"State.Code","County.Code","GIS.Join.Match.Code","Data.File.Year","Region.Code","Division.Code","State.Name","County.Name","CENSUS2010","X","Full.Name","POPESTIMATE042010","HUBasedPop042010","Error","PctError","AbsPctError","Error_HUBasedPop","PctError_HUBasedPop","AbsPctError_HUBasedPop"
"01","001","G0100010","2010","3","6","Alabama","Autauga County",54571,"","Autauga County Alabama",50973,50368,-3598,-6.59324549669238,6.59324549669238,-4203,-7.70189294680325,7.70189294680325
"01","003","G0100030","2010","3","6","Alabama","Baldwin County",182265,"","Baldwin County Alabama",182664,201113,399,0.218912023701753,0.218912023701753,18848,10.3409870243876,10.3409870243876
"01","005","G0100050","2010","3","6","Alabama","Barbour County",27457,"","Barbour County Alabama",29656,30235,2199,8.00888662271916,8.00888662271916,2778,10.1176384892741,10.1176384892741
"01","007","G0100070","2010","3","6","Alabama","Bibb County",22915,"","Bibb County Alabama",21438,20912,-1477,-6.44555967706742,6.44555967706742,-2003,-8.74099934540694,8.74099934540694
"01","009","G0100090","2010","3","6","Alabama","Blount County",57322,"","Blount County Alabama",58254,53080,932,1.62590279473849,1.62590279473849,-4242,-7.40030005931405,7.40030005931405
"01","011","G0100110","2010","3","6","Alabama","Bullock County",10914,"","Bullock County Alabama",10841,12035,-73,-0.668865677111966,0.668865677111966,1121,10.2712112882536,10.2712112882536
"01","013","G0100130","2010","3","6","Alabama","Butler County",20947,"","Butler County Alabama",20029,22389,-918,-4.38248913925622,4.38248913925622,1442,6.88404067408221,6.88404067408221
"01","015","G0100150","2010","3","6","Alabama","Calhoun County",118572,"","Calhoun County Alabama",113486,117966,-5086,-4.28937691866545,4.28937691866545,-606,-0.51108187430422,0.51108187430422
"01","017","G0100170","2010","3","6","Alabama","Chambers County",34215,"","Chambers County Alabama",34088,38794,-127,-0.371182230016075,0.371182230016075,4579,13.3830191436504,13.3830191436504
"01","019","G0100190","2010","3","6","Alabama","Cherokee County",25989,"","Cherokee County Alabama",24408,25215,-1581,-6.08334295278772,6.08334295278772,-774,-2.97818307745585,2.97818307745585
"01","021","G0100210","2010","3","6","Alabama","Chilton County",43643,"","Chilton County Alabama",43112,42316,-531,-1.21668996173499,1.21668996173499,-1327,-3.04057924523979,3.04057924523979
"01","023","G0100230","2010","3","6","Alabama","Choctaw County",13859,"","Choctaw County Alabama",13870,16511,11,0.079370805974457,0.079370805974457,2652,19.13557976766,19.13557976766
"01","025","G0100250","2010","3","6","Alabama","Clarke County",25833,"","Clarke County Alabama",25845,29006,12,0.0464522122866102,0.0464522122866102,3173,12.2827391321178,12.2827391321178
"01","027","G0100270","2010","3","6","Alabama","Clay County",13932,"","Clay County Alabama",13507,14703,-425,-3.05053115130635,3.05053115130635,771,5.53402239448751,5.53402239448751
"01","029","G0100290","2010","3","6","Alabama","Cleburne County",14972,"","Cleburne County Alabama",14852,14849,-120,-0.801496126102057,0.801496126102057,-123,-0.821533529254609,0.821533529254609
"01","031","G0100310","2010","3","6","Alabama","Coffee County",49948,"","Coffee County Alabama",48737,49574,-1211,-2.42452150236246,2.42452150236246,-374,-0.748778729879074,0.748778729879074
"01","033","G0100330","2010","3","6","Alabama","Colbert County",54428,"","Colbert County Alabama",54629,58866,201,0.369295215697803,0.369295215697803,4438,8.15389137943705,8.15389137943705
"01","035","G0100350","2010","3","6","Alabama","Conecuh County",13228,"","Conecuh County Alabama",12791,14651,-437,-3.30359842757787,3.30359842757787,1423,10.7574841245842,10.7574841245842
"01","037","G0100370","2010","3","6","Alabama","Coosa County",11539,"","Coosa County Alabama",10584,12303,-955,-8.27628044024612,8.27628044024612,764,6.6210243521969,6.6210243521969
"01","039","G0100390","2010","3","6","Alabama","Covington County",37765,"","Covington County Alabama",36693,39014,-1072,-2.83860717595657,2.83860717595657,1249,3.30729511452403,3.30729511452403
"01","041","G0100410","2010","3","6","Alabama","Crenshaw County",13906,"","Crenshaw County Alabama",13598,14171,-308,-2.21487127858478,2.21487127858478,265,1.9056522364447,1.9056522364447
"01","043","G0100430","2010","3","6","Alabama","Cullman County",80406,"","Cullman County Alabama",81901,80965,1495,1.85931398154367,1.85931398154367,559,0.695221749620675,0.695221749620675
"01","045","G0100450","2010","3","6","Alabama","Dale County",50251,"","Dale County Alabama",47963,51703,-2288,-4.55314322103043,4.55314322103043,1452,2.88949473642316,2.88949473642316
"01","047","G0100470","2010","3","6","Alabama","Dallas County",43820,"","Dallas County Alabama",41898,47667,-1922,-4.38612505705157,4.38612505705157,3847,8.77909630305797,8.77909630305797
"01","049","G0100490","2010","3","6","Alabama","DeKalb County",71109,"","DeKalb County Alabama",69569,67514,-1540,-2.16568929390091,2.16568929390091,-3595,-5.05561883868427,5.05561883868427
"01","051","G0100510","2010","3","6","Alabama","Elmore County",79303,"","Elmore County Alabama",79695,75021,392,0.494306646659017,0.494306646659017,-4282,-5.39954352294365,5.39954352294365
"01","053","G0100530","2010","3","6","Alabama","Escambia County",38319,"","Escambia County Alabama",37644,39590,-675,-1.76152822359665,1.76152822359665,1271,3.31689240324643,3.31689240324643
"01","055","G0100550","2010","3","6","Alabama","Etowah County",104430,"","Etowah County Alabama",103517,109709,-913,-0.874269845829742,0.874269845829742,5279,5.05506080628172,5.05506080628172
"01","057","G0100570","2010","3","6","Alabama","Fayette County",17241,"","Fayette County Alabama",17351,19334,110,0.638014036308799,0.638014036308799,2093,12.1396670726756,12.1396670726756
"01","059","G0100590","2010","3","6","Alabama","Franklin County",31704,"","Franklin County Alabama",31302,32179,-402,-1.26797880393641,1.26797880393641,475,1.49823366136765,1.49823366136765
"01","061","G0100610","2010","3","6","Alabama","Geneva County",26790,"","Geneva County Alabama",25936,26533,-854,-3.18775662560657,3.18775662560657,-257,-0.959313176558417,0.959313176558417
"01","063","G0100630","2010","3","6","Alabama","Greene County",9045,"","Greene County Alabama",8628,10275,-417,-4.61028192371476,4.61028192371476,1230,13.5986733001658,13.5986733001658
"01","065","G0100650","2010","3","6","Alabama","Hale County",15760,"","Hale County Alabama",17851,19708,2091,13.2677664974619,13.2677664974619,3948,25.0507614213198,25.0507614213198
"01","067","G0100670","2010","3","6","Alabama","Henry County",17302,"","Henry County Alabama",16675,17066,-627,-3.62385851346665,3.62385851346665,-236,-1.36400416136863,1.36400416136863
"01","069","G0100690","2010","3","6","Alabama","Houston County",101547,"","Houston County Alabama",101251,99193,-296,-0.291490639802259,0.291490639802259,-2354,-2.31813839896797,2.31813839896797
"01","071","G0100710","2010","3","6","Alabama","Jackson County",53227,"","Jackson County Alabama",52502,56537,-725,-1.36209066826986,1.36209066826986,3310,6.21864843030793,6.21864843030793
"01","073","G0100730","2010","3","6","Alabama","Jefferson County",658466,"","Jefferson County Alabama",665399,717816,6933,1.05290174435734,1.05290174435734,59350,9.01337350751595,9.01337350751595
"01","075","G0100750","2010","3","6","Alabama","Lamar County",14564,"","Lamar County Alabama",14040,16359,-524,-3.59791266135677,3.59791266135677,1795,12.324910738808,12.324910738808
"01","077","G0100770","2010","3","6","Alabama","Lauderdale County",92709,"","Lauderdale County Alabama",89135,92282,-3574,-3.85507340171936,3.85507340171936,-427,-0.46058095762008,0.46058095762008
"01","079","G0100790","2010","3","6","Alabama","Lawrence County",34339,"","Lawrence County Alabama",34201,36158,-138,-0.401875418620228,0.401875418620228,1819,5.29718395992894,5.29718395992894
"01","081","G0100810","2010","3","6","Alabama","Lee County",140247,"","Lee County Alabama",138780,147875,-1467,-1.04601167939421,1.04601167939421,7628,5.43897552175804,5.43897552175804
"01","083","G0100830","2010","3","6","Alabama","Limestone County",82782,"","Limestone County Alabama",79703,72959,-3079,-3.71940760068614,3.71940760068614,-9823,-11.8661061583436,11.8661061583436
"01","085","G0100850","2010","3","6","Alabama","Lowndes County",11299,"","Lowndes County Alabama",12203,13776,904,8.00070802725905,8.00070802725905,2477,21.9222940083193,21.9222940083193
"01","087","G0100870","2010","3","6","Alabama","Macon County",21452,"","Macon County Alabama",21585,24884,133,0.61998881223196,0.61998881223196,3432,15.9985082975946,15.9985082975946
"01","089","G0100890","2010","3","6","Alabama","Madison County",334811,"","Madison County Alabama",330383,336508,-4428,-1.32253719262509,1.32253719262509,1697,0.506853120118515,0.506853120118515
"01","091","G0100910","2010","3","6","Alabama","Marengo County",21027,"","Marengo County Alabama",20755,23357,-272,-1.2935749274742,1.2935749274742,2330,11.0809911066724,11.0809911066724
"01","093","G0100930","2010","3","6","Alabama","Marion County",30776,"","Marion County Alabama",28950,32491,-1826,-5.93319469716662,5.93319469716662,1715,5.57252404471016,5.57252404471016
"01","095","G0100950","2010","3","6","Alabama","Marshall County",93019,"","Marshall County Alabama",90959,87566,-2060,-2.2146013180103,2.2146013180103,-5453,-5.86224319762629,5.86224319762629
"01","097","G0100970","2010","3","6","Alabama","Mobile County",412992,"","Mobile County Alabama",411246,446877,-1746,-0.422768479776848,0.422768479776848,33885,8.20475941422594,8.20475941422594
"01","099","G0100990","2010","3","6","Alabama","Monroe County",23068,"","Monroe County Alabama",22186,25218,-882,-3.82347841165251,3.82347841165251,2150,9.32027050459511,9.32027050459511
"01","101","G0101010","2010","3","6","Alabama","Montgomery County",229363,"","Montgomery County Alabama",225604,242618,-3759,-1.63888683004669,1.63888683004669,13255,5.77904893117024,5.77904893117024
"01","103","G0101030","2010","3","6","Alabama","Morgan County",119490,"","Morgan County Alabama",117805,119050,-1685,-1.41015984601222,1.41015984601222,-440,-0.3682316511842,0.3682316511842
"01","105","G0101050","2010","3","6","Alabama","Perry County",10591,"","Perry County Alabama",10685,12256,94,0.887546029647814,0.887546029647814,1665,15.7208950996129,15.7208950996129
"01","107","G0101070","2010","3","6","Alabama","Pickens County",19746,"","Pickens County Alabama",19056,21647,-690,-3.49437860832574,3.49437860832574,1901,9.62726628177859,9.62726628177859
"01","109","G0101090","2010","3","6","Alabama","Pike County",32899,"","Pike County Alabama",30652,32284,-2247,-6.82999483266969,6.82999483266969,-615,-1.86935773123803,1.86935773123803
"01","111","G0101110","2010","3","6","Alabama","Randolph County",22913,"","Randolph County Alabama",22518,23099,-395,-1.7239121895867,1.7239121895867,186,0.811766246235761,0.811766246235761
"01","113","G0101130","2010","3","6","Alabama","Russell County",52947,"","Russell County Alabama",51838,59070,-1109,-2.09454737756625,2.09454737756625,6123,11.5643945832625,11.5643945832625
"01","115","G0101150","2010","3","6","Alabama","St. Clair County",83593,"","St. Clair County Alabama",82479,75626,-1114,-1.33264747048198,1.33264747048198,-7967,-9.53070233153494,9.53070233153494
"01","117","G0101170","2010","3","6","Alabama","Shelby County",195085,"","Shelby County Alabama",194634,194176,-451,-0.231181279954891,0.231181279954891,-909,-0.465950739421278,0.465950739421278
"01","119","G0101190","2010","3","6","Alabama","Sumter County",13763,"","Sumter County Alabama",12769,15365,-994,-7.22226258809853,7.22226258809853,1602,11.6399040906779,11.6399040906779
"01","121","G0101210","2010","3","6","Alabama","Talladega County",82291,"","Talladega County Alabama",80318,86322,-1973,-2.39758904375934,2.39758904375934,4031,4.89847006355494,4.89847006355494
"01","123","G0101230","2010","3","6","Alabama","Tallapoosa County",41616,"","Tallapoosa County Alabama",40666,43417,-950,-2.28277585544022,2.28277585544022,1801,4.32766243752403,4.32766243752403
"01","125","G0101250","2010","3","6","Alabama","Tuscaloosa County",194656,"","Tuscaloosa County Alabama",186553,196409,-8103,-4.16272809469012,4.16272809469012,1753,0.900563044550386,0.900563044550386
"01","127","G0101270","2010","3","6","Alabama","Walker County",67023,"","Walker County Alabama",68342,73572,1319,1.96798114080241,1.96798114080241,6549,9.77127254822971,9.77127254822971
"01","129","G0101290","2010","3","6","Alabama","Washington County",17581,"","Washington County Alabama",17055,18754,-526,-2.99186621921392,2.99186621921392,1173,6.67197542801888,6.67197542801888
"01","131","G0101310","2010","3","6","Alabama","Wilcox County",11670,"","Wilcox County Alabama",12156,13527,486,4.16452442159383,4.16452442159383,1857,15.9125964010283,15.9125964010283
"01","133","G0101330","2010","3","6","Alabama","Winston County",24484,"","Winston County Alabama",23719,25675,-765,-3.12448946250613,3.12448946250613,1191,4.86440124162718,4.86440124162718
"02","013","G0200130","2010","4","9","Alaska","Aleutians East Borough",3141,"","Aleutians East Borough Alaska",2782,2831,-359,-11.4294810569882,11.4294810569882,-310,-9.86946832219038,9.86946832219038
"02","016","G0200160","2010","4","9","Alaska","Aleutians West Census Area",5561,"","Aleutians West Census Area Alaska",4711,5723,-850,-15.2850206797339,15.2850206797339,162,2.91314511778457,2.91314511778457
"02","020","G0200200","2010","4","9","Alaska","Anchorage Municipality",291826,"","Anchorage Municipality Alaska",289094,291666,-2732,-0.936174295641924,0.936174295641924,-160,-0.0548271915456471,0.0548271915456471
"02","050","G0200500","2010","4","9","Alaska","Bethel Census Area",17013,"","Bethel Census Area Alaska",17555,17317,542,3.18579909480985,3.18579909480985,304,1.7868688649856,1.7868688649856
"02","060","G0200600","2010","4","9","Alaska","Bristol Bay Borough",997,"","Bristol Bay Borough Alaska",899,1272,-98,-9.82948846539619,9.82948846539619,275,27.5827482447342,27.5827482447342
"02","068","G0200680","2010","4","9","Alaska","Denali Borough",1826,"","Denali Borough Alaska",1842,1950,16,0.876232201533406,0.876232201533406,124,6.7907995618839,6.7907995618839
"02","070","G0200700","2010","4","9","Alaska","Dillingham Census Area",4847,"","Dillingham Census Area Alaska",5002,5129,155,3.19785434289251,3.19785434289251,282,5.81803177223025,5.81803177223025
"02","090","G0200900","2010","4","9","Alaska","Fairbanks North Star Borough",97581,"","Fairbanks North Star Borough Alaska",97682,94512,101,0.103503755854111,0.103503755854111,-3069,-3.14507947243828,3.14507947243828
"02","100","G0201000","2010","4","9","Alaska","Haines Borough",2508,"","Haines Borough Alaska",2421,2598,-87,-3.4688995215311,3.4688995215311,90,3.58851674641148,3.58851674641148
"02","105","G0201050","2010","4","9","Alaska","Hoonah-Angoon Census Area",2150,"","Hoonah-Angoon Census Area Alaska",2066,2867,-84,-3.90697674418605,3.90697674418605,717,33.3488372093023,33.3488372093023
"02","110","G0201100","2010","4","9","Alaska","Juneau City and Borough",31275,"","Juneau City and Borough Alaska",31166,32299,-109,-0.348521183053557,0.348521183053557,1024,3.27418065547562,3.27418065547562
"02","122","G0201220","2010","4","9","Alaska","Kenai Peninsula Borough",55400,"","Kenai Peninsula Borough Alaska",55426,51364,26,0.0469314079422383,0.0469314079422383,-4036,-7.28519855595668,7.28519855595668
"02","130","G0201300","2010","4","9","Alaska","Ketchikan Gateway Borough",13477,"","Ketchikan Gateway Borough Alaska",13185,15029,-292,-2.16665429991838,2.16665429991838,1552,11.5159160050456,11.5159160050456
"02","150","G0201500","2010","4","9","Alaska","Kodiak Island Borough",13592,"","Kodiak Island Borough Alaska",13415,15253,-177,-1.30223660977045,1.30223660977045,1661,12.2204237786933,12.2204237786933
"02","164","G0201640","2010","4","9","Alaska","Lake and Peninsula Borough",1631,"","Lake and Peninsula Borough Alaska",1495,1862,-136,-8.33844267320662,8.33844267320662,231,14.1630901287554,14.1630901287554
"02","170","G0201700","2010","4","9","Alaska","Matanuska-Susitna Borough",88995,"","Matanuska-Susitna Borough Alaska",90655,62456,1660,1.86527332996236,1.86527332996236,-26539,-29.8207764481151,29.8207764481151
"02","180","G0201800","2010","4","9","Alaska","Nome Census Area",9492,"","Nome Census Area Alaska",9548,9330,56,0.589970501474926,0.589970501474926,-162,-1.70670037926675,1.70670037926675
"02","185","G0201850","2010","4","9","Alaska","North Slope Borough",9430,"","North Slope Borough Alaska",6900,7917,-2530,-26.8292682926829,26.8292682926829,-1513,-16.0445387062566,16.0445387062566
"02","188","G0201880","2010","4","9","Alaska","Northwest Arctic Borough",7523,"","Northwest Arctic Borough Alaska",7532,7347,9,0.119633125083079,0.119633125083079,-176,-2.33949222384687,2.33949222384687
"02","195","G0201950","2010","4","9","Alaska","Petersburg Census Area",3815,"","Petersburg Census Area Alaska",3766,4536,-49,-1.28440366972477,1.28440366972477,721,18.8990825688073,18.8990825688073
"02","198","G0201980","2010","4","9","Alaska","Prince of Wales-Hyder Census Area",5559,"","Prince of Wales-Hyder Census Area Alaska",5682,6622,123,2.21262817053427,2.21262817053427,1063,19.1221442705523,19.1221442705523
"02","220","G0202200","2010","4","9","Alaska","Sitka City and Borough",8881,"","Sitka City and Borough Alaska",8665,9670,-216,-2.43215854070488,2.43215854070488,789,8.8841346695192,8.8841346695192
"02","230","G0202300","2010","4","9","Alaska","Skagway Municipality",968,"","Skagway Municipality Alaska",903,1023,-65,-6.71487603305785,6.71487603305785,55,5.68181818181818,5.68181818181818
"02","240","G0202400","2010","4","9","Alaska","Southeast Fairbanks Census Area",7029,"","Southeast Fairbanks Census Area Alaska",6935,6356,-94,-1.33731683027458,1.33731683027458,-673,-9.57461943377436,9.57461943377436
"02","261","G0202610","2010","4","9","Alaska","Valdez-Cordova Census Area",9636,"","Valdez-Cordova Census Area Alaska",9469,10559,-167,-1.73308426733084,1.73308426733084,923,9.57866334578663,9.57866334578663
"02","270","G0202700","2010","4","9","Alaska","Wade Hampton Census Area",7459,"","Wade Hampton Census Area Alaska",7764,7103,305,4.08901997586808,4.08901997586808,-356,-4.77275774232471,4.77275774232471
"02","275","G0202750","2010","4","9","Alaska","Wrangell City and Borough",2369,"","Wrangell City and Borough Alaska",2160,2603,-209,-8.82228788518362,8.82228788518362,234,9.87758547910511,9.87758547910511
"02","282","G0202820","2010","4","9","Alaska","Yakutat City and Borough",662,"","Yakutat City and Borough Alaska",725,826,63,9.5166163141994,9.5166163141994,164,24.773413897281,24.773413897281
"02","290","G0202900","2010","4","9","Alaska","Yukon-Koyukuk Census Area",5588,"","Yukon-Koyukuk Census Area Alaska",5730,6717,142,2.5411596277738,2.5411596277738,1129,20.2040085898354,20.2040085898354
"04","001","G0400010","2010","4","8","Arizona","Apache County",71518,"","Apache County Arizona",71100,71872,-418,-0.584468245756313,0.584468245756313,354,0.494980284683576,0.494980284683576
"04","003","G0400030","2010","4","8","Arizona","Cochise County",131346,"","Cochise County Arizona",129860,134429,-1486,-1.13136296499322,1.13136296499322,3083,2.3472355458103,2.3472355458103
"04","005","G0400050","2010","4","8","Arizona","Coconino County",134421,"","Coconino County Arizona",130712,133156,-3709,-2.75924148756519,2.75924148756519,-1265,-0.941073195408455,0.941073195408455
"04","007","G0400070","2010","4","8","Arizona","Gila County",53597,"","Gila County Arizona",52242,56583,-1355,-2.52812657424856,2.52812657424856,2986,5.57120734369461,5.57120734369461
"04","009","G0400090","2010","4","8","Arizona","Graham County",37220,"","Graham County Arizona",36702,38391,-518,-1.39172487909726,1.39172487909726,1171,3.14615797958087,3.14615797958087
"04","011","G0400110","2010","4","8","Arizona","Greenlee County",8437,"","Greenlee County Arizona",7801,8977,-636,-7.53822448737703,7.53822448737703,540,6.40037928173521,6.40037928173521
"04","012","G0400120","2010","4","8","Arizona","La Paz County",20489,"","La Paz County Arizona",19800,20673,-689,-3.36278002830787,3.36278002830787,184,0.898042852262189,0.898042852262189
"04","013","G0400130","2010","4","8","Arizona","Maricopa County",3817117,"","Maricopa County Arizona",4052821,3914577,235704,6.17492206814724,6.17492206814724,97460,2.55323585837165,2.55323585837165
"04","015","G0400150","2010","4","8","Arizona","Mohave County",200186,"","Mohave County Arizona",194297,199292,-5889,-2.94176415933182,2.94176415933182,-894,-0.446584676251086,0.446584676251086
"04","017","G0400170","2010","4","8","Arizona","Navajo County",107449,"","Navajo County Arizona",113244,113221,5795,5.39325633556385,5.39325633556385,5772,5.3718508315573,5.3718508315573
"04","019","G0400190","2010","4","8","Arizona","Pima County",980263,"","Pima County Arizona",1025286,987927,45023,4.59295107537467,4.59295107537467,7664,0.781830998415731,0.781830998415731
"04","021","G0400210","2010","4","8","Arizona","Pinal County",375770,"","Pinal County Arizona",363881,330066,-11889,-3.16390345157942,3.16390345157942,-45704,-12.162759134577,12.162759134577
"04","023","G0400230","2010","4","8","Arizona","Santa Cruz County",47420,"","Santa Cruz County Arizona",43676,51832,-3744,-7.8954027836356,7.8954027836356,4412,9.30409110080135,9.30409110080135
"04","025","G0400250","2010","4","8","Arizona","Yavapai County",211033,"","Yavapai County Arizona",215070,219199,4037,1.91297095714888,1.91297095714888,8166,3.86953699184488,3.86953699184488
"04","027","G0400270","2010","4","8","Arizona","Yuma County",195751,"","Yuma County Arizona",197866,192278,2115,1.080454250553,1.080454250553,-3473,-1.77419272443053,1.77419272443053
"05","001","G0500010","2010","3","7","Arkansas","Arkansas County",19019,"","Arkansas County Arkansas",18998,21461,-21,-0.110415899889584,0.110415899889584,2442,12.8397917871602,12.8397917871602
"05","003","G0500030","2010","3","7","Arkansas","Ashley County",21853,"","Ashley County Arkansas",21959,25446,106,0.485059259598225,0.485059259598225,3593,16.4416784880794,16.4416784880794
"05","005","G0500050","2010","3","7","Arkansas","Baxter County",41513,"","Baxter County Arkansas",42043,41609,530,1.27670850095151,1.27670850095151,96,0.231252860549707,0.231252860549707
"05","007","G0500070","2010","3","7","Arkansas","Benton County",221339,"","Benton County Arkansas",230006,209563,8667,3.91571300132376,3.91571300132376,-11776,-5.32034571404045,5.32034571404045
"05","009","G0500090","2010","3","7","Arkansas","Boone County",36903,"","Boone County Arkansas",36837,36032,-66,-0.178847248191204,0.178847248191204,-871,-2.36024171476574,2.36024171476574
"05","011","G0500110","2010","3","7","Arkansas","Bradley County",11508,"","Bradley County Arkansas",11772,12748,264,2.29405630865485,2.29405630865485,1240,10.775112964894,10.775112964894
"05","013","G0500130","2010","3","7","Arkansas","Calhoun County",5368,"","Calhoun County Arkansas",5094,6038,-274,-5.1043219076006,5.1043219076006,670,12.4813710879285,12.4813710879285
"05","015","G0500150","2010","3","7","Arkansas","Carroll County",27446,"","Carroll County Arkansas",28321,27188,875,3.18807840851126,3.18807840851126,-258,-0.940027690738177,0.940027690738177
"05","017","G0500170","2010","3","7","Arkansas","Chicot County",11800,"","Chicot County Arkansas",11817,14671,17,0.144067796610169,0.144067796610169,2871,24.3305084745763,24.3305084745763
"05","019","G0500190","2010","3","7","Arkansas","Clark County",22995,"","Clark County Arkansas",23771,25068,776,3.3746466623179,3.3746466623179,2073,9.0150032615786,9.0150032615786
"05","021","G0500210","2010","3","7","Arkansas","Clay County",16083,"","Clay County Arkansas",15506,18131,-577,-3.58763912205434,3.58763912205434,2048,12.733942672387,12.733942672387
"05","023","G0500230","2010","3","7","Arkansas","Cleburne County",25970,"","Cleburne County Arkansas",25545,26061,-425,-1.636503658067,1.636503658067,91,0.350404312668464,0.350404312668464
"05","025","G0500250","2010","3","7","Arkansas","Cleveland County",8689,"","Cleveland County Arkansas",8476,9051,-213,-2.45137530210611,2.45137530210611,362,4.16618713315686,4.16618713315686
"05","027","G0500270","2010","3","7","Arkansas","Columbia County",24552,"","Columbia County Arkansas",23895,26608,-657,-2.67595307917889,2.67595307917889,2056,8.37406321277289,8.37406321277289
"05","029","G0500290","2010","3","7","Arkansas","Conway County",21273,"","Conway County Arkansas",20858,21309,-415,-1.95082969021765,1.95082969021765,36,0.169228599633338,0.169228599633338
"05","031","G0500310","2010","3","7","Arkansas","Craighead County",96443,"","Craighead County Arkansas",96747,94357,304,0.315212094190351,0.315212094190351,-2086,-2.16293562000353,2.16293562000353
"05","033","G0500330","2010","3","7","Arkansas","Crawford County",61948,"","Crawford County Arkansas",60335,59737,-1613,-2.60379673274359,2.60379673274359,-2211,-3.56912248983018,3.56912248983018
"05","035","G0500350","2010","3","7","Arkansas","Crittenden County",50902,"","Crittenden County Arkansas",53124,57864,2222,4.36525087422891,4.36525087422891,6962,13.6772621900908,13.6772621900908
"05","037","G0500370","2010","3","7","Arkansas","Cross County",17870,"","Cross County Arkansas",18520,20959,650,3.63738108561835,3.63738108561835,3089,17.2859541130386,17.2859541130386
"05","039","G0500390","2010","3","7","Arkansas","Dallas County",8116,"","Dallas County Arkansas",7880,9510,-236,-2.90783637259734,2.90783637259734,1394,17.1759487432233,17.1759487432233
"05","041","G0500410","2010","3","7","Arkansas","Desha County",13008,"","Desha County Arkansas",13285,16019,277,2.12945879458795,2.12945879458795,3011,23.1472939729397,23.1472939729397
"05","043","G0500430","2010","3","7","Arkansas","Drew County",18509,"","Drew County Arkansas",18679,20122,170,0.918472094656654,0.918472094656654,1613,8.71467934518342,8.71467934518342
"05","045","G0500450","2010","3","7","Arkansas","Faulkner County",113237,"","Faulkner County Arkansas",111534,111123,-1703,-1.50392539540963,1.50392539540963,-2114,-1.86688096646856,1.86688096646856
"05","047","G0500470","2010","3","7","Arkansas","Franklin County",18125,"","Franklin County Arkansas",17977,18653,-148,-0.816551724137931,0.816551724137931,528,2.91310344827586,2.91310344827586
"05","049","G0500490","2010","3","7","Arkansas","Fulton County",12245,"","Fulton County Arkansas",11468,12290,-777,-6.34544712127399,6.34544712127399,45,0.367496937525521,0.367496937525521
"05","051","G0500510","2010","3","7","Arkansas","Garland County",96024,"","Garland County Arkansas",98723,92890,2699,2.81075564442223,2.81075564442223,-3134,-3.26376739148546,3.26376739148546
"05","053","G0500530","2010","3","7","Arkansas","Grant County",17853,"","Grant County Arkansas",17901,18052,48,0.268862376071249,0.268862376071249,199,1.11465860079538,1.11465860079538
"05","055","G0500550","2010","3","7","Arkansas","Greene County",42090,"","Greene County Arkansas",41336,42285,-754,-1.79139938227608,1.79139938227608,195,0.463292943692088,0.463292943692088
"05","057","G0500570","2010","3","7","Arkansas","Hempstead County",22609,"","Hempstead County Arkansas",23088,25083,479,2.11862532619753,2.11862532619753,2474,10.9425450042019,10.9425450042019
"05","059","G0500590","2010","3","7","Arkansas","Hot Spring County",32923,"","Hot Spring County Arkansas",32048,31877,-875,-2.6577164899918,2.6577164899918,-1046,-3.17711022689305,3.17711022689305
"05","061","G0500610","2010","3","7","Arkansas","Howard County",13789,"","Howard County Arkansas",14462,15078,673,4.88070200884763,4.88070200884763,1289,9.34803103923417,9.34803103923417
"05","063","G0500630","2010","3","7","Arkansas","Independence County",36647,"","Independence County Arkansas",35063,36235,-1584,-4.32231833437935,4.32231833437935,-412,-1.12423936475018,1.12423936475018
"05","065","G0500650","2010","3","7","Arkansas","Izard County",13696,"","Izard County Arkansas",13001,14077,-695,-5.07447429906542,5.07447429906542,381,2.78183411214953,2.78183411214953
"05","067","G0500670","2010","3","7","Arkansas","Jackson County",17997,"","Jackson County Arkansas",16449,18950,-1548,-8.60143357226204,8.60143357226204,953,5.29532699894427,5.29532699894427
"05","069","G0500690","2010","3","7","Arkansas","Jefferson County",77435,"","Jefferson County Arkansas",78462,88478,1027,1.32627364886679,1.32627364886679,11043,14.2609930909795,14.2609930909795
"05","071","G0500710","2010","3","7","Arkansas","Johnson County",25540,"","Johnson County Arkansas",25227,24645,-313,-1.2255285826155,1.2255285826155,-895,-3.50430696945967,3.50430696945967
"05","073","G0500730","2010","3","7","Arkansas","Lafayette County",7645,"","Lafayette County Arkansas",7491,9058,-154,-2.01438848920863,2.01438848920863,1413,18.482668410726,18.482668410726
"05","075","G0500750","2010","3","7","Arkansas","Lawrence County",17415,"","Lawrence County Arkansas",16793,18384,-622,-3.57163364915303,3.57163364915303,969,5.56416881998277,5.56416881998277
"05","077","G0500770","2010","3","7","Arkansas","Lee County",10424,"","Lee County Arkansas",10301,13348,-123,-1.17996930161167,1.17996930161167,2924,28.0506523407521,28.0506523407521
"05","079","G0500790","2010","3","7","Arkansas","Lincoln County",14134,"","Lincoln County Arkansas",13456,15330,-678,-4.79694354039904,4.79694354039904,1196,8.46186500636762,8.46186500636762
"05","081","G0500810","2010","3","7","Arkansas","Little River County",13171,"","Little River County Arkansas",12892,14289,-279,-2.11829018297775,2.11829018297775,1118,8.48834560777466,8.48834560777466
"05","083","G0500830","2010","3","7","Arkansas","Logan County",22353,"","Logan County Arkansas",22246,23457,-107,-0.47868295083434,0.47868295083434,1104,4.93893437122534,4.93893437122534
"05","085","G0500850","2010","3","7","Arkansas","Lonoke County",68356,"","Lonoke County Arkansas",67251,67278,-1105,-1.61653695359588,1.61653695359588,-1078,-1.57703786061209,1.57703786061209
"05","087","G0500870","2010","3","7","Arkansas","Madison County",15717,"","Madison County Arkansas",15992,15185,275,1.74969777947445,1.74969777947445,-532,-3.38486988611058,3.38486988611058
"05","089","G0500890","2010","3","7","Arkansas","Marion County",16653,"","Marion County Arkansas",16411,17633,-242,-1.45319161712604,1.45319161712604,980,5.8848255569567,5.8848255569567
"05","091","G0500910","2010","3","7","Arkansas","Miller County",43462,"","Miller County Arkansas",43842,44231,380,0.874326998297363,0.874326998297363,769,1.76936174129124,1.76936174129124
"05","093","G0500930","2010","3","7","Arkansas","Mississippi County",46480,"","Mississippi County Arkansas",46261,53437,-219,-0.471170395869191,0.471170395869191,6957,14.9677280550775,14.9677280550775
"05","095","G0500950","2010","3","7","Arkansas","Monroe County",8149,"","Monroe County Arkansas",8007,10676,-142,-1.74254509755798,1.74254509755798,2527,31.0099398699227,31.0099398699227
"05","097","G0500970","2010","3","7","Arkansas","Montgomery County",9487,"","Montgomery County Arkansas",8921,9843,-566,-5.96605881732898,5.96605881732898,356,3.75250342574049,3.75250342574049
"05","099","G0500990","2010","3","7","Arkansas","Nevada County",8997,"","Nevada County Arkansas",9080,12568,83,0.922529732132933,0.922529732132933,3571,39.6910081138157,39.6910081138157
"05","101","G0501010","2010","3","7","Arkansas","Newton County",8330,"","Newton County Arkansas",8171,9060,-159,-1.90876350540216,1.90876350540216,730,8.76350540216086,8.76350540216086
"05","103","G0501030","2010","3","7","Arkansas","Ouachita County",26120,"","Ouachita County Arkansas",25508,29435,-612,-2.34303215926493,2.34303215926493,3315,12.6914241960184,12.6914241960184
"05","105","G0501050","2010","3","7","Arkansas","Perry County",10445,"","Perry County Arkansas",10223,10833,-222,-2.1254188606989,2.1254188606989,388,3.71469602680708,3.71469602680708
"05","107","G0501070","2010","3","7","Arkansas","Phillips County",21757,"","Phillips County Arkansas",20646,26837,-1111,-5.10640253711449,5.10640253711449,5080,23.3488072804155,23.3488072804155
"05","109","G0501090","2010","3","7","Arkansas","Pike County",11291,"","Pike County Arkansas",10612,11989,-679,-6.0136391816491,6.0136391816491,698,6.18191479939775,6.18191479939775
"05","111","G0501110","2010","3","7","Arkansas","Poinsett County",24583,"","Poinsett County Arkansas",24729,27005,146,0.593906358052313,0.593906358052313,2422,9.85233698084042,9.85233698084042
"05","113","G0501130","2010","3","7","Arkansas","Polk County",20662,"","Polk County Arkansas",20324,21366,-338,-1.63585325718711,1.63585325718711,704,3.4072209853838,3.4072209853838
"05","115","G0501150","2010","3","7","Arkansas","Pope County",61754,"","Pope County Arkansas",60773,60014,-981,-1.58856106487029,1.58856106487029,-1740,-2.81763124655893,2.81763124655893
"05","117","G0501170","2010","3","7","Arkansas","Prairie County",8715,"","Prairie County Arkansas",8521,9976,-194,-2.22604704532415,2.22604704532415,1261,14.469305794607,14.469305794607
"05","119","G0501190","2010","3","7","Arkansas","Pulaski County",382748,"","Pulaski County Arkansas",382463,398163,-285,-0.0744615255990887,0.0744615255990887,15415,4.02745409512264,4.02745409512264
"05","121","G0501210","2010","3","7","Arkansas","Randolph County",17969,"","Randolph County Arkansas",17978,19505,9,0.0500862596694307,0.0500862596694307,1536,8.54805498358284,8.54805498358284
"05","123","G0501230","2010","3","7","Arkansas","St. Francis County",28258,"","St. Francis County Arkansas",26130,30658,-2128,-7.53061080048128,7.53061080048128,2400,8.49317007573077,8.49317007573077
"05","125","G0501250","2010","3","7","Arkansas","Saline County",107118,"","Saline County Arkansas",100431,102755,-6687,-6.2426482944043,6.2426482944043,-4363,-4.07307828749603,4.07307828749603
"05","127","G0501270","2010","3","7","Arkansas","Scott County",11233,"","Scott County Arkansas",11199,11573,-34,-0.302679604736046,0.302679604736046,340,3.02679604736046,3.02679604736046
"05","129","G0501290","2010","3","7","Arkansas","Searcy County",8195,"","Searcy County Arkansas",7869,8653,-326,-3.97803538743136,3.97803538743136,458,5.58877364246492,5.58877364246492
"05","131","G0501310","2010","3","7","Arkansas","Sebastian County",125744,"","Sebastian County Arkansas",124278,126444,-1466,-1.165860796539,1.165860796539,700,0.556686601348772,0.556686601348772
"05","133","G0501330","2010","3","7","Arkansas","Sevier County",17058,"","Sevier County Arkansas",17131,16480,73,0.427951694219721,0.427951694219721,-578,-3.38843944190409,3.38843944190409
"05","135","G0501350","2010","3","7","Arkansas","Sharp County",17264,"","Sharp County Arkansas",17567,17792,303,1.75509731232623,1.75509731232623,528,3.05838739573679,3.05838739573679
"05","137","G0501370","2010","3","7","Arkansas","Stone County",12394,"","Stone County Arkansas",11954,12343,-440,-3.55010488946264,3.55010488946264,-51,-0.411489430369534,0.411489430369534
"05","139","G0501390","2010","3","7","Arkansas","Union County",41639,"","Union County Arkansas",42522,47143,883,2.12060808376762,2.12060808376762,5504,13.2183770023295,13.2183770023295
"05","141","G0501410","2010","3","7","Arkansas","Van Buren County",17295,"","Van Buren County Arkansas",16211,17290,-1084,-6.26770742989303,6.26770742989303,-5,-0.0289100896212778,0.0289100896212778
"05","143","G0501430","2010","3","7","Arkansas","Washington County",203065,"","Washington County Arkansas",202984,210258,-81,-0.039888705586881,0.039888705586881,7193,3.54221554674612,3.54221554674612
"05","145","G0501450","2010","3","7","Arkansas","White County",77076,"","White County Arkansas",77346,75571,270,0.350303596450257,0.350303596450257,-1505,-1.95261819502828,1.95261819502828
"05","147","G0501470","2010","3","7","Arkansas","Woodruff County",7260,"","Woodruff County Arkansas",7249,9063,-11,-0.151515151515152,0.151515151515152,1803,24.8347107438017,24.8347107438017
"05","149","G0501490","2010","3","7","Arkansas","Yell County",22185,"","Yell County Arkansas",22570,22447,385,1.73540680640072,1.73540680640072,262,1.18097813838179,1.18097813838179
"06","001","G0600010","2010","4","9","California","Alameda County",1510271,"","Alameda County California",1500704,1516654,-9567,-0.633462471304819,0.633462471304819,6383,0.422639380614472,0.422639380614472
"06","003","G0600030","2010","4","9","California","Alpine County",1175,"","Alpine County California",1012,1412,-163,-13.8723404255319,13.8723404255319,237,20.1702127659574,20.1702127659574
"06","005","G0600050","2010","4","9","California","Amador County",38091,"","Amador County California",37896,40857,-195,-0.511931952429708,0.511931952429708,2766,7.26155784831063,7.26155784831063
"06","007","G0600070","2010","4","9","California","Butte County",220000,"","Butte County California",220121,228647,121,0.055,0.055,8647,3.93045454545455,3.93045454545455
"06","009","G0600090","2010","4","9","California","Calaveras County",45578,"","Calaveras County California",46403,48507,825,1.81008381236561,1.81008381236561,2929,6.4263460441441,6.4263460441441
"06","011","G0600110","2010","4","9","California","Colusa County",21419,"","Colusa County California",21494,20928,75,0.350156403193426,0.350156403193426,-491,-2.2923572529063,2.2923572529063
"06","013","G0600130","2010","4","9","California","Contra Costa County",1049025,"","Contra Costa County California",1052126,1062555,3101,0.295607826314911,0.295607826314911,13530,1.28976907128047,1.28976907128047
"06","015","G0600150","2010","4","9","California","Del Norte County",28610,"","Del Norte County California",29123,29440,513,1.7930793428871,1.7930793428871,830,2.90108353722475,2.90108353722475
"06","017","G0600170","2010","4","9","California","El Dorado County",181058,"","El Dorado County California",178335,182843,-2723,-1.50393796463012,1.50393796463012,1785,0.985871930541594,0.985871930541594
"06","019","G0600190","2010","4","9","California","Fresno County",930450,"","Fresno County California",921912,918959,-8538,-0.917620506206674,0.917620506206674,-11491,-1.23499382019453,1.23499382019453
"06","021","G0600210","2010","4","9","California","Glenn County",28122,"","Glenn County California",28177,28828,55,0.19557641704004,0.19557641704004,706,2.51049000782306,2.51049000782306
"06","023","G0600230","2010","4","9","California","Humboldt County",134623,"","Humboldt County California",129858,134569,-4765,-3.53951405034801,3.53951405034801,-54,-0.0401120165202083,0.0401120165202083
"06","025","G0600250","2010","4","9","California","Imperial County",174528,"","Imperial County California",168669,178151,-5859,-3.35705445544554,3.35705445544554,3623,2.07588467180051,2.07588467180051
"06","027","G0600270","2010","4","9","California","Inyo County",18546,"","Inyo County California",17221,18070,-1325,-7.14439771379273,7.14439771379273,-476,-2.56659117869082,2.56659117869082
"06","029","G0600290","2010","4","9","California","Kern County",839631,"","Kern County California",812342,787118,-27289,-3.25011820668841,3.25011820668841,-52513,-6.25429504151228,6.25429504151228
"06","031","G0600310","2010","4","9","California","Kings County",152982,"","Kings County California",148565,150819,-4417,-2.88726778313789,2.88726778313789,-2163,-1.41389183041142,1.41389183041142
"06","033","G0600330","2010","4","9","California","Lake County",64665,"","Lake County California",65571,63702,906,1.40106703781025,1.40106703781025,-963,-1.48921363952679,1.48921363952679
"06","035","G0600350","2010","4","9","California","Lassen County",34895,"","Lassen County California",34195,36356,-700,-2.00601805416249,2.00601805416249,1461,4.18684625304485,4.18684625304485
"06","037","G0600370","2010","4","9","California","Los Angeles County",9818605,"","Los Angeles County California",9868572,9863836,49967,0.508901213563434,0.508901213563434,45231,0.460666255542412,0.460666255542412
"06","039","G0600390","2010","4","9","California","Madera County",150865,"","Madera County California",150215,150969,-650,-0.430848772081,0.430848772081,104,0.0689358035329599,0.0689358035329599
"06","041","G0600410","2010","4","9","California","Marin County",252409,"","Marin County California",252064,256002,-345,-0.136682923350594,0.136682923350594,3593,1.42348331477879,1.42348331477879
"06","043","G0600430","2010","4","9","California","Mariposa County",18251,"","Mariposa County California",17684,19286,-567,-3.10667908607748,3.10667908607748,1035,5.67092214125253,5.67092214125253
"06","045","G0600450","2010","4","9","California","Mendocino County",87841,"","Mendocino County California",85854,91530,-1987,-2.26204164342391,2.26204164342391,3689,4.19963342858119,4.19963342858119
"06","047","G0600470","2010","4","9","California","Merced County",255793,"","Merced County California",248443,258707,-7350,-2.8734171771706,2.8734171771706,2914,1.1392024019422,1.1392024019422
"06","049","G0600490","2010","4","9","California","Modoc County",9686,"","Modoc County California",9123,9547,-563,-5.81251290522404,5.81251290522404,-139,-1.43506091265744,1.43506091265744
"06","051","G0600510","2010","4","9","California","Mono County",14202,"","Mono County California",12934,14823,-1268,-8.92831995493592,8.92831995493592,621,4.37262357414449,4.37262357414449
"06","053","G0600530","2010","4","9","California","Monterey County",415057,"","Monterey County California",413771,428117,-1286,-0.309836962152186,0.309836962152186,13060,3.14655577426715,3.14655577426715
"06","055","G0600550","2010","4","9","California","Napa County",136484,"","Napa County California",135749,137031,-735,-0.53852466223147,0.53852466223147,547,0.400779578558659,0.400779578558659
"06","057","G0600570","2010","4","9","California","Nevada County",98764,"","Nevada County California",97836,104611,-928,-0.939613624397554,0.939613624397554,5847,5.92017334251347,5.92017334251347
"06","059","G0600590","2010","4","9","California","Orange County",3010232,"","Orange County California",3050024,3045296,39792,1.32189146883031,1.32189146883031,35064,1.16482716282333,1.16482716282333
"06","061","G0600610","2010","4","9","California","Placer County",348432,"","Placer County California",351962,345454,3530,1.01311016209763,1.01311016209763,-2978,-0.854686136749782,0.854686136749782
"06","063","G0600630","2010","4","9","California","Plumas County",20007,"","Plumas County California",19919,23494,-88,-0.439846053881142,0.439846053881142,3487,17.4288998850402,17.4288998850402
"06","065","G0600650","2010","4","9","California","Riverside County",2189641,"","Riverside County California",2162563,2051975,-27078,-1.23664107495247,1.23664107495247,-137666,-6.28714935462023,6.28714935462023
"06","067","G0600670","2010","4","9","California","Sacramento County",1418788,"","Sacramento County California",1409164,1424963,-9624,-0.678325443970487,0.678325443970487,6175,0.435230633470258,0.435230633470258
"06","069","G0600690","2010","4","9","California","San Benito County",55269,"","San Benito County California",55870,57561,601,1.08740885487344,1.08740885487344,2292,4.14699017532432,4.14699017532432
"06","071","G0600710","2010","4","9","California","San Bernardino County",2035210,"","San Bernardino County California",2032844,1960830,-2366,-0.116253359604169,0.116253359604169,-74380,-3.65465971570501,3.65465971570501
"06","073","G0600730","2010","4","9","California","San Diego County",3095313,"","San Diego County California",3066195,3092369,-29118,-0.940712619369996,0.940712619369996,-2944,-0.0951115444544704,0.0951115444544704
"06","075","G0600750","2010","4","9","California","San Francisco County",805235,"","San Francisco County California",815934,808634,10699,1.32868044732283,1.32868044732283,3399,0.422112799369128,0.422112799369128
"06","077","G0600770","2010","4","9","California","San Joaquin County",685306,"","San Joaquin County California",681063,682622,-4243,-0.619139479298299,0.619139479298299,-2684,-0.391649861521714,0.391649861521714
"06","079","G0600790","2010","4","9","California","San Luis Obispo County",269637,"","San Luis Obispo County California",268026,283399,-1611,-0.597469931797194,0.597469931797194,13762,5.10389894561948,5.10389894561948
"06","081","G0600810","2010","4","9","California","San Mateo County",718451,"","San Mateo County California",723147,725509,4696,0.653628431166496,0.653628431166496,7058,0.982391283469576,0.982391283469576
"06","083","G0600830","2010","4","9","California","Santa Barbara County",423895,"","Santa Barbara County California",408176,424604,-15719,-3.7082296323382,3.7082296323382,709,0.167258401255028,0.167258401255028
"06","085","G0600850","2010","4","9","California","Santa Clara County",1781642,"","Santa Clara County California",1801402,1801039,19760,1.10908925586622,1.10908925586622,19397,1.08871479230957,1.08871479230957
"06","087","G0600870","2010","4","9","California","Santa Cruz County",262382,"","Santa Cruz County California",257678,268052,-4704,-1.79280590894192,1.79280590894192,5670,2.16097140809964,2.16097140809964
"06","089","G0600890","2010","4","9","California","Shasta County",177223,"","Shasta County California",181151,184121,3928,2.21641660506819,2.21641660506819,6898,3.89227131918543,3.89227131918543
"06","091","G0600910","2010","4","9","California","Sierra County",3240,"","Sierra County California",3163,3709,-77,-2.37654320987654,2.37654320987654,469,14.4753086419753,14.4753086419753
"06","093","G0600930","2010","4","9","California","Siskiyou County",44900,"","Siskiyou County California",44583,47927,-317,-0.706013363028953,0.706013363028953,3027,6.74164810690423,6.74164810690423
"06","095","G0600950","2010","4","9","California","Solano County",413344,"","Solano County California",408331,443151,-5013,-1.21279128280561,1.21279128280561,29807,7.21118487264845,7.21118487264845
"06","097","G0600970","2010","4","9","California","Sonoma County",483878,"","Sonoma County California",475037,498007,-8841,-1.82711344595125,1.82711344595125,14129,2.91995089671363,2.91995089671363
"06","099","G0600990","2010","4","9","California","Stanislaus County",514453,"","Stanislaus County California",511277,519315,-3176,-0.617354743776399,0.617354743776399,4862,0.945081474886919,0.945081474886919
"06","101","G0601010","2010","4","9","California","Sutter County",94737,"","Sutter County California",92561,93304,-2176,-2.29688506074712,2.29688506074712,-1433,-1.51260859009679,1.51260859009679
"06","103","G0601030","2010","4","9","California","Tehama County",63463,"","Tehama County California",61553,63502,-1910,-3.00962765706002,3.00962765706002,39,0.0614531301703355,0.0614531301703355
"06","105","G0601050","2010","4","9","California","Trinity County",13786,"","Trinity County California",14173,13665,387,2.80719570578848,2.80719570578848,-121,-0.877702016538517,0.877702016538517
"06","107","G0601070","2010","4","9","California","Tulare County",442179,"","Tulare County California",433618,429534,-8561,-1.936093753887,1.936093753887,-12645,-2.85970161405223,2.85970161405223
"06","109","G0601090","2010","4","9","California","Tuolumne County",55365,"","Tuolumne County California",54593,58807,-772,-1.39438273277341,1.39438273277341,3442,6.21692404948975,6.21692404948975
"06","111","G0601110","2010","4","9","California","Ventura County",823318,"","Ventura County California",808014,819876,-15304,-1.85882004280242,1.85882004280242,-3442,-0.418064465977909,0.418064465977909
"06","113","G0601130","2010","4","9","California","Yolo County",200849,"","Yolo County California",200155,199506,-694,-0.34553321151711,0.34553321151711,-1343,-0.66866153179752,0.66866153179752
"06","115","G0601150","2010","4","9","California","Yuba County",72155,"","Yuba County California",72990,76539,835,1.15723096112536,1.15723096112536,4384,6.07580902224378,6.07580902224378
"08","001","G0800010","2010","4","8","Colorado","Adams County",441603,"","Adams County Colorado",446592,446808,4989,1.12974775986576,1.12974775986576,5205,1.17866047105658,1.17866047105658
"08","003","G0800030","2010","4","8","Colorado","Alamosa County",15445,"","Alamosa County Colorado",15618,16179,173,1.12010359339592,1.12010359339592,734,4.75234703787634,4.75234703787634
"08","005","G0800050","2010","4","8","Colorado","Arapahoe County",572003,"","Arapahoe County Colorado",573771,581634,1768,0.309089287993245,0.309089287993245,9631,1.68373242797678,1.68373242797678
"08","007","G0800070","2010","4","8","Colorado","Archuleta County",12084,"","Archuleta County Colorado",12343,13770,259,2.14333002317114,2.14333002317114,1686,13.9523336643496,13.9523336643496
"08","009","G0800090","2010","4","8","Colorado","Baca County",3788,"","Baca County Colorado",3764,4641,-24,-0.633579725448786,0.633579725448786,853,22.5184794086589,22.5184794086589
"08","011","G0800110","2010","4","8","Colorado","Bent County",6499,"","Bent County Colorado",6693,6110,194,2.98507462686567,2.98507462686567,-389,-5.98553623634405,5.98553623634405
"08","013","G0800130","2010","4","8","Colorado","Boulder County",294567,"","Boulder County Colorado",303838,303338,9271,3.14733150692372,3.14733150692372,8771,2.97759083671966,2.97759083671966
"08","014","G0800140","2010","4","8","Colorado","Broomfield County",55889,"","Broomfield County Colorado",56585,58729,696,1.24532555601281,1.24532555601281,2840,5.0815008320063,5.0815008320063
"08","015","G0800150","2010","4","8","Colorado","Chaffee County",17809,"","Chaffee County Colorado",17147,19602,-662,-3.71722162951317,3.71722162951317,1793,10.0679431747993,10.0679431747993
"08","017","G0800170","2010","4","8","Colorado","Cheyenne County",1836,"","Cheyenne County Colorado",1709,2296,-127,-6.91721132897603,6.91721132897603,460,25.0544662309368,25.0544662309368
"08","019","G0800190","2010","4","8","Colorado","Clear Creek County",9088,"","Clear Creek County Colorado",8750,9895,-338,-3.71919014084507,3.71919014084507,807,8.87984154929578,8.87984154929578
"08","021","G0800210","2010","4","8","Colorado","Conejos County",8256,"","Conejos County Colorado",7984,9384,-272,-3.29457364341085,3.29457364341085,1128,13.6627906976744,13.6627906976744
"08","023","G0800230","2010","4","8","Colorado","Costilla County",3524,"","Costilla County Colorado",3173,3927,-351,-9.96027241770715,9.96027241770715,403,11.4358683314415,11.4358683314415
"08","025","G0800250","2010","4","8","Colorado","Crowley County",5823,"","Crowley County Colorado",6473,5664,650,11.1626309462476,11.1626309462476,-159,-2.73055126223596,2.73055126223596
"08","027","G0800270","2010","4","8","Colorado","Custer County",4255,"","Custer County Colorado",4055,4683,-200,-4.70035252643948,4.70035252643948,428,10.0587544065805,10.0587544065805
"08","029","G0800290","2010","4","8","Colorado","Delta County",30952,"","Delta County Colorado",31091,30111,139,0.449082450245541,0.449082450245541,-841,-2.71711036443525,2.71711036443525
"08","031","G0800310","2010","4","8","Colorado","Denver County",600158,"","Denver County Colorado",622417,617080,22259,3.70885666774416,3.70885666774416,16922,2.81959084107852,2.81959084107852
"08","033","G0800330","2010","4","8","Colorado","Dolores County",2064,"","Dolores County Colorado",1940,1990,-124,-6.0077519379845,6.0077519379845,-74,-3.58527131782946,3.58527131782946
"08","035","G0800350","2010","4","8","Colorado","Douglas County",285465,"","Douglas County Colorado",292172,285533,6707,2.34949993869651,2.34949993869651,68,0.0238207836337204,0.0238207836337204
"08","037","G0800370","2010","4","8","Colorado","Eagle County",52197,"","Eagle County Colorado",53440,51389,1243,2.38136291357741,2.38136291357741,-808,-1.54798168477116,1.54798168477116
"08","039","G0800390","2010","4","8","Colorado","Elbert County",23086,"","Elbert County Colorado",23447,25155,361,1.56371827081348,1.56371827081348,2069,8.96214155765399,8.96214155765399
"08","041","G0800410","2010","4","8","Colorado","El Paso County",622263,"","El Paso County Colorado",613331,633804,-8932,-1.43540592964711,1.43540592964711,11541,1.85468202351739,1.85468202351739
"08","043","G0800430","2010","4","8","Colorado","Fremont County",46824,"","Fremont County Colorado",47501,52201,677,1.44583974030412,1.44583974030412,5377,11.4834273022382,11.4834273022382
"08","045","G0800450","2010","4","8","Colorado","Garfield County",56389,"","Garfield County Colorado",55684,56205,-705,-1.25024384188406,1.25024384188406,-184,-0.326304775754136,0.326304775754136
"08","047","G0800470","2010","4","8","Colorado","Gilpin County",5441,"","Gilpin County Colorado",5653,5657,212,3.89634258408381,3.89634258408381,216,3.96985848189671,3.96985848189671
"08","049","G0800490","2010","4","8","Colorado","Grand County",14843,"","Grand County Colorado",13777,17801,-1066,-7.1818365559523,7.1818365559523,2958,19.9285858653911,19.9285858653911
"08","051","G0800510","2010","4","8","Colorado","Gunnison County",15324,"","Gunnison County Colorado",15345,16936,21,0.137039937353171,0.137039937353171,1612,10.5194466196815,10.5194466196815
"08","053","G0800530","2010","4","8","Colorado","Hinsdale County",843,"","Hinsdale County Colorado",857,878,14,1.66073546856465,1.66073546856465,35,4.15183867141162,4.15183867141162
"08","055","G0800550","2010","4","8","Colorado","Huerfano County",6711,"","Huerfano County Colorado",6698,8767,-13,-0.193711816420802,0.193711816420802,2056,30.6362688123976,30.6362688123976
"08","057","G0800570","2010","4","8","Colorado","Jackson County",1394,"","Jackson County Colorado",1346,1734,-48,-3.44332855093257,3.44332855093257,340,24.390243902439,24.390243902439
"08","059","G0800590","2010","4","8","Colorado","Jefferson County",534543,"","Jefferson County Colorado",540264,568226,5721,1.07026001650008,1.07026001650008,33683,6.30127043100368,6.30127043100368
"08","061","G0800610","2010","4","8","Colorado","Kiowa County",1398,"","Kiowa County Colorado",1249,1642,-149,-10.6580829756795,10.6580829756795,244,17.4535050071531,17.4535050071531
"08","063","G0800630","2010","4","8","Colorado","Kit Carson County",8270,"","Kit Carson County Colorado",8223,8279,-47,-0.568319226118501,0.568319226118501,9,0.108827085852479,0.108827085852479
"08","065","G0800650","2010","4","8","Colorado","Lake County",7310,"","Lake County Colorado",7978,8772,668,9.13816689466484,9.13816689466484,1462,20,20
"08","067","G0800670","2010","4","8","Colorado","La Plata County",51334,"","La Plata County Colorado",52000,55938,666,1.29738574823704,1.29738574823704,4604,8.96871469201699,8.96871469201699
"08","069","G0800690","2010","4","8","Colorado","Larimer County",299630,"","Larimer County Colorado",300290,313005,660,0.220271668391016,0.220271668391016,13375,4.46383873443914,4.46383873443914
"08","071","G0800710","2010","4","8","Colorado","Las Animas County",15507,"","Las Animas County Colorado",15670,16217,163,1.05113819565358,1.05113819565358,710,4.57857741665055,4.57857741665055
"08","073","G0800730","2010","4","8","Colorado","Lincoln County",5467,"","Lincoln County Colorado",5183,6210,-284,-5.19480519480519,5.19480519480519,743,13.5906347173953,13.5906347173953
"08","075","G0800750","2010","4","8","Colorado","Logan County",22709,"","Logan County Colorado",20927,21320,-1782,-7.84710907569686,7.84710907569686,-1389,-6.11651768021489,6.11651768021489
"08","077","G0800770","2010","4","8","Colorado","Mesa County",146723,"","Mesa County Colorado",145808,145178,-915,-0.623624108013059,0.623624108013059,-1545,-1.0530046413991,1.0530046413991
"08","079","G0800790","2010","4","8","Colorado","Mineral County",712,"","Mineral County Colorado",913,936,201,28.2303370786517,28.2303370786517,224,31.4606741573034,31.4606741573034
"08","081","G0800810","2010","4","8","Colorado","Moffat County",13795,"","Moffat County Colorado",14054,14364,259,1.87749184487133,1.87749184487133,569,4.12468285610729,4.12468285610729
"08","083","G0800830","2010","4","8","Colorado","Montezuma County",25535,"","Montezuma County Colorado",25464,25365,-71,-0.278049735656941,0.278049735656941,-170,-0.665752888192677,0.665752888192677
"08","085","G0800850","2010","4","8","Colorado","Montrose County",41276,"","Montrose County Colorado",41104,41943,-172,-0.416707045256323,0.416707045256323,667,1.61595115805795,1.61595115805795
"08","087","G0800870","2010","4","8","Colorado","Morgan County",28159,"","Morgan County Colorado",27857,29333,-302,-1.07248126709045,1.07248126709045,1174,4.16918214425228,4.16918214425228
"08","089","G0800890","2010","4","8","Colorado","Otero County",18831,"","Otero County Colorado",18720,20551,-111,-0.58945356061813,0.58945356061813,1720,9.13387499336201,9.13387499336201
"08","091","G0800910","2010","4","8","Colorado","Ouray County",4436,"","Ouray County Colorado",4680,4971,244,5.50045085662759,5.50045085662759,535,12.0604147880974,12.0604147880974
"08","093","G0800930","2010","4","8","Colorado","Park County",16206,"","Park County Colorado",16956,18329,750,4.6279155868197,4.6279155868197,2123,13.1000863877576,13.1000863877576
"08","095","G0800950","2010","4","8","Colorado","Phillips County",4442,"","Phillips County Colorado",4573,4603,131,2.94912201710941,2.94912201710941,161,3.62449347140927,3.62449347140927
"08","097","G0800970","2010","4","8","Colorado","Pitkin County",17148,"","Pitkin County Colorado",16087,16965,-1061,-6.18731047352461,6.18731047352461,-183,-1.06717984604619,1.06717984604619
"08","099","G0800990","2010","4","8","Colorado","Prowers County",12551,"","Prowers County Colorado",12944,14725,393,3.13122460361724,3.13122460361724,2174,17.3213289777707,17.3213289777707
"08","101","G0801010","2010","4","8","Colorado","Pueblo County",159063,"","Pueblo County Colorado",158939,163483,-124,-0.0779565329460654,0.0779565329460654,4420,2.77877319049685,2.77877319049685
"08","103","G0801030","2010","4","8","Colorado","Rio Blanco County",6666,"","Rio Blanco County Colorado",6401,6726,-265,-3.97539753975398,3.97539753975398,60,0.9000900090009,0.9000900090009
"08","105","G0801050","2010","4","8","Colorado","Rio Grande County",11982,"","Rio Grande County Colorado",11728,13906,-254,-2.11984643632115,2.11984643632115,1924,16.0574194625271,16.0574194625271
"08","107","G0801070","2010","4","8","Colorado","Routt County",23509,"","Routt County Colorado",23305,26886,-204,-0.867752775532775,0.867752775532775,3377,14.3647113871283,14.3647113871283
"08","109","G0801090","2010","4","8","Colorado","Saguache County",6108,"","Saguache County Colorado",7101,7419,993,16.2573673870334,16.2573673870334,1311,21.4636542239686,21.4636542239686
"08","111","G0801110","2010","4","8","Colorado","San Juan County",699,"","San Juan County Colorado",577,645,-122,-17.4535050071531,17.4535050071531,-54,-7.72532188841202,7.72532188841202
"08","113","G0801130","2010","4","8","Colorado","San Miguel County",7359,"","San Miguel County Colorado",7562,8162,203,2.75852697377361,2.75852697377361,803,10.9118086696562,10.9118086696562
"08","115","G0801150","2010","4","8","Colorado","Sedgwick County",2379,"","Sedgwick County Colorado",2292,2739,-87,-3.65699873896595,3.65699873896595,360,15.1324085750315,15.1324085750315
"08","117","G0801170","2010","4","8","Colorado","Summit County",27994,"","Summit County Colorado",27464,28237,-530,-1.89326284203758,1.89326284203758,243,0.868043152104022,0.868043152104022
"08","119","G0801190","2010","4","8","Colorado","Teller County",23350,"","Teller County Colorado",21958,24303,-1392,-5.96145610278373,5.96145610278373,953,4.0813704496788,4.0813704496788
"08","121","G0801210","2010","4","8","Colorado","Washington County",4814,"","Washington County Colorado",4405,5063,-409,-8.49605317823016,8.49605317823016,249,5.17241379310345,5.17241379310345
"08","123","G0801230","2010","4","8","Colorado","Weld County",252825,"","Weld County Colorado",259628,259138,6803,2.69079402748937,2.69079402748937,6313,2.49698407989716,2.49698407989716
"08","125","G0801250","2010","4","8","Colorado","Yuma County",10043,"","Yuma County Colorado",9797,10016,-246,-2.4494672906502,2.4494672906502,-27,-0.268843970925022,0.268843970925022
"09","001","G0900010","2010","1","1","Connecticut","Fairfield County",916829,"","Fairfield County Connecticut",906383,918892,-10446,-1.13936186573505,1.13936186573505,2063,0.225014697397225,0.225014697397225
"09","003","G0900030","2010","1","1","Connecticut","Hartford County",894014,"","Hartford County Connecticut",881061,886401,-12953,-1.44885874270425,1.44885874270425,-7613,-0.851552660249168,0.851552660249168
"09","005","G0900050","2010","1","1","Connecticut","Litchfield County",189927,"","Litchfield County Connecticut",187773,191956,-2154,-1.13411995134973,1.13411995134973,2029,1.06830519094178,1.06830519094178
"09","007","G0900070","2010","1","1","Connecticut","Middlesex County",165676,"","Middlesex County Connecticut",165773,168089,97,0.0585480093676815,0.0585480093676815,2413,1.45645718148676,1.45645718148676
"09","009","G0900090","2010","1","1","Connecticut","New Haven County",862477,"","New Haven County Connecticut",850067,846546,-12410,-1.43887894981547,1.43887894981547,-15931,-1.84712172034733,1.84712172034733
"09","011","G0900110","2010","1","1","Connecticut","New London County",274055,"","New London County Connecticut",264140,274898,-9915,-3.61788692050866,3.61788692050866,843,0.307602488551568,0.307602488551568
"09","013","G0900130","2010","1","1","Connecticut","Tolland County",152691,"","Tolland County Connecticut",150966,149944,-1725,-1.12973259720612,1.12973259720612,-2747,-1.79905822871027,1.79905822871027
"09","015","G0900150","2010","1","1","Connecticut","Windham County",118428,"","Windham County Connecticut",117762,117371,-666,-0.562367007802209,0.562367007802209,-1057,-0.892525416286689,0.892525416286689
"10","001","G1000010","2010","3","5","Delaware","Kent County",162310,"","Kent County Delaware",159175,161585,-3135,-1.93148912574703,1.93148912574703,-725,-0.446676113609759,0.446676113609759
"10","003","G1000030","2010","3","5","Delaware","New Castle County",538479,"","New Castle County Delaware",536356,537274,-2123,-0.394258643326852,0.394258643326852,-1205,-0.223778457470022,0.223778457470022
"10","005","G1000050","2010","3","5","Delaware","Sussex County",197145,"","Sussex County Delaware",194191,200657,-2954,-1.49838951025895,1.49838951025895,3512,1.78142991199371,1.78142991199371
"11","001","G1100010","2010","3","5","District Of Columbia","District Of Columbia",601723,"","District Of Columbia District Of Columbia",607918,594071,6195,1.02954349426563,1.02954349426563,-7652,-1.27168148799365,1.27168148799365
"12","001","G1200010","2010","3","5","Florida","Alachua County",247336,"","Alachua County Florida",244056,253722,-3280,-1.32613125464955,1.32613125464955,6386,2.58191286347317,2.58191286347317
"12","003","G1200030","2010","3","5","Florida","Baker County",27115,"","Baker County Florida",26173,26433,-942,-3.4740918310898,3.4740918310898,-682,-2.51521298174442,2.51521298174442
"12","005","G1200050","2010","3","5","Florida","Bay County",168852,"","Bay County Florida",165235,187802,-3617,-2.14211261933528,2.14211261933528,18950,11.2228460426883,11.2228460426883
"12","007","G1200070","2010","3","5","Florida","Bradford County",28520,"","Bradford County Florida",28727,27989,207,0.725806451612903,0.725806451612903,-531,-1.86185133239832,1.86185133239832
"12","009","G1200090","2010","3","5","Florida","Brevard County",543376,"","Brevard County Florida",535711,577269,-7665,-1.41062542327964,1.41062542327964,33893,6.23748564529902,6.23748564529902
"12","011","G1200110","2010","3","5","Florida","Broward County",1748066,"","Broward County Florida",1782500,1766826,34434,1.96983409093249,1.96983409093249,18760,1.07318602386866,1.07318602386866
"12","013","G1200130","2010","3","5","Florida","Calhoun County",14625,"","Calhoun County Florida",13607,13708,-1018,-6.96068376068376,6.96068376068376,-917,-6.27008547008547,6.27008547008547
"12","015","G1200150","2010","3","5","Florida","Charlotte County",159978,"","Charlotte County Florida",156718,180373,-3260,-2.03778019477678,2.03778019477678,20395,12.7486279363412,12.7486279363412
"12","017","G1200170","2010","3","5","Florida","Citrus County",141236,"","Citrus County Florida",139851,146685,-1385,-0.980628168455635,0.980628168455635,5449,3.85808150896372,3.85808150896372
"12","019","G1200190","2010","3","5","Florida","Clay County",190865,"","Clay County Florida",187604,192470,-3261,-1.7085374479344,1.7085374479344,1605,0.840908495533492,0.840908495533492
"12","021","G1200210","2010","3","5","Florida","Collier County",321520,"","Collier County Florida",320911,338740,-609,-0.189412789251057,0.189412789251057,17220,5.35580990296094,5.35580990296094
"12","023","G1200230","2010","3","5","Florida","Columbia County",67531,"","Columbia County Florida",69437,63397,1906,2.82240748693193,2.82240748693193,-4134,-6.12163302779464,6.12163302779464
"12","027","G1200270","2010","3","5","Florida","DeSoto County",34862,"","DeSoto County Florida",35818,35144,956,2.74224083529344,2.74224083529344,282,0.808903677356434,0.808903677356434
"12","029","G1200290","2010","3","5","Florida","Dixie County",16422,"","Dixie County Florida",14639,14998,-1783,-10.857386432834,10.857386432834,-1424,-8.67129460479844,8.67129460479844
"12","031","G1200310","2010","3","5","Florida","Duval County",864263,"","Duval County Florida",858957,941658,-5306,-0.613933490152882,0.613933490152882,77395,8.95502873546594,8.95502873546594
"12","033","G1200330","2010","3","5","Florida","Escambia County",297619,"","Escambia County Florida",301694,332336,4075,1.36920021907204,1.36920021907204,34717,11.6649138663862,11.6649138663862
"12","035","G1200350","2010","3","5","Florida","Flagler County",95696,"","Flagler County Florida",92173,100470,-3523,-3.6814495903695,3.6814495903695,4774,4.98871426182913,4.98871426182913
"12","037","G1200370","2010","3","5","Florida","Franklin County",11549,"","Franklin County Florida",11230,11688,-319,-2.76214390856351,2.76214390856351,139,1.20356740843363,1.20356740843363
"12","039","G1200390","2010","3","5","Florida","Gadsden County",46389,"","Gadsden County Florida",47699,49307,1310,2.82394533186747,2.82394533186747,2918,6.2902843346483,6.2902843346483
"12","041","G1200410","2010","3","5","Florida","Gilchrist County",16939,"","Gilchrist County Florida",17177,16150,238,1.40504161993034,1.40504161993034,-789,-4.65789007615562,4.65789007615562
"12","043","G1200430","2010","3","5","Florida","Glades County",12884,"","Glades County Florida",10862,11223,-2022,-15.6938838869916,15.6938838869916,-1661,-12.8919590189382,12.8919590189382
"12","045","G1200450","2010","3","5","Florida","Gulf County",15863,"","Gulf County Florida",15627,16987,-236,-1.48773876315955,1.48773876315955,1124,7.08567105843787,7.08567105843787
"12","047","G1200470","2010","3","5","Florida","Hamilton County",14799,"","Hamilton County Florida",14369,14148,-430,-2.90560172984661,2.90560172984661,-651,-4.39894587472126,4.39894587472126
"12","049","G1200490","2010","3","5","Florida","Hardee County",27731,"","Hardee County Florida",29692,29199,1961,7.07150842017958,7.07150842017958,1468,5.29371461541235,5.29371461541235
"12","051","G1200510","2010","3","5","Florida","Hendry County",39140,"","Hendry County Florida",39649,40015,509,1.30045988758304,1.30045988758304,875,2.23556463975473,2.23556463975473
"12","053","G1200530","2010","3","5","Florida","Hernando County",172778,"","Hernando County Florida",171725,169705,-1053,-0.609452592343933,0.609452592343933,-3073,-1.77858292143676,1.77858292143676
"12","055","G1200550","2010","3","5","Florida","Highlands County",98786,"","Highlands County Florida",98296,99634,-490,-0.49602170348025,0.49602170348025,848,0.858421233778066,0.858421233778066
"12","057","G1200570","2010","3","5","Florida","Hillsborough County",1229226,"","Hillsborough County Florida",1208406,1241196,-20820,-1.69374874921292,1.69374874921292,11970,0.97378350278956,0.97378350278956
"12","059","G1200590","2010","3","5","Florida","Holmes County",19927,"","Holmes County Florida",18724,19696,-1203,-6.03703517840116,6.03703517840116,-231,-1.15923119385758,1.15923119385758
"12","061","G1200610","2010","3","5","Florida","Indian River County",138028,"","Indian River County Florida",135613,153506,-2415,-1.74964499956531,1.74964499956531,15478,11.2136667922451,11.2136667922451
"12","063","G1200630","2010","3","5","Florida","Jackson County",49746,"","Jackson County Florida",50570,50239,824,1.65641458609737,1.65641458609737,493,0.99103445503156,0.99103445503156
"12","065","G1200650","2010","3","5","Florida","Jefferson County",14761,"","Jefferson County Florida",14015,14565,-746,-5.05385813969243,5.05385813969243,-196,-1.32782331820337,1.32782331820337
"12","067","G1200670","2010","3","5","Florida","Lafayette County",8870,"","Lafayette County Florida",8347,7534,-523,-5.89627959413754,5.89627959413754,-1336,-15.0620067643743,15.0620067643743
"12","069","G1200690","2010","3","5","Florida","Lake County",297052,"","Lake County Florida",314589,298206,17537,5.90368016374238,5.90368016374238,1154,0.388484171121554,0.388484171121554
"12","071","G1200710","2010","3","5","Florida","Lee County",618754,"","Lee County Florida",591305,656681,-27449,-4.43617334190971,4.43617334190971,37927,6.12957653607088,6.12957653607088
"12","073","G1200730","2010","3","5","Florida","Leon County",275487,"","Leon County Florida",267636,285027,-7851,-2.84986224395344,2.84986224395344,9540,3.46295832471224,3.46295832471224
"12","075","G1200750","2010","3","5","Florida","Levy County",40801,"","Levy County Florida",38907,38158,-1894,-4.64204308717924,4.64204308717924,-2643,-6.47778240729394,6.47778240729394
"12","077","G1200770","2010","3","5","Florida","Liberty County",8365,"","Liberty County Florida",7909,7347,-456,-5.45128511655708,5.45128511655708,-1018,-12.1697549312612,12.1697549312612
"12","079","G1200790","2010","3","5","Florida","Madison County",19224,"","Madison County Florida",18772,19937,-452,-2.35122763212651,2.35122763212651,713,3.70890553474823,3.70890553474823
"12","081","G1200810","2010","3","5","Florida","Manatee County",322833,"","Manatee County Florida",319336,329263,-3497,-1.08322259496396,1.08322259496396,6430,1.99174186034265,1.99174186034265
"12","083","G1200830","2010","3","5","Florida","Marion County",331298,"","Marion County Florida",327542,343829,-3756,-1.13372250964389,1.13372250964389,12531,3.78239530573683,3.78239530573683
"12","085","G1200850","2010","3","5","Florida","Martin County",146318,"","Martin County Florida",140197,147411,-6121,-4.183354064435,4.183354064435,1093,0.747003102830821,0.747003102830821
"12","086","G1200860","2010","3","5","Florida","Miami-Dade County",2496435,"","Miami-Dade County Florida",2525545,2592929,29110,1.16606280556073,1.16606280556073,96494,3.8652718776976,3.8652718776976
"12","087","G1200870","2010","3","5","Florida","Monroe County",73090,"","Monroe County Florida",73460,83613,370,0.506225201805993,0.506225201805993,10523,14.3973183746066,14.3973183746066
"12","089","G1200890","2010","3","5","Florida","Nassau County",73314,"","Nassau County Florida",71147,76129,-2167,-2.95577925089342,2.95577925089342,2815,3.83964863464004,3.83964863464004
"12","091","G1200910","2010","3","5","Florida","Okaloosa County",180822,"","Okaloosa County Florida",176056,204971,-4766,-2.63574122617823,2.63574122617823,24149,13.3551227173685,13.3551227173685
"12","093","G1200930","2010","3","5","Florida","Okeechobee County",39996,"","Okeechobee County Florida",40426,39454,430,1.07510751075108,1.07510751075108,-542,-1.35513551355136,1.35513551355136
"12","095","G1200950","2010","3","5","Florida","Orange County",1145956,"","Orange County Florida",1096536,1153811,-49420,-4.312556503042,4.312556503042,7855,0.685453891772459,0.685453891772459
"12","097","G1200970","2010","3","5","Florida","Osceola County",268685,"","Osceola County Florida",273892,293871,5207,1.93795708729553,1.93795708729553,25186,9.37380203584123,9.37380203584123
"12","099","G1200990","2010","3","5","Florida","Palm Beach County",1320134,"","Palm Beach County Florida",1287881,1306125,-32253,-2.44316107304259,2.44316107304259,-14009,-1.06118015292387,1.06118015292387
"12","101","G1201010","2010","3","5","Florida","Pasco County",464697,"","Pasco County Florida",472402,443598,7705,1.65806966690123,1.65806966690123,-21099,-4.5403779236793,4.5403779236793
"12","103","G1201030","2010","3","5","Florida","Pinellas County",916542,"","Pinellas County Florida",909788,957985,-6754,-0.736900218429706,0.736900218429706,41443,4.52166949250553,4.52166949250553
"12","105","G1201050","2010","3","5","Florida","Polk County",602095,"","Polk County Florida",584473,608447,-17622,-2.92678065753743,2.92678065753743,6352,1.05498301763011,1.05498301763011
"12","107","G1201070","2010","3","5","Florida","Putnam County",74364,"","Putnam County Florida",72544,74124,-1820,-2.44742079500834,2.44742079500834,-240,-0.322736808132968,0.322736808132968
"12","109","G1201090","2010","3","5","Florida","St. Johns County",190039,"","St. Johns County Florida",191159,185076,1120,0.589352711811786,0.589352711811786,-4963,-2.61156920421598,2.61156920421598
"12","111","G1201110","2010","3","5","Florida","St. Lucie County",277789,"","St. Lucie County Florida",268752,280796,-9037,-3.25318857118172,3.25318857118172,3007,1.08247626795877,1.08247626795877
"12","113","G1201130","2010","3","5","Florida","Santa Rosa County",151372,"","Santa Rosa County Florida",153068,144603,1696,1.12041857146632,1.12041857146632,-6769,-4.47176492349972,4.47176492349972
"12","115","G1201150","2010","3","5","Florida","Sarasota County",379448,"","Sarasota County Florida",370312,396549,-9136,-2.40770803904619,2.40770803904619,17101,4.50680989226455,4.50680989226455
"12","117","G1201170","2010","3","5","Florida","Seminole County",422718,"","Seminole County Florida",415181,435287,-7537,-1.78298534720547,1.78298534720547,12569,2.97337705042132,2.97337705042132
"12","119","G1201190","2010","3","5","Florida","Sumter County",93420,"","Sumter County Florida",78756,106111,-14664,-15.6968529222864,15.6968529222864,12691,13.5848854634982,13.5848854634982
"12","121","G1201210","2010","3","5","Florida","Suwannee County",41551,"","Suwannee County Florida",40130,37784,-1421,-3.41989362470217,3.41989362470217,-3767,-9.06596712473827,9.06596712473827
"12","123","G1201230","2010","3","5","Florida","Taylor County",22570,"","Taylor County Florida",21409,20253,-1161,-5.14399645547187,5.14399645547187,-2317,-10.2658396101019,10.2658396101019
"12","125","G1201250","2010","3","5","Florida","Union County",15535,"","Union County Florida",14511,14626,-1024,-6.59156742838751,6.59156742838751,-909,-5.85130350820727,5.85130350820727
"12","127","G1201270","2010","3","5","Florida","Volusia County",494593,"","Volusia County Florida",494368,522145,-225,-0.0454919499467239,0.0454919499467239,27552,5.57064091080949,5.57064091080949
"12","129","G1201290","2010","3","5","Florida","Wakulla County",30776,"","Wakulla County Florida",33130,32160,2354,7.64881726020276,7.64881726020276,1384,4.49701065765532,4.49701065765532
"12","131","G1201310","2010","3","5","Florida","Walton County",55043,"","Walton County Florida",55439,59261,396,0.719437530657849,0.719437530657849,4218,7.66309975837073,7.66309975837073
"12","133","G1201330","2010","3","5","Florida","Washington County",24896,"","Washington County Florida",23998,22619,-898,-3.60700514138817,3.60700514138817,-2277,-9.14604755784062,9.14604755784062
"13","001","G1300010","2010","3","5","Georgia","Appling County",18236,"","Appling County Georgia",18112,17866,-124,-0.679973678438254,0.679973678438254,-370,-2.0289537179206,2.0289537179206
"13","003","G1300030","2010","3","5","Georgia","Atkinson County",8375,"","Atkinson County Georgia",8146,7813,-229,-2.73432835820896,2.73432835820896,-562,-6.71044776119403,6.71044776119403
"13","005","G1300050","2010","3","5","Georgia","Bacon County",11096,"","Bacon County Georgia",10551,10299,-545,-4.91167988464311,4.91167988464311,-797,-7.18276856524874,7.18276856524874
"13","007","G1300070","2010","3","5","Georgia","Baker County",3451,"","Baker County Georgia",3452,4155,1,0.0289771080846132,0.0289771080846132,704,20.3998840915677,20.3998840915677
"13","009","G1300090","2010","3","5","Georgia","Baldwin County",45720,"","Baldwin County Georgia",43533,51663,-2187,-4.78346456692913,4.78346456692913,5943,12.998687664042,12.998687664042
"13","011","G1300110","2010","3","5","Georgia","Banks County",18395,"","Banks County Georgia",16894,17399,-1501,-8.1598260396847,8.1598260396847,-996,-5.4145148138081,5.4145148138081
"13","013","G1300130","2010","3","5","Georgia","Barrow County",69367,"","Barrow County Georgia",73135,71309,3768,5.43197774157741,5.43197774157741,1942,2.79960211628008,2.79960211628008
"13","015","G1300150","2010","3","5","Georgia","Bartow County",100157,"","Bartow County Georgia",96059,100206,-4098,-4.09157622532624,4.09157622532624,49,0.0489231905907725,0.0489231905907725
"13","017","G1300170","2010","3","5","Georgia","Ben Hill County",17634,"","Ben Hill County Georgia",17584,18537,-50,-0.283543155268232,0.283543155268232,903,5.12078938414427,5.12078938414427
"13","019","G1300190","2010","3","5","Georgia","Berrien County",19286,"","Berrien County Georgia",17016,17600,-2270,-11.7701959970963,11.7701959970963,-1686,-8.74209270973763,8.74209270973763
"13","021","G1300210","2010","3","5","Georgia","Bibb County",155547,"","Bibb County Georgia",156619,166163,1072,0.689180762084772,0.689180762084772,10616,6.82494680064546,6.82494680064546
"13","023","G1300230","2010","3","5","Georgia","Bleckley County",13063,"","Bleckley County Georgia",12798,12543,-265,-2.02863048304371,2.02863048304371,-520,-3.98070887238766,3.98070887238766
"13","025","G1300250","2010","3","5","Georgia","Brantley County",18411,"","Brantley County Georgia",15870,15124,-2541,-13.8015316930096,13.8015316930096,-3287,-17.8534571723426,17.8534571723426
"13","027","G1300270","2010","3","5","Georgia","Brooks County",16243,"","Brooks County Georgia",16316,18205,73,0.449424367419812,0.449424367419812,1962,12.0790494366804,12.0790494366804
"13","029","G1300290","2010","3","5","Georgia","Bryan County",30233,"","Bryan County Georgia",32828,34117,2595,8.5833360897033,8.5833360897033,3884,12.8468891608507,12.8468891608507
"13","031","G1300310","2010","3","5","Georgia","Bulloch County",70217,"","Bulloch County Georgia",71129,70988,912,1.29883076747796,1.29883076747796,771,1.09802469487446,1.09802469487446
"13","033","G1300330","2010","3","5","Georgia","Burke County",23316,"","Burke County Georgia",23030,23941,-286,-1.22662549322354,1.22662549322354,625,2.68056270372277,2.68056270372277
"13","035","G1300350","2010","3","5","Georgia","Butts County",23655,"","Butts County Georgia",24267,24818,612,2.58719086873811,2.58719086873811,1163,4.91650813781442,4.91650813781442
"13","037","G1300370","2010","3","5","Georgia","Calhoun County",6694,"","Calhoun County Georgia",6335,6468,-359,-5.36301165222587,5.36301165222587,-226,-3.37615775321183,3.37615775321183
"13","039","G1300390","2010","3","5","Georgia","Camden County",50513,"","Camden County Georgia",48058,56697,-2455,-4.86013501474868,4.86013501474868,6184,12.2423930473343,12.2423930473343
"13","043","G1300430","2010","3","5","Georgia","Candler County",10998,"","Candler County Georgia",10704,9925,-294,-2.67321331151118,2.67321331151118,-1073,-9.75631933078742,9.75631933078742
"13","045","G1300450","2010","3","5","Georgia","Carroll County",110527,"","Carroll County Georgia",114958,118034,4431,4.00897518253458,4.00897518253458,7507,6.79200557329883,6.79200557329883
"13","047","G1300470","2010","3","5","Georgia","Catoosa County",63942,"","Catoosa County Georgia",63801,65092,-141,-0.220512339307497,0.220512339307497,1150,1.79850489506115,1.79850489506115
"13","049","G1300490","2010","3","5","Georgia","Charlton County",12171,"","Charlton County Georgia",10186,11145,-1985,-16.3092597157177,16.3092597157177,-1026,-8.42987429134829,8.42987429134829
"13","051","G1300510","2010","3","5","Georgia","Chatham County",265128,"","Chatham County Georgia",259327,276287,-5801,-2.18799975860716,2.18799975860716,11159,4.20891041308349,4.20891041308349
"13","053","G1300530","2010","3","5","Georgia","Chattahoochee County",11267,"","Chattahoochee County Georgia",13021,15173,1754,15.5675867577882,15.5675867577882,3906,34.6676133842194,34.6676133842194
"13","055","G1300550","2010","3","5","Georgia","Chattooga County",26015,"","Chattooga County Georgia",26823,26110,808,3.10590044205266,3.10590044205266,95,0.365173938112627,0.365173938112627
"13","057","G1300570","2010","3","5","Georgia","Cherokee County",214346,"","Cherokee County Georgia",216411,223245,2065,0.963395631362377,0.963395631362377,8899,4.15169865544493,4.15169865544493
"13","059","G1300590","2010","3","5","Georgia","Clarke County",116714,"","Clarke County Georgia",116868,122583,154,0.131946467433213,0.131946467433213,5869,5.02853128159432,5.02853128159432
"13","061","G1300610","2010","3","5","Georgia","Clay County",3183,"","Clay County Georgia",3071,3626,-112,-3.51869305686459,3.51869305686459,443,13.9176877159912,13.9176877159912
"13","063","G1300630","2010","3","5","Georgia","Clayton County",259424,"","Clayton County Georgia",276100,293663,16676,6.4280868385346,6.4280868385346,34239,13.1980849882817,13.1980849882817
"13","065","G1300650","2010","3","5","Georgia","Clinch County",6798,"","Clinch County Georgia",6904,7084,106,1.55928214180641,1.55928214180641,286,4.20711974110032,4.20711974110032
"13","067","G1300670","2010","3","5","Georgia","Cobb County",688078,"","Cobb County Georgia",717756,718752,29678,4.31317379715672,4.31317379715672,30674,4.45792482828982,4.45792482828982
"13","069","G1300690","2010","3","5","Georgia","Coffee County",42356,"","Coffee County Georgia",41109,40652,-1247,-2.94409292662197,2.94409292662197,-1704,-4.02304278024365,4.02304278024365
"13","071","G1300710","2010","3","5","Georgia","Colquitt County",45498,"","Colquitt County Georgia",46173,44972,675,1.48358169589872,1.48358169589872,-526,-1.15609477339663,1.15609477339663
"13","073","G1300730","2010","3","5","Georgia","Columbia County",124053,"","Columbia County Georgia",115010,122159,-9043,-7.28962620815297,7.28962620815297,-1894,-1.52676678516441,1.52676678516441
"13","075","G1300750","2010","3","5","Georgia","Cook County",17212,"","Cook County Georgia",16624,17475,-588,-3.41622124099465,3.41622124099465,263,1.52800371833604,1.52800371833604
"13","077","G1300770","2010","3","5","Georgia","Coweta County",127317,"","Coweta County Georgia",128774,128490,1457,1.14438763087412,1.14438763087412,1173,0.921322368576074,0.921322368576074
"13","079","G1300790","2010","3","5","Georgia","Crawford County",12630,"","Crawford County Georgia",12139,15121,-491,-3.88756927949327,3.88756927949327,2491,19.72288202692,19.72288202692
"13","081","G1300810","2010","3","5","Georgia","Crisp County",23439,"","Crisp County Georgia",22255,23573,-1184,-5.05141004309058,5.05141004309058,134,0.57169674474167,0.57169674474167
"13","083","G1300830","2010","3","5","Georgia","Dade County",16633,"","Dade County Georgia",16033,15862,-600,-3.60728671917273,3.60728671917273,-771,-4.63536343413696,4.63536343413696
"13","085","G1300850","2010","3","5","Georgia","Dawson County",22330,"","Dawson County Georgia",22354,22796,24,0.107478728168383,0.107478728168383,466,2.08687863860278,2.08687863860278
"13","087","G1300870","2010","3","5","Georgia","Decatur County",27842,"","Decatur County Georgia",28816,33251,974,3.49831190288054,3.49831190288054,5409,19.4274836577832,19.4274836577832
"13","089","G1300890","2010","3","5","Georgia","DeKalb County",691893,"","DeKalb County Georgia",751385,801933,59492,8.59843935406197,8.59843935406197,110040,15.9041932784405,15.9041932784405
"13","091","G1300910","2010","3","5","Georgia","Dodge County",21796,"","Dodge County Georgia",19821,19995,-1975,-9.06129565057809,9.06129565057809,-1801,-8.26298403376766,8.26298403376766
"13","093","G1300930","2010","3","5","Georgia","Dooly County",14918,"","Dooly County Georgia",11595,11777,-3323,-22.2751039013273,22.2751039013273,-3141,-21.0551012200027,21.0551012200027
"13","095","G1300950","2010","3","5","Georgia","Dougherty County",94565,"","Dougherty County Georgia",95467,101239,902,0.953841273198329,0.953841273198329,6674,7.05757944271136,7.05757944271136
"13","097","G1300970","2010","3","5","Georgia","Douglas County",132403,"","Douglas County Georgia",130838,131990,-1565,-1.18199738676616,1.18199738676616,-413,-0.311926466922955,0.311926466922955
"13","099","G1300990","2010","3","5","Georgia","Early County",11008,"","Early County Georgia",11513,12814,505,4.5875726744186,4.5875726744186,1806,16.40625,16.40625
"13","101","G1301010","2010","3","5","Georgia","Echols County",4034,"","Echols County Georgia",4381,3919,347,8.601883986118,8.601883986118,-115,-2.85076846802181,2.85076846802181
"13","103","G1301030","2010","3","5","Georgia","Effingham County",52250,"","Effingham County Georgia",54002,52156,1752,3.35311004784689,3.35311004784689,-94,-0.179904306220096,0.179904306220096
"13","105","G1301050","2010","3","5","Georgia","Elbert County",20166,"","Elbert County Georgia",20246,21573,80,0.396707329167906,0.396707329167906,1407,6.97709015174055,6.97709015174055
"13","107","G1301070","2010","3","5","Georgia","Emanuel County",22598,"","Emanuel County Georgia",23390,22646,792,3.50473493229489,3.50473493229489,48,0.212408177714842,0.212408177714842
"13","109","G1301090","2010","3","5","Georgia","Evans County",11000,"","Evans County Georgia",11698,11266,698,6.34545454545455,6.34545454545455,266,2.41818181818182,2.41818181818182
"13","111","G1301110","2010","3","5","Georgia","Fannin County",23682,"","Fannin County Georgia",22760,30004,-922,-3.89325225909974,3.89325225909974,6322,26.6953804577316,26.6953804577316
"13","113","G1301130","2010","3","5","Georgia","Fayette County",106567,"","Fayette County Georgia",108025,110350,1458,1.36815336830351,1.36815336830351,3783,3.54987941858174,3.54987941858174
"13","115","G1301150","2010","3","5","Georgia","Floyd County",96317,"","Floyd County Georgia",96541,99951,224,0.232565383058027,0.232565383058027,3634,3.7729580447896,3.7729580447896
"13","117","G1301170","2010","3","5","Georgia","Forsyth County",175511,"","Forsyth County Georgia",177746,173663,2235,1.2734244577263,1.2734244577263,-1848,-1.05292545766362,1.05292545766362
"13","119","G1301190","2010","3","5","Georgia","Franklin County",22084,"","Franklin County Georgia",21583,21055,-501,-2.26861075892049,2.26861075892049,-1029,-4.65948197790255,4.65948197790255
"13","121","G1301210","2010","3","5","Georgia","Fulton County",920581,"","Fulton County Georgia",1048872,1042540,128291,13.9358731062231,13.9358731062231,121959,13.2480466140405,13.2480466140405
"13","123","G1301230","2010","3","5","Georgia","Gilmer County",28292,"","Gilmer County Georgia",29070,33582,778,2.74989396295773,2.74989396295773,5290,18.6978651208822,18.6978651208822
"13","125","G1301250","2010","3","5","Georgia","Glascock County",3082,"","Glascock County Georgia",2790,2642,-292,-9.47436729396496,9.47436729396496,-440,-14.2764438676184,14.2764438676184
"13","127","G1301270","2010","3","5","Georgia","Glynn County",79626,"","Glynn County Georgia",77364,81306,-2262,-2.84078064953658,2.84078064953658,1680,2.10986361238791,2.10986361238791
"13","129","G1301290","2010","3","5","Georgia","Gordon County",55186,"","Gordon County Georgia",53213,55027,-1973,-3.57518211140507,3.57518211140507,-159,-0.288116551299243,0.288116551299243
"13","131","G1301310","2010","3","5","Georgia","Grady County",25011,"","Grady County Georgia",25514,25789,503,2.01111510935189,2.01111510935189,778,3.11063132221822,3.11063132221822
"13","133","G1301330","2010","3","5","Georgia","Greene County",15994,"","Greene County Georgia",15782,18766,-212,-1.32549706139802,1.32549706139802,2772,17.3314993122421,17.3314993122421
"13","135","G1301350","2010","3","5","Georgia","Gwinnett County",805321,"","Gwinnett County Georgia",817474,811303,12153,1.50908768056464,1.50908768056464,5982,0.742809389051074,0.742809389051074
"13","137","G1301370","2010","3","5","Georgia","Habersham County",43041,"","Habersham County Georgia",43610,44403,569,1.32199530680049,1.32199530680049,1362,3.16442461838712,3.16442461838712
"13","139","G1301390","2010","3","5","Georgia","Hall County",179684,"","Hall County Georgia",189394,177715,9710,5.403931346141,5.403931346141,-1969,-1.09581264887246,1.09581264887246
"13","141","G1301410","2010","3","5","Georgia","Hancock County",9429,"","Hancock County Georgia",9127,11258,-302,-3.20288471736133,3.20288471736133,1829,19.3976031392512,19.3976031392512
"13","143","G1301430","2010","3","5","Georgia","Haralson County",28780,"","Haralson County Georgia",29015,29209,235,0.816539263377345,0.816539263377345,429,1.49061848505907,1.49061848505907
"13","145","G1301450","2010","3","5","Georgia","Harris County",32024,"","Harris County Georgia",30520,30123,-1504,-4.69647764176867,4.69647764176867,-1901,-5.93617287034724,5.93617287034724
"13","147","G1301470","2010","3","5","Georgia","Hart County",25213,"","Hart County Georgia",24201,25624,-1012,-4.01380240352199,4.01380240352199,411,1.63011145044223,1.63011145044223
"13","149","G1301490","2010","3","5","Georgia","Heard County",11834,"","Heard County Georgia",11512,11985,-322,-2.72097346628359,2.72097346628359,151,1.27598445158019,1.27598445158019
"13","151","G1301510","2010","3","5","Georgia","Henry County",203922,"","Henry County Georgia",198635,204761,-5287,-2.59265797706966,2.59265797706966,839,0.411431821971146,0.411431821971146
"13","153","G1301530","2010","3","5","Georgia","Houston County",139900,"","Houston County Georgia",137163,148403,-2737,-1.95639742673338,1.95639742673338,8503,6.07791279485347,6.07791279485347
"13","155","G1301550","2010","3","5","Georgia","Irwin County",9538,"","Irwin County Georgia",9999,10160,461,4.83329838540575,4.83329838540575,622,6.52128328790103,6.52128328790103
"13","157","G1301570","2010","3","5","Georgia","Jackson County",60485,"","Jackson County Georgia",63874,63270,3389,5.6030420765479,5.6030420765479,2785,4.60444738364884,4.60444738364884
"13","159","G1301590","2010","3","5","Georgia","Jasper County",13900,"","Jasper County Georgia",14087,15009,187,1.34532374100719,1.34532374100719,1109,7.97841726618705,7.97841726618705
"13","161","G1301610","2010","3","5","Georgia","Jeff Davis County",15068,"","Jeff Davis County Georgia",13669,12934,-1399,-9.28457658614282,9.28457658614282,-2134,-14.1624634988054,14.1624634988054
"13","163","G1301630","2010","3","5","Georgia","Jefferson County",16930,"","Jefferson County Georgia",16335,17834,-595,-3.51447135262847,3.51447135262847,904,5.33963378617838,5.33963378617838
"13","165","G1301650","2010","3","5","Georgia","Jenkins County",8340,"","Jenkins County Georgia",8482,8738,142,1.70263788968825,1.70263788968825,398,4.77218225419664,4.77218225419664
"13","167","G1301670","2010","3","5","Georgia","Johnson County",9980,"","Johnson County Georgia",9178,8665,-802,-8.03607214428858,8.03607214428858,-1315,-13.1763527054108,13.1763527054108
"13","169","G1301690","2010","3","5","Georgia","Jones County",28669,"","Jones County Georgia",27743,29147,-926,-3.22996965363284,3.22996965363284,478,1.66730614949946,1.66730614949946
"13","171","G1301710","2010","3","5","Georgia","Lamar County",18317,"","Lamar County Georgia",17548,19282,-769,-4.19828574548234,4.19828574548234,965,5.2683299666976,5.2683299666976
"13","173","G1301730","2010","3","5","Georgia","Lanier County",10078,"","Lanier County Georgia",8565,9371,-1513,-15.0128993847986,15.0128993847986,-707,-7.01528080968446,7.01528080968446
"13","175","G1301750","2010","3","5","Georgia","Laurens County",48434,"","Laurens County Georgia",48351,46388,-83,-0.171367221373415,0.171367221373415,-2046,-4.22430524012058,4.22430524012058
"13","177","G1301770","2010","3","5","Georgia","Lee County",28298,"","Lee County Georgia",34731,33939,6433,22.7330553396,22.7330553396,5641,19.9342709732137,19.9342709732137
"13","179","G1301790","2010","3","5","Georgia","Liberty County",63453,"","Liberty County Georgia",57290,71130,-6163,-9.71270073912975,9.71270073912975,7677,12.0987187367028,12.0987187367028
"13","181","G1301810","2010","3","5","Georgia","Lincoln County",7996,"","Lincoln County Georgia",7804,8997,-192,-2.40120060030015,2.40120060030015,1001,12.5187593796898,12.5187593796898
"13","183","G1301830","2010","3","5","Georgia","Long County",14464,"","Long County Georgia",12456,11636,-2008,-13.8827433628319,13.8827433628319,-2828,-19.5519911504425,19.5519911504425
"13","185","G1301850","2010","3","5","Georgia","Lowndes County",109233,"","Lowndes County Georgia",107799,121118,-1434,-1.31279009090659,1.31279009090659,11885,10.8804115972279,10.8804115972279
"13","187","G1301870","2010","3","5","Georgia","Lumpkin County",29966,"","Lumpkin County Georgia",27723,29713,-2243,-7.48514983648135,7.48514983648135,-253,-0.844290195554962,0.844290195554962
"13","189","G1301890","2010","3","5","Georgia","McDuffie County",21875,"","McDuffie County Georgia",21916,22278,41,0.187428571428571,0.187428571428571,403,1.84228571428571,1.84228571428571
"13","191","G1301910","2010","3","5","Georgia","McIntosh County",14333,"","McIntosh County Georgia",11268,13236,-3065,-21.3842182376334,21.3842182376334,-1097,-7.65366636433405,7.65366636433405
"13","193","G1301930","2010","3","5","Georgia","Macon County",14740,"","Macon County Georgia",13153,14586,-1587,-10.7666214382632,10.7666214382632,-154,-1.04477611940299,1.04477611940299
"13","195","G1301950","2010","3","5","Georgia","Madison County",28120,"","Madison County Georgia",28267,29587,147,0.52275960170697,0.52275960170697,1467,5.21692745376956,5.21692745376956
"13","197","G1301970","2010","3","5","Georgia","Marion County",8742,"","Marion County Georgia",7029,7402,-1713,-19.5950583390528,19.5950583390528,-1340,-15.3283001601464,15.3283001601464
"13","199","G1301990","2010","3","5","Georgia","Meriwether County",21992,"","Meriwether County Georgia",22412,25846,420,1.90978537650055,1.90978537650055,3854,17.5245543834121,17.5245543834121
"13","201","G1302010","2010","3","5","Georgia","Miller County",6125,"","Miller County Georgia",6138,6499,13,0.212244897959184,0.212244897959184,374,6.10612244897959,6.10612244897959
"13","205","G1302050","2010","3","5","Georgia","Mitchell County",23498,"","Mitchell County Georgia",23734,26361,236,1.00434079496127,1.00434079496127,2863,12.1840156609073,12.1840156609073
"13","207","G1302070","2010","3","5","Georgia","Monroe County",26424,"","Monroe County Georgia",25468,27843,-956,-3.61792310021193,3.61792310021193,1419,5.37011807447775,5.37011807447775
"13","209","G1302090","2010","3","5","Georgia","Montgomery County",9123,"","Montgomery County Georgia",8824,9048,-299,-3.27743066973583,3.27743066973583,-75,-0.822097994080894,0.822097994080894
"13","211","G1302110","2010","3","5","Georgia","Morgan County",17868,"","Morgan County Georgia",18722,19657,854,4.77949406760689,4.77949406760689,1789,10.0123125139915,10.0123125139915
"13","213","G1302130","2010","3","5","Georgia","Murray County",39628,"","Murray County Georgia",40528,41621,900,2.27112142929242,2.27112142929242,1993,5.02927223175532,5.02927223175532
"13","215","G1302150","2010","3","5","Georgia","Muscogee County",189885,"","Muscogee County Georgia",191265,205731,1380,0.726755667904258,0.726755667904258,15846,8.34505095189193,8.34505095189193
"13","217","G1302170","2010","3","5","Georgia","Newton County",99958,"","Newton County Georgia",100010,101766,52,0.0520218491766542,0.0520218491766542,1808,1.80875967906521,1.80875967906521
"13","219","G1302190","2010","3","5","Georgia","Oconee County",32808,"","Oconee County Georgia",33219,35227,411,1.25274323335772,1.25274323335772,2419,7.37320165813216,7.37320165813216
"13","221","G1302210","2010","3","5","Georgia","Oglethorpe County",14899,"","Oglethorpe County Georgia",14345,15124,-554,-3.71837036042687,3.71837036042687,225,1.51016846768239,1.51016846768239
"13","223","G1302230","2010","3","5","Georgia","Paulding County",142324,"","Paulding County Georgia",137695,146977,-4629,-3.25243809898541,3.25243809898541,4653,3.26930103144937,3.26930103144937
"13","225","G1302250","2010","3","5","Georgia","Peach County",27695,"","Peach County Georgia",27210,28973,-485,-1.75121863152194,1.75121863152194,1278,4.61455136306192,4.61455136306192
"13","227","G1302270","2010","3","5","Georgia","Pickens County",29431,"","Pickens County Georgia",31368,30842,1937,6.58149570181102,6.58149570181102,1411,4.79426455098366,4.79426455098366
"13","229","G1302290","2010","3","5","Georgia","Pierce County",18758,"","Pierce County Georgia",18667,18403,-91,-0.485126346092334,0.485126346092334,-355,-1.89252585563493,1.89252585563493
"13","231","G1302310","2010","3","5","Georgia","Pike County",17869,"","Pike County Georgia",17457,18700,-412,-2.30566903576026,2.30566903576026,831,4.65051205999216,4.65051205999216
"13","233","G1302330","2010","3","5","Georgia","Polk County",41475,"","Polk County Georgia",42395,43478,920,2.21820373719108,2.21820373719108,2003,4.82941531042797,4.82941531042797
"13","235","G1302350","2010","3","5","Georgia","Pulaski County",12010,"","Pulaski County Georgia",9835,10460,-2175,-18.1099084096586,18.1099084096586,-1550,-12.9059117402165,12.9059117402165
"13","237","G1302370","2010","3","5","Georgia","Putnam County",21218,"","Putnam County Georgia",20448,23269,-770,-3.62899425016495,3.62899425016495,2051,9.66632104816665,9.66632104816665
"13","239","G1302390","2010","3","5","Georgia","Quitman County",2513,"","Quitman County Georgia",2678,2650,165,6.5658575407879,6.5658575407879,137,5.4516514126542,5.4516514126542
"13","241","G1302410","2010","3","5","Georgia","Rabun County",16276,"","Rabun County Georgia",16633,19261,357,2.19341361513885,2.19341361513885,2985,18.3398869501106,18.3398869501106
"13","243","G1302430","2010","3","5","Georgia","Randolph County",7719,"","Randolph County Georgia",7137,7823,-582,-7.53983676642052,7.53983676642052,104,1.34732478300298,1.34732478300298
"13","245","G1302450","2010","3","5","Georgia","Richmond County",200549,"","Richmond County Georgia",200590,212449,41,0.0204438815451585,0.0204438815451585,11900,5.93371196066797,5.93371196066797
"13","247","G1302470","2010","3","5","Georgia","Rockdale County",85215,"","Rockdale County Georgia",85197,89034,-18,-0.0211230417180074,0.0211230417180074,3819,4.48160535117057,4.48160535117057
"13","249","G1302490","2010","3","5","Georgia","Schley County",5010,"","Schley County Georgia",4283,3886,-727,-14.5109780439122,14.5109780439122,-1124,-22.435129740519,22.435129740519
"13","251","G1302510","2010","3","5","Georgia","Screven County",14593,"","Screven County Georgia",14846,17080,253,1.73370794216405,1.73370794216405,2487,17.0424175974782,17.0424175974782
"13","253","G1302530","2010","3","5","Georgia","Seminole County",8729,"","Seminole County Georgia",9018,9832,289,3.31080307022568,3.31080307022568,1103,12.6360407835949,12.6360407835949
"13","255","G1302550","2010","3","5","Georgia","Spalding County",64073,"","Spalding County Georgia",64794,68090,721,1.12527897866496,1.12527897866496,4017,6.26941145256192,6.26941145256192
"13","257","G1302570","2010","3","5","Georgia","Stephens County",26175,"","Stephens County Georgia",25753,27696,-422,-1.61222540592168,1.61222540592168,1521,5.810888252149,5.810888252149
"13","259","G1302590","2010","3","5","Georgia","Stewart County",6058,"","Stewart County Georgia",4584,5269,-1474,-24.3314625288874,24.3314625288874,-789,-13.0241003631562,13.0241003631562
"13","261","G1302610","2010","3","5","Georgia","Sumter County",32819,"","Sumter County Georgia",32366,34859,-453,-1.38029799811085,1.38029799811085,2040,6.21591151467138,6.21591151467138
"13","263","G1302630","2010","3","5","Georgia","Talbot County",6865,"","Talbot County Georgia",6268,7095,-597,-8.69628550619082,8.69628550619082,230,3.35032774945375,3.35032774945375
"13","265","G1302650","2010","3","5","Georgia","Taliaferro County",1717,"","Taliaferro County Georgia",1713,2147,-4,-0.23296447291788,0.23296447291788,430,25.0436808386721,25.0436808386721
"13","267","G1302670","2010","3","5","Georgia","Tattnall County",25520,"","Tattnall County Georgia",24935,23364,-585,-2.2923197492163,2.2923197492163,-2156,-8.44827586206897,8.44827586206897
"13","269","G1302690","2010","3","5","Georgia","Taylor County",8906,"","Taylor County Georgia",8596,9482,-310,-3.4807994610375,3.4807994610375,576,6.46754996631484,6.46754996631484
"13","271","G1302710","2010","3","5","Georgia","Telfair County",16500,"","Telfair County Georgia",12849,12026,-3651,-22.1272727272727,22.1272727272727,-4474,-27.1151515151515,27.1151515151515
"13","273","G1302730","2010","3","5","Georgia","Terrell County",9315,"","Terrell County Georgia",10103,11674,788,8.45947396672034,8.45947396672034,2359,25.32474503489,25.32474503489
"13","275","G1302750","2010","3","5","Georgia","Thomas County",44720,"","Thomas County Georgia",46190,48357,1470,3.2871198568873,3.2871198568873,3637,8.13282647584973,8.13282647584973
"13","277","G1302770","2010","3","5","Georgia","Tift County",40118,"","Tift County Georgia",43496,41054,3378,8.42016052644698,8.42016052644698,936,2.33311730395334,2.33311730395334
"13","279","G1302790","2010","3","5","Georgia","Toombs County",27223,"","Toombs County Georgia",28188,27411,965,3.54479667927855,3.54479667927855,188,0.690592513683282,0.690592513683282
"13","281","G1302810","2010","3","5","Georgia","Towns County",10471,"","Towns County Georgia",11059,12788,588,5.6155095024353,5.6155095024353,2317,22.1277814917391,22.1277814917391
"13","283","G1302830","2010","3","5","Georgia","Treutlen County",6885,"","Treutlen County Georgia",7031,6970,146,2.12055192447349,2.12055192447349,85,1.23456790123457,1.23456790123457
"13","285","G1302850","2010","3","5","Georgia","Troup County",67044,"","Troup County Georgia",65069,68768,-1975,-2.94582662132331,2.94582662132331,1724,2.57144561780323,2.57144561780323
"13","287","G1302870","2010","3","5","Georgia","Turner County",8930,"","Turner County Georgia",9321,9785,391,4.37849944008959,4.37849944008959,855,9.57446808510638,9.57446808510638
"13","289","G1302890","2010","3","5","Georgia","Twiggs County",9023,"","Twiggs County Georgia",9910,11127,887,9.8304333370276,9.8304333370276,2104,23.3181868558129,23.3181868558129
"13","291","G1302910","2010","3","5","Georgia","Union County",21356,"","Union County Georgia",21261,23798,-95,-0.444839857651246,0.444839857651246,2442,11.4347256040457,11.4347256040457
"13","293","G1302930","2010","3","5","Georgia","Upson County",27153,"","Upson County Georgia",27572,29635,419,1.54310757559017,1.54310757559017,2482,9.14079475564394,9.14079475564394
"13","295","G1302950","2010","3","5","Georgia","Walker County",68756,"","Walker County Georgia",65044,70025,-3712,-5.39880155913666,5.39880155913666,1269,1.84565710628891,1.84565710628891
"13","297","G1302970","2010","3","5","Georgia","Walton County",83768,"","Walton County Georgia",87769,87484,4001,4.77628688759431,4.77628688759431,3716,4.43606150319931,4.43606150319931
"13","299","G1302990","2010","3","5","Georgia","Ware County",36312,"","Ware County Georgia",36309,37225,-3,-0.00826173165895572,0.00826173165895572,913,2.51432033487552,2.51432033487552
"13","301","G1303010","2010","3","5","Georgia","Warren County",5834,"","Warren County Georgia",5666,6430,-168,-2.87967089475489,2.87967089475489,596,10.2159753171066,10.2159753171066
"13","303","G1303030","2010","3","5","Georgia","Washington County",21187,"","Washington County Georgia",20898,21980,-289,-1.36404398923868,1.36404398923868,793,3.74286118846462,3.74286118846462
"13","305","G1303050","2010","3","5","Georgia","Wayne County",30099,"","Wayne County Georgia",29631,27354,-468,-1.55486893252267,1.55486893252267,-2745,-9.119904315758,9.119904315758
"13","307","G1303070","2010","3","5","Georgia","Webster County",2799,"","Webster County Georgia",2167,2446,-632,-22.5794926759557,22.5794926759557,-353,-12.6116470167917,12.6116470167917
"13","309","G1303090","2010","3","5","Georgia","Wheeler County",7421,"","Wheeler County Georgia",7276,6314,-145,-1.95391456676998,1.95391456676998,-1107,-14.9171270718232,14.9171270718232
"13","311","G1303110","2010","3","5","Georgia","White County",27144,"","White County Georgia",25354,25865,-1790,-6.59445918066608,6.59445918066608,-1279,-4.71190686707928,4.71190686707928
"13","313","G1303130","2010","3","5","Georgia","Whitfield County",102599,"","Whitfield County Georgia",94387,97375,-8212,-8.00397664694588,8.00397664694588,-5224,-5.09166756011267,5.09166756011267
"13","315","G1303150","2010","3","5","Georgia","Wilcox County",9255,"","Wilcox County Georgia",9012,8868,-243,-2.62560777957861,2.62560777957861,-387,-4.18152350081037,4.18152350081037
"13","317","G1303170","2010","3","5","Georgia","Wilkes County",10593,"","Wilkes County Georgia",10207,11132,-386,-3.6439157934485,3.6439157934485,539,5.08826583592939,5.08826583592939
"13","319","G1303190","2010","3","5","Georgia","Wilkinson County",9563,"","Wilkinson County Georgia",9881,10510,318,3.3253163233295,3.3253163233295,947,9.90275018299697,9.90275018299697
"13","321","G1303210","2010","3","5","Georgia","Worth County",21679,"","Worth County Georgia",21290,23304,-389,-1.79436320863508,1.79436320863508,1625,7.49573319802574,7.49573319802574
"15","001","G1500010","2010","4","9","Hawaii","Hawaii County",185079,"","Hawaii County Hawaii",178783,192242,-6296,-3.40179058672243,3.40179058672243,7163,3.8702391951545,3.8702391951545
"15","003","G1500030","2010","4","9","Hawaii","Honolulu County",953207,"","Honolulu County Hawaii",906685,933723,-46522,-4.88057683168504,4.88057683168504,-19484,-2.0440470957515,2.0440470957515
"15","005","G1500050","2010","4","9","Hawaii","Kalawao County",90,"","Kalawao County Hawaii",131,150,41,45.5555555555556,45.5555555555556,60,66.6666666666667,66.6666666666667
"15","007","G1500070","2010","4","9","Hawaii","Kauai County",67091,"","Kauai County Hawaii",64983,70311,-2108,-3.14200116260005,3.14200116260005,3220,4.79945149125814,4.79945149125814
"15","009","G1500090","2010","4","9","Hawaii","Maui County",154834,"","Maui County Hawaii",146303,151874,-8531,-5.50977175555756,5.50977175555756,-2960,-1.91172481496312,1.91172481496312
"16","001","G1600010","2010","4","8","Idaho","Ada County",392365,"","Ada County Idaho",387466,401289,-4899,-1.24858231493635,1.24858231493635,8924,2.27441285537701,2.27441285537701
"16","003","G1600030","2010","4","8","Idaho","Adams County",3976,"","Adams County Idaho",3423,4371,-553,-13.9084507042254,13.9084507042254,395,9.93460764587525,9.93460764587525
"16","005","G1600050","2010","4","8","Idaho","Bannock County",82839,"","Bannock County Idaho",83320,83772,481,0.580644382476853,0.580644382476853,933,1.12628109948213,1.12628109948213
"16","007","G1600070","2010","4","8","Idaho","Bear Lake County",5986,"","Bear Lake County Idaho",5735,7145,-251,-4.19311727363849,4.19311727363849,1159,19.3618443033745,19.3618443033745
"16","009","G1600090","2010","4","8","Idaho","Benewah County",9285,"","Benewah County Idaho",9270,9571,-15,-0.161550888529887,0.161550888529887,286,3.08023694130318,3.08023694130318
"16","011","G1600110","2010","4","8","Idaho","Bingham County",45607,"","Bingham County Idaho",45211,46367,-396,-0.868287762843423,0.868287762843423,760,1.66641085798233,1.66641085798233
"16","013","G1600130","2010","4","8","Idaho","Blaine County",21376,"","Blaine County Idaho",22219,22750,843,3.9436751497006,3.9436751497006,1374,6.42776946107784,6.42776946107784
"16","015","G1600150","2010","4","8","Idaho","Boise County",7028,"","Boise County Idaho",7532,7986,504,7.17131474103586,7.17131474103586,958,13.6311895276039,13.6311895276039
"16","017","G1600170","2010","4","8","Idaho","Bonner County",40877,"","Bonner County Idaho",41512,37363,635,1.55344081023558,1.55344081023558,-3514,-8.59652127113046,8.59652127113046
"16","019","G1600190","2010","4","8","Idaho","Bonneville County",104234,"","Bonneville County Idaho",102385,104626,-1849,-1.77389335533511,1.77389335533511,392,0.376076903889326,0.376076903889326
"16","021","G1600210","2010","4","8","Idaho","Boundary County",10972,"","Boundary County Idaho",11094,11654,122,1.11192125410135,1.11192125410135,682,6.21582209259934,6.21582209259934
"16","023","G1600230","2010","4","8","Idaho","Butte County",2891,"","Butte County Idaho",2804,2908,-87,-3.00933932895192,3.00933932895192,17,0.588031822898651,0.588031822898651
"16","025","G1600250","2010","4","8","Idaho","Camas County",1117,"","Camas County Idaho",1085,1272,-32,-2.86481647269472,2.86481647269472,155,13.876454789615,13.876454789615
"16","027","G1600270","2010","4","8","Idaho","Canyon County",188923,"","Canyon County Idaho",188077,188573,-846,-0.447801485261191,0.447801485261191,-350,-0.185260661751084,0.185260661751084
"16","029","G1600290","2010","4","8","Idaho","Caribou County",6963,"","Caribou County Idaho",6923,7594,-40,-0.574465029441333,0.574465029441333,631,9.06218583943702,9.06218583943702
"16","031","G1600310","2010","4","8","Idaho","Cassia County",22952,"","Cassia County Idaho",22099,22483,-853,-3.71645172533984,3.71645172533984,-469,-2.04339491111886,2.04339491111886
"16","033","G1600330","2010","4","8","Idaho","Clark County",982,"","Clark County Idaho",985,1108,3,0.305498981670061,0.305498981670061,126,12.8309572301426,12.8309572301426
"16","035","G1600350","2010","4","8","Idaho","Clearwater County",8761,"","Clearwater County Idaho",8035,9469,-726,-8.28672525967355,8.28672525967355,708,8.08126926149983,8.08126926149983
"16","037","G1600370","2010","4","8","Idaho","Custer County",4368,"","Custer County Idaho",4225,4449,-143,-3.27380952380952,3.27380952380952,81,1.8543956043956,1.8543956043956
"16","039","G1600390","2010","4","8","Idaho","Elmore County",27038,"","Elmore County Idaho",28526,34091,1488,5.50336563355278,5.50336563355278,7053,26.085509283231,26.085509283231
"16","041","G1600410","2010","4","8","Idaho","Franklin County",12786,"","Franklin County Idaho",12689,13138,-97,-0.758642264977319,0.758642264977319,352,2.75301110589707,2.75301110589707
"16","043","G1600430","2010","4","8","Idaho","Fremont County",13242,"","Fremont County Idaho",12685,13826,-557,-4.20631324573327,4.20631324573327,584,4.41020993807582,4.41020993807582
"16","045","G1600450","2010","4","8","Idaho","Gem County",16719,"","Gem County Idaho",16230,17704,-489,-2.9248160775166,2.9248160775166,985,5.89150068784018,5.89150068784018
"16","047","G1600470","2010","4","8","Idaho","Gooding County",15464,"","Gooding County Idaho",14556,15652,-908,-5.87170201758924,5.87170201758924,188,1.2157268494568,1.2157268494568
"16","049","G1600490","2010","4","8","Idaho","Idaho County",16267,"","Idaho County Idaho",15605,15899,-662,-4.0695887379357,4.0695887379357,-368,-2.26224872441139,2.26224872441139
"16","051","G1600510","2010","4","8","Idaho","Jefferson County",26140,"","Jefferson County Idaho",25034,25309,-1106,-4.23106350420811,4.23106350420811,-831,-3.17903596021423,3.17903596021423
"16","053","G1600530","2010","4","8","Idaho","Jerome County",22374,"","Jerome County Idaho",21696,21058,-678,-3.03030303030303,3.03030303030303,-1316,-5.88182712076517,5.88182712076517
"16","055","G1600550","2010","4","8","Idaho","Kootenai County",138494,"","Kootenai County Idaho",140265,143132,1771,1.2787557583722,1.2787557583722,4638,3.34888153999451,3.34888153999451
"16","057","G1600570","2010","4","8","Idaho","Latah County",37244,"","Latah County Idaho",38503,39745,1259,3.38041026742563,3.38041026742563,2501,6.71517559875416,6.71517559875416
"16","059","G1600590","2010","4","8","Idaho","Lemhi County",7936,"","Lemhi County Idaho",7925,8495,-11,-0.138608870967742,0.138608870967742,559,7.04385080645161,7.04385080645161
"16","061","G1600610","2010","4","8","Idaho","Lewis County",3821,"","Lewis County Idaho",3680,3827,-141,-3.69013347291285,3.69013347291285,6,0.157026956294164,0.157026956294164
"16","063","G1600630","2010","4","8","Idaho","Lincoln County",5208,"","Lincoln County Idaho",4676,4497,-532,-10.2150537634409,10.2150537634409,-711,-13.6520737327189,13.6520737327189
"16","065","G1600650","2010","4","8","Idaho","Madison County",37536,"","Madison County Idaho",38467,41672,931,2.48028559249787,2.48028559249787,4136,11.0187553282182,11.0187553282182
"16","067","G1600670","2010","4","8","Idaho","Minidoka County",20069,"","Minidoka County Idaho",19395,20435,-674,-3.35841347351637,3.35841347351637,366,1.82370820668693,1.82370820668693
"16","069","G1600690","2010","4","8","Idaho","Nez Perce County",39265,"","Nez Perce County Idaho",39423,39230,158,0.402393989558131,0.402393989558131,-35,-0.0891379090793327,0.0891379090793327
"16","071","G1600710","2010","4","8","Idaho","Oneida County",4286,"","Oneida County Idaho",4216,4351,-70,-1.63322445170322,1.63322445170322,65,1.51656556229585,1.51656556229585
"16","073","G1600730","2010","4","8","Idaho","Owyhee County",11526,"","Owyhee County Idaho",11145,11677,-381,-3.30557001561687,3.30557001561687,151,1.31008155474579,1.31008155474579
"16","075","G1600750","2010","4","8","Idaho","Payette County",22623,"","Payette County Idaho",23142,23408,519,2.29412544755337,2.29412544755337,785,3.46991999292755,3.46991999292755
"16","077","G1600770","2010","4","8","Idaho","Power County",7817,"","Power County Idaho",7984,8115,167,2.13636945119611,2.13636945119611,298,3.81220417039785,3.81220417039785
"16","079","G1600790","2010","4","8","Idaho","Shoshone County",12765,"","Shoshone County Idaho",12601,14194,-164,-1.28476302389346,1.28476302389346,1429,11.1946729338034,11.1946729338034
"16","081","G1600810","2010","4","8","Idaho","Teton County",10170,"","Teton County Idaho",9384,11524,-786,-7.72861356932153,7.72861356932153,1354,13.3136676499508,13.3136676499508
"16","083","G1600830","2010","4","8","Idaho","Twin Falls County",77230,"","Twin Falls County Idaho",76103,76833,-1127,-1.45927748284345,1.45927748284345,-397,-0.514048944710605,0.514048944710605
"16","085","G1600850","2010","4","8","Idaho","Valley County",9862,"","Valley County Idaho",8480,9708,-1382,-14.013384708984,14.013384708984,-154,-1.56154938146421,1.56154938146421
"16","087","G1600870","2010","4","8","Idaho","Washington County",10198,"","Washington County Idaho",10147,10784,-51,-0.500098058442832,0.500098058442832,586,5.74622474995097,5.74622474995097
"17","001","G1700010","2010","2","3","Illinois","Adams County",67103,"","Adams County Illinois",67014,70977,-89,-0.132631924057047,0.132631924057047,3874,5.77321431232583,5.77321431232583
"17","003","G1700030","2010","2","3","Illinois","Alexander County",8238,"","Alexander County Illinois",7932,9650,-306,-3.71449380917698,3.71449380917698,1412,17.1400825443069,17.1400825443069
"17","005","G1700050","2010","2","3","Illinois","Bond County",17768,"","Bond County Illinois",18108,19149,340,1.91355245384962,1.91355245384962,1381,7.77239981990095,7.77239981990095
"17","007","G1700070","2010","2","3","Illinois","Boone County",54165,"","Boone County Illinois",53746,51352,-419,-0.77356226345426,0.77356226345426,-2813,-5.19339056586356,5.19339056586356
"17","009","G1700090","2010","2","3","Illinois","Brown County",6937,"","Brown County Illinois",6532,7150,-405,-5.83825861323339,5.83825861323339,213,3.07049156695978,3.07049156695978
"17","011","G1700110","2010","2","3","Illinois","Bureau County",34978,"","Bureau County Illinois",34618,36304,-360,-1.02921836582995,1.02921836582995,1326,3.79095431414032,3.79095431414032
"17","013","G1700130","2010","2","3","Illinois","Calhoun County",5089,"","Calhoun County Illinois",5016,5435,-73,-1.43446649636471,1.43446649636471,346,6.79897818824916,6.79897818824916
"17","015","G1700150","2010","2","3","Illinois","Carroll County",15387,"","Carroll County Illinois",15559,17569,172,1.11782673685579,1.11782673685579,2182,14.1808019756938,14.1808019756938
"17","017","G1700170","2010","2","3","Illinois","Cass County",13642,"","Cass County Illinois",13539,14157,-103,-0.755021257880076,0.755021257880076,515,3.77510628940038,3.77510628940038
"17","019","G1700190","2010","2","3","Illinois","Champaign County",201081,"","Champaign County Illinois",196059,205792,-5022,-2.49750100705686,2.49750100705686,4711,2.3428369661977,2.3428369661977
"17","021","G1700210","2010","2","3","Illinois","Christian County",34800,"","Christian County Illinois",34266,36418,-534,-1.53448275862069,1.53448275862069,1618,4.64942528735632,4.64942528735632
"17","023","G1700230","2010","2","3","Illinois","Clark County",16335,"","Clark County Illinois",16531,17668,196,1.19987756351393,1.19987756351393,1333,8.16039179675543,8.16039179675543
"17","025","G1700250","2010","2","3","Illinois","Clay County",13815,"","Clay County Illinois",13467,14805,-348,-2.51900108577633,2.51900108577633,990,7.16612377850163,7.16612377850163
"17","027","G1700270","2010","2","3","Illinois","Clinton County",37762,"","Clinton County Illinois",36476,39573,-1286,-3.40553996080716,3.40553996080716,1811,4.79582649224088,4.79582649224088
"17","029","G1700290","2010","2","3","Illinois","Coles County",53873,"","Coles County Illinois",52360,55110,-1513,-2.80845692647523,2.80845692647523,1237,2.29614092402502,2.29614092402502
"17","031","G1700310","2010","2","3","Illinois","Cook County",5194675,"","Cook County Illinois",5304343,5611152,109668,2.11116191099539,2.11116191099539,416477,8.01738318566609,8.01738318566609
"17","033","G1700330","2010","2","3","Illinois","Crawford County",19817,"","Crawford County Illinois",19346,20891,-471,-2.37674723722057,2.37674723722057,1074,5.41958924156028,5.41958924156028
"17","035","G1700350","2010","2","3","Illinois","Cumberland County",11048,"","Cumberland County Illinois",10765,11735,-283,-2.56154960173787,2.56154960173787,687,6.21832005792904,6.21832005792904
"17","037","G1700370","2010","2","3","Illinois","DeKalb County",105160,"","DeKalb County Illinois",107306,105926,2146,2.04069988588817,2.04069988588817,766,0.728413845568657,0.728413845568657
"17","039","G1700390","2010","2","3","Illinois","De Witt County",16561,"","De Witt County Illinois",16008,17483,-553,-3.33917033995532,3.33917033995532,922,5.56729666082966,5.56729666082966
"17","041","G1700410","2010","2","3","Illinois","Douglas County",19980,"","Douglas County Illinois",19213,21029,-767,-3.83883883883884,3.83883883883884,1049,5.25025025025025,5.25025025025025
"17","043","G1700430","2010","2","3","Illinois","DuPage County",916924,"","DuPage County Illinois",939211,969849,22287,2.43062674769119,2.43062674769119,52925,5.77201600132617,5.77201600132617
"17","045","G1700450","2010","2","3","Illinois","Edgar County",18576,"","Edgar County Illinois",18268,20138,-308,-1.65805340223945,1.65805340223945,1562,8.40869939707149,8.40869939707149
"17","047","G1700470","2010","2","3","Illinois","Edwards County",6721,"","Edwards County Illinois",6450,7207,-271,-4.03213807469127,4.03213807469127,486,7.23106680553489,7.23106680553489
"17","049","G1700490","2010","2","3","Illinois","Effingham County",34242,"","Effingham County Illinois",34372,36127,130,0.379650721336371,0.379650721336371,1885,5.50493545937737,5.50493545937737
"17","051","G1700510","2010","2","3","Illinois","Fayette County",22140,"","Fayette County Illinois",20901,22489,-1239,-5.59620596205962,5.59620596205962,349,1.57633242999097,1.57633242999097
"17","053","G1700530","2010","2","3","Illinois","Ford County",14081,"","Ford County Illinois",13867,14742,-214,-1.51977842482778,1.51977842482778,661,4.69426887294936,4.69426887294936
"17","055","G1700550","2010","2","3","Illinois","Franklin County",39561,"","Franklin County Illinois",39245,39728,-316,-0.798766461919567,0.798766461919567,167,0.422132908672683,0.422132908672683
"17","057","G1700570","2010","2","3","Illinois","Fulton County",37069,"","Fulton County Illinois",36507,38946,-562,-1.51609161293803,1.51609161293803,1877,5.0635301734603,5.0635301734603
"17","059","G1700590","2010","2","3","Illinois","Gallatin County",5589,"","Gallatin County Illinois",5635,6692,46,0.823045267489712,0.823045267489712,1103,19.7351941313294,19.7351941313294
"17","061","G1700610","2010","2","3","Illinois","Greene County",13886,"","Greene County Illinois",13512,15253,-374,-2.69336021892554,2.69336021892554,1367,9.84444764511018,9.84444764511018
"17","063","G1700630","2010","2","3","Illinois","Grundy County",50063,"","Grundy County Illinois",48582,46657,-1481,-2.95827257655354,2.95827257655354,-3406,-6.80342768112179,6.80342768112179
"17","065","G1700650","2010","2","3","Illinois","Hamilton County",8457,"","Hamilton County Illinois",8068,8842,-389,-4.59973986047062,4.59973986047062,385,4.55244176421899,4.55244176421899
"17","067","G1700670","2010","2","3","Illinois","Hancock County",19104,"","Hancock County Illinois",18377,20876,-727,-3.80548576214405,3.80548576214405,1772,9.27554438860972,9.27554438860972
"17","069","G1700690","2010","2","3","Illinois","Hardin County",4320,"","Hardin County Illinois",4336,4884,16,0.37037037037037,0.37037037037037,564,13.0555555555556,13.0555555555556
"17","071","G1700710","2010","2","3","Illinois","Henderson County",7331,"","Henderson County Illinois",7270,8512,-61,-0.832082935479471,0.832082935479471,1181,16.109671259037,16.109671259037
"17","073","G1700730","2010","2","3","Illinois","Henry County",50486,"","Henry County Illinois",49270,52224,-1216,-2.40858851958959,2.40858851958959,1738,3.44253852553183,3.44253852553183
"17","075","G1700750","2010","2","3","Illinois","Iroquois County",29718,"","Iroquois County Illinois",29488,32154,-230,-0.773941718823609,0.773941718823609,2436,8.19705229154048,8.19705229154048
"17","077","G1700770","2010","2","3","Illinois","Jackson County",60218,"","Jackson County Illinois",58559,64590,-1659,-2.7549902022651,2.7549902022651,4372,7.26028762164137,7.26028762164137
"17","079","G1700790","2010","2","3","Illinois","Jasper County",9698,"","Jasper County Illinois",9498,10492,-200,-2.06228088265622,2.06228088265622,794,8.18725510414518,8.18725510414518
"17","081","G1700810","2010","2","3","Illinois","Jefferson County",38827,"","Jefferson County Illinois",39846,41472,1019,2.62446235866794,2.62446235866794,2645,6.81226981224406,6.81226981224406
"17","083","G1700830","2010","2","3","Illinois","Jersey County",22985,"","Jersey County Illinois",22380,24167,-605,-2.63215140308897,2.63215140308897,1182,5.1424842288449,5.1424842288449
"17","085","G1700850","2010","2","3","Illinois","Jo Daviess County",22678,"","Jo Daviess County Illinois",21892,24712,-786,-3.46591410177264,3.46591410177264,2034,8.96904488932005,8.96904488932005
"17","087","G1700870","2010","2","3","Illinois","Johnson County",12582,"","Johnson County Illinois",13710,13536,1128,8.96518836432999,8.96518836432999,954,7.58226037195994,7.58226037195994
"17","089","G1700890","2010","2","3","Illinois","Kane County",515269,"","Kane County Illinois",514064,508476,-1205,-0.233858431227184,0.233858431227184,-6793,-1.31834051728321,1.31834051728321
"17","091","G1700910","2010","2","3","Illinois","Kankakee County",113449,"","Kankakee County Illinois",113198,114059,-251,-0.221244788407126,0.221244788407126,610,0.537686537563134,0.537686537563134
"17","093","G1700930","2010","2","3","Illinois","Kendall County",114736,"","Kendall County Illinois",106004,97907,-8732,-7.61051457258402,7.61051457258402,-16829,-14.6675847162181,14.6675847162181
"17","095","G1700950","2010","2","3","Illinois","Knox County",52919,"","Knox County Illinois",51660,56532,-1259,-2.37910769288913,2.37910769288913,3613,6.82741548404165,6.82741548404165
"17","097","G1700970","2010","2","3","Illinois","Lake County",703462,"","Lake County Illinois",713099,726543,9637,1.36993895903403,1.36993895903403,23081,3.28105853621091,3.28105853621091
"17","099","G1700990","2010","2","3","Illinois","LaSalle County",113924,"","LaSalle County Illinois",112227,119012,-1697,-1.48958955092869,1.48958955092869,5088,4.46613531828236,4.46613531828236
"17","101","G1701010","2010","2","3","Illinois","Lawrence County",16833,"","Lawrence County Illinois",16339,15771,-494,-2.9347115784471,2.9347115784471,-1062,-6.30903582249154,6.30903582249154
"17","103","G1701030","2010","2","3","Illinois","Lee County",36031,"","Lee County Illinois",34699,37700,-1332,-3.69681663012406,3.69681663012406,1669,4.63212233909689,4.63212233909689
"17","105","G1701050","2010","2","3","Illinois","Livingston County",38950,"","Livingston County Illinois",37631,41031,-1319,-3.38639281129653,3.38639281129653,2081,5.34274711168164,5.34274711168164
"17","107","G1701070","2010","2","3","Illinois","Logan County",30305,"","Logan County Illinois",29679,31769,-626,-2.06566573172744,2.06566573172744,1464,4.83088599241049,4.83088599241049
"17","109","G1701090","2010","2","3","Illinois","McDonough County",32612,"","McDonough County Illinois",32796,35786,184,0.564209493437998,0.564209493437998,3174,9.73261376180547,9.73261376180547
"17","111","G1701110","2010","2","3","Illinois","McHenry County",308760,"","McHenry County Illinois",319685,324421,10925,3.53834693613162,3.53834693613162,15661,5.07222438139655,5.07222438139655
"17","113","G1701130","2010","2","3","Illinois","McLean County",169572,"","McLean County Illinois",168194,173196,-1378,-0.812634161300215,0.812634161300215,3624,2.13714528341943,2.13714528341943
"17","115","G1701150","2010","2","3","Illinois","Macon County",110768,"","Macon County Illinois",108182,119834,-2586,-2.33460927343637,2.33460927343637,9066,8.1846742741586,8.1846742741586
"17","117","G1701170","2010","2","3","Illinois","Macoupin County",47765,"","Macoupin County Illinois",47789,51552,24,0.050245996022192,0.050245996022192,3787,7.92839945566838,7.92839945566838
"17","119","G1701190","2010","2","3","Illinois","Madison County",269282,"","Madison County Illinois",267375,281670,-1907,-0.708179529266717,0.708179529266717,12388,4.60038175592873,4.60038175592873
"17","121","G1701210","2010","2","3","Illinois","Marion County",39437,"","Marion County Illinois",39041,42751,-396,-1.0041331744301,1.0041331744301,3314,8.40327611126607,8.40327611126607
"17","123","G1701230","2010","2","3","Illinois","Marshall County",12640,"","Marshall County Illinois",12631,13778,-9,-0.0712025316455696,0.0712025316455696,1138,9.00316455696202,9.00316455696202
"17","125","G1701250","2010","2","3","Illinois","Mason County",14666,"","Mason County Illinois",14611,16191,-55,-0.375017046229374,0.375017046229374,1525,10.3981999181781,10.3981999181781
"17","127","G1701270","2010","2","3","Illinois","Massac County",15429,"","Massac County Illinois",14935,15761,-494,-3.20176291399313,3.20176291399313,332,2.15179207984963,2.15179207984963
"17","129","G1701290","2010","2","3","Illinois","Menard County",12705,"","Menard County Illinois",12404,13594,-301,-2.36914600550964,2.36914600550964,889,6.99724517906336,6.99724517906336
"17","131","G1701310","2010","2","3","Illinois","Mercer County",16434,"","Mercer County Illinois",16183,17458,-251,-1.52732140683948,1.52732140683948,1024,6.23098454423756,6.23098454423756
"17","133","G1701330","2010","2","3","Illinois","Monroe County",32957,"","Monroe County Illinois",33262,33609,305,0.925448311436114,0.925448311436114,652,1.97833540674212,1.97833540674212
"17","135","G1701350","2010","2","3","Illinois","Montgomery County",30104,"","Montgomery County Illinois",29414,31179,-690,-2.29205421206484,2.29205421206484,1075,3.57095402604305,3.57095402604305
"17","137","G1701370","2010","2","3","Illinois","Morgan County",35547,"","Morgan County Illinois",34864,37566,-683,-1.92139983683574,1.92139983683574,2019,5.67980420288632,5.67980420288632
"17","139","G1701390","2010","2","3","Illinois","Moultrie County",14846,"","Moultrie County Illinois",14397,15236,-449,-3.02438367236966,3.02438367236966,390,2.62697022767075,2.62697022767075
"17","141","G1701410","2010","2","3","Illinois","Ogle County",53497,"","Ogle County Illinois",55353,55489,1856,3.4693534216872,3.4693534216872,1992,3.72357328448324,3.72357328448324
"17","143","G1701430","2010","2","3","Illinois","Peoria County",186494,"","Peoria County Illinois",185353,195008,-1141,-0.611815929735005,0.611815929735005,8514,4.56529432582281,4.56529432582281
"17","145","G1701450","2010","2","3","Illinois","Perry County",22350,"","Perry County Illinois",22324,23851,-26,-0.116331096196868,0.116331096196868,1501,6.7158836689038,6.7158836689038
"17","147","G1701470","2010","2","3","Illinois","Piatt County",16729,"","Piatt County Illinois",16451,17601,-278,-1.66178492438281,1.66178492438281,872,5.21250523043816,5.21250523043816
"17","149","G1701490","2010","2","3","Illinois","Pike County",16430,"","Pike County Illinois",16167,17956,-263,-1.60073037127206,1.60073037127206,1526,9.28788800973828,9.28788800973828
"17","151","G1701510","2010","2","3","Illinois","Pope County",4470,"","Pope County Illinois",4013,4547,-457,-10.2237136465324,10.2237136465324,77,1.72259507829978,1.72259507829978
"17","153","G1701530","2010","2","3","Illinois","Pulaski County",6161,"","Pulaski County Illinois",6217,7526,56,0.908943353351729,0.908943353351729,1365,22.1554942379484,22.1554942379484
"17","155","G1701550","2010","2","3","Illinois","Putnam County",6006,"","Putnam County Illinois",5993,6672,-13,-0.216450216450216,0.216450216450216,666,11.0889110889111,11.0889110889111
"17","157","G1701570","2010","2","3","Illinois","Randolph County",33476,"","Randolph County Illinois",32538,35138,-938,-2.80200740829251,2.80200740829251,1662,4.96475086629227,4.96475086629227
"17","159","G1701590","2010","2","3","Illinois","Richland County",16233,"","Richland County Illinois",15465,16891,-768,-4.73110330807614,4.73110330807614,658,4.05347132384649,4.05347132384649
"17","161","G1701610","2010","2","3","Illinois","Rock Island County",147546,"","Rock Island County Illinois",146542,152248,-1004,-0.680465753053285,0.680465753053285,4702,3.18680275981728,3.18680275981728
"17","163","G1701630","2010","2","3","Illinois","St. Clair County",270056,"","St. Clair County Illinois",262934,285883,-7122,-2.63723079657553,2.63723079657553,15827,5.86063631246853,5.86063631246853
"17","165","G1701650","2010","2","3","Illinois","Saline County",24913,"","Saline County Illinois",25768,27747,855,3.43194316220447,3.43194316220447,2834,11.3755870429093,11.3755870429093
"17","167","G1701670","2010","2","3","Illinois","Sangamon County",197465,"","Sangamon County Illinois",196398,201042,-1067,-0.540348922593877,0.540348922593877,3577,1.81146025878004,1.81146025878004
"17","169","G1701690","2010","2","3","Illinois","Schuyler County",7544,"","Schuyler County Illinois",6707,7446,-837,-11.0949098621421,11.0949098621421,-98,-1.29904559915164,1.29904559915164
"17","171","G1701710","2010","2","3","Illinois","Scott County",5355,"","Scott County Illinois",5149,5737,-206,-3.8468720821662,3.8468720821662,382,7.13352007469654,7.13352007469654
"17","173","G1701730","2010","2","3","Illinois","Shelby County",22363,"","Shelby County Illinois",21651,24121,-712,-3.18383043419935,3.18383043419935,1758,7.86119930241918,7.86119930241918
"17","175","G1701750","2010","2","3","Illinois","Stark County",5994,"","Stark County Illinois",5921,6532,-73,-1.21788455121788,1.21788455121788,538,8.97564230897564,8.97564230897564
"17","177","G1701770","2010","2","3","Illinois","Stephenson County",47711,"","Stephenson County Illinois",46345,50177,-1366,-2.86307140910901,2.86307140910901,2466,5.16861939594643,5.16861939594643
"17","179","G1701790","2010","2","3","Illinois","Tazewell County",135394,"","Tazewell County Illinois",132583,138682,-2811,-2.07616290234427,2.07616290234427,3288,2.42846802664815,2.42846802664815
"17","181","G1701810","2010","2","3","Illinois","Union County",17808,"","Union County Illinois",17934,19057,126,0.707547169811321,0.707547169811321,1249,7.01370170709793,7.01370170709793
"17","183","G1701830","2010","2","3","Illinois","Vermilion County",81625,"","Vermilion County Illinois",79942,84776,-1683,-2.06186830015314,2.06186830015314,3151,3.86033690658499,3.86033690658499
"17","185","G1701850","2010","2","3","Illinois","Wabash County",11947,"","Wabash County Illinois",11883,13188,-64,-0.535699338746129,0.535699338746129,1241,10.3875449903742,10.3875449903742
"17","187","G1701870","2010","2","3","Illinois","Warren County",17707,"","Warren County Illinois",17411,18972,-296,-1.67165527757384,1.67165527757384,1265,7.14406731800983,7.14406731800983
"17","189","G1701890","2010","2","3","Illinois","Washington County",14716,"","Washington County Illinois",14467,16089,-249,-1.69203587931503,1.69203587931503,1373,9.32998097309051,9.32998097309051
"17","191","G1701910","2010","2","3","Illinois","Wayne County",16760,"","Wayne County Illinois",16233,17766,-527,-3.14439140811456,3.14439140811456,1006,6.00238663484487,6.00238663484487
"17","193","G1701930","2010","2","3","Illinois","White County",14665,"","White County Illinois",14527,15870,-138,-0.941016024548244,0.941016024548244,1205,8.21684282304807,8.21684282304807
"17","195","G1701950","2010","2","3","Illinois","Whiteside County",58498,"","Whiteside County Illinois",58842,62172,344,0.588054292454443,0.588054292454443,3674,6.28055660022565,6.28055660022565
"17","197","G1701970","2010","2","3","Illinois","Will County",677560,"","Will County Illinois",686918,665454,9358,1.38113229824665,1.38113229824665,-12106,-1.78670523643663,1.78670523643663
"17","199","G1701990","2010","2","3","Illinois","Williamson County",66357,"","Williamson County Illinois",64959,66583,-1398,-2.10678602106786,2.10678602106786,226,0.34058200340582,0.34058200340582
"17","201","G1702010","2010","2","3","Illinois","Winnebago County",295266,"","Winnebago County Illinois",298103,306049,2837,0.960828541044346,0.960828541044346,10783,3.65196128236912,3.65196128236912
"17","203","G1702030","2010","2","3","Illinois","Woodford County",38664,"","Woodford County Illinois",38682,39850,18,0.0465549348230912,0.0465549348230912,1186,3.06745292778812,3.06745292778812
"18","001","G1800010","2010","2","3","Indiana","Adams County",34387,"","Adams County Indiana",34290,36085,-97,-0.282083345450315,0.282083345450315,1698,4.93791258324367,4.93791258324367
"18","003","G1800030","2010","2","3","Indiana","Allen County",355329,"","Allen County Indiana",354633,367425,-696,-0.195874808979847,0.195874808979847,12096,3.40416909399458,3.40416909399458
"18","005","G1800050","2010","2","3","Indiana","Bartholomew County",76794,"","Bartholomew County Indiana",76123,76095,-671,-0.873766179649452,0.873766179649452,-699,-0.910227361512618,0.910227361512618
"18","007","G1800070","2010","2","3","Indiana","Benton County",8854,"","Benton County Indiana",8725,9629,-129,-1.45696860176192,1.45696860176192,775,8.75310594081771,8.75310594081771
"18","009","G1800090","2010","2","3","Indiana","Blackford County",12766,"","Blackford County Indiana",13011,14592,245,1.91916026946577,1.91916026946577,1826,14.3036189879367,14.3036189879367
"18","011","G1800110","2010","2","3","Indiana","Boone County",56640,"","Boone County Indiana",57138,58035,498,0.879237288135593,0.879237288135593,1395,2.46292372881356,2.46292372881356
"18","013","G1800130","2010","2","3","Indiana","Brown County",15242,"","Brown County Indiana",14475,17327,-767,-5.03214801207191,5.03214801207191,2085,13.6793071775358,13.6793071775358
"18","015","G1800150","2010","2","3","Indiana","Carroll County",20155,"","Carroll County Indiana",19785,22061,-370,-1.83577276110146,1.83577276110146,1906,9.45671049367403,9.45671049367403
"18","017","G1800170","2010","2","3","Indiana","Cass County",38966,"","Cass County Indiana",39042,42456,76,0.195041831340143,0.195041831340143,3490,8.95652620233024,8.95652620233024
"18","019","G1800190","2010","2","3","Indiana","Clark County",110232,"","Clark County Indiana",109824,114251,-408,-0.370128456346614,0.370128456346614,4019,3.64594673053197,3.64594673053197
"18","021","G1800210","2010","2","3","Indiana","Clay County",26890,"","Clay County Indiana",26381,28074,-509,-1.89289698772778,1.89289698772778,1184,4.40312383785794,4.40312383785794
"18","023","G1800230","2010","2","3","Indiana","Clinton County",33224,"","Clinton County Indiana",34427,34946,1203,3.62087647483747,3.62087647483747,1722,5.18300024078979,5.18300024078979
"18","025","G1800250","2010","2","3","Indiana","Crawford County",10713,"","Crawford County Indiana",10606,11293,-107,-0.998786521049193,0.998786521049193,580,5.41398301129469,5.41398301129469
"18","027","G1800270","2010","2","3","Indiana","Daviess County",31648,"","Daviess County Indiana",30964,31066,-684,-2.16127401415571,2.16127401415571,-582,-1.83897876643074,1.83897876643074
"18","029","G1800290","2010","2","3","Indiana","Dearborn County",50047,"","Dearborn County Indiana",50599,52662,552,1.1029632145783,1.1029632145783,2615,5.22508841688813,5.22508841688813
"18","031","G1800310","2010","2","3","Indiana","Decatur County",25740,"","Decatur County Indiana",25116,27070,-624,-2.42424242424242,2.42424242424242,1330,5.16705516705517,5.16705516705517
"18","033","G1800330","2010","2","3","Indiana","DeKalb County",42223,"","DeKalb County Indiana",42394,43989,171,0.404992539611112,0.404992539611112,1766,4.1825545318902,4.1825545318902
"18","035","G1800350","2010","2","3","Indiana","Delaware County",117671,"","Delaware County Indiana",115192,123079,-2479,-2.10672128221907,2.10672128221907,5408,4.5958647415251,4.5958647415251
"18","037","G1800370","2010","2","3","Indiana","Dubois County",41889,"","Dubois County Indiana",41526,43879,-363,-0.866575950726921,0.866575950726921,1990,4.75065052877844,4.75065052877844
"18","039","G1800390","2010","2","3","Indiana","Elkhart County",197559,"","Elkhart County Indiana",200470,205042,2911,1.47348387064118,1.47348387064118,7483,3.78772923531704,3.78772923531704
"18","041","G1800410","2010","2","3","Indiana","Fayette County",24277,"","Fayette County Indiana",24118,26311,-159,-0.654940890554846,0.654940890554846,2034,8.37830044898464,8.37830044898464
"18","043","G1800430","2010","2","3","Indiana","Floyd County",74578,"","Floyd County Indiana",74728,77433,150,0.20113170103784,0.20113170103784,2855,3.82820670975355,3.82820670975355
"18","045","G1800450","2010","2","3","Indiana","Fountain County",17240,"","Fountain County Indiana",16852,18480,-388,-2.25058004640371,2.25058004640371,1240,7.19257540603248,7.19257540603248
"18","047","G1800470","2010","2","3","Indiana","Franklin County",23087,"","Franklin County Indiana",22979,24490,-108,-0.46779572919825,0.46779572919825,1403,6.07701303764023,6.07701303764023
"18","049","G1800490","2010","2","3","Indiana","Fulton County",20836,"","Fulton County Indiana",20339,21774,-497,-2.38529468228067,2.38529468228067,938,4.50182376655788,4.50182376655788
"18","051","G1800510","2010","2","3","Indiana","Gibson County",33503,"","Gibson County Indiana",32788,35201,-715,-2.13413724144106,2.13413724144106,1698,5.06820284750619,5.06820284750619
"18","053","G1800530","2010","2","3","Indiana","Grant County",70061,"","Grant County Indiana",68615,76097,-1446,-2.06391573057764,2.06391573057764,6036,8.61534948116641,8.61534948116641
"18","055","G1800550","2010","2","3","Indiana","Greene County",33165,"","Greene County Indiana",32634,34789,-531,-1.6010854816825,1.6010854816825,1624,4.89672847881803,4.89672847881803
"18","057","G1800570","2010","2","3","Indiana","Hamilton County",274569,"","Hamilton County Indiana",283800,277123,9231,3.36199643805382,3.36199643805382,2554,0.930185126507362,0.930185126507362
"18","059","G1800590","2010","2","3","Indiana","Hancock County",70002,"","Hancock County Indiana",68991,72083,-1011,-1.44424445015857,1.44424445015857,2081,2.97277220650839,2.97277220650839
"18","061","G1800610","2010","2","3","Indiana","Harrison County",39364,"","Harrison County Indiana",37754,38157,-1610,-4.09003150086373,4.09003150086373,-1207,-3.06625342952952,3.06625342952952
"18","063","G1800630","2010","2","3","Indiana","Hendricks County",145448,"","Hendricks County Indiana",141978,150682,-3470,-2.38573235795611,2.38573235795611,5234,3.59853693416204,3.59853693416204
"18","065","G1800650","2010","2","3","Indiana","Henry County",49462,"","Henry County Indiana",47747,50518,-1715,-3.4673082366261,3.4673082366261,1056,2.13497230196919,2.13497230196919
"18","067","G1800670","2010","2","3","Indiana","Howard County",82752,"","Howard County Indiana",82888,89023,136,0.164346481051817,0.164346481051817,6271,7.57806457849961,7.57806457849961
"18","069","G1800690","2010","2","3","Indiana","Huntington County",37124,"","Huntington County Indiana",37790,40473,666,1.79398771684086,1.79398771684086,3349,9.02111841396401,9.02111841396401
"18","071","G1800710","2010","2","3","Indiana","Jackson County",42376,"","Jackson County Indiana",43091,45001,715,1.68727581649991,1.68727581649991,2625,6.1945440815556,6.1945440815556
"18","073","G1800730","2010","2","3","Indiana","Jasper County",33478,"","Jasper County Indiana",32948,35778,-530,-1.58312921918872,1.58312921918872,2300,6.87018340402653,6.87018340402653
"18","075","G1800750","2010","2","3","Indiana","Jay County",21253,"","Jay County Indiana",20940,22673,-313,-1.47273326118666,1.47273326118666,1420,6.68140968333882,6.68140968333882
"18","077","G1800770","2010","2","3","Indiana","Jefferson County",32428,"","Jefferson County Indiana",32857,34017,429,1.32293080054274,1.32293080054274,1589,4.90008634513383,4.90008634513383
"18","079","G1800790","2010","2","3","Indiana","Jennings County",28525,"","Jennings County Indiana",28003,30883,-522,-1.82997370727432,1.82997370727432,2358,8.26643295354952,8.26643295354952
"18","081","G1800810","2010","2","3","Indiana","Johnson County",139654,"","Johnson County Indiana",142517,145952,2863,2.05006659315165,2.05006659315165,6298,4.50971687169719,4.50971687169719
"18","083","G1800830","2010","2","3","Indiana","Knox County",38440,"","Knox County Indiana",37848,40125,-592,-1.54006243496358,1.54006243496358,1685,4.38345473465141,4.38345473465141
"18","085","G1800850","2010","2","3","Indiana","Kosciusko County",77358,"","Kosciusko County Indiana",76608,83855,-750,-0.969518343287055,0.969518343287055,6497,8.39861423511466,8.39861423511466
"18","087","G1800870","2010","2","3","Indiana","LaGrange County",37128,"","LaGrange County Indiana",37218,39340,90,0.24240465416936,0.24240465416936,2212,5.9577677224736,5.9577677224736
"18","089","G1800890","2010","2","3","Indiana","Lake County",496005,"","Lake County Indiana",492556,525353,-3449,-0.695355893589782,0.695355893589782,29348,5.91687583794518,5.91687583794518
"18","091","G1800910","2010","2","3","Indiana","LaPorte County",111467,"","LaPorte County Indiana",111084,117325,-383,-0.34359945095858,0.34359945095858,5858,5.25536705930903,5.25536705930903
"18","093","G1800930","2010","2","3","Indiana","Lawrence County",46134,"","Lawrence County Indiana",45736,47482,-398,-0.862704296180691,0.862704296180691,1348,2.92192309359691,2.92192309359691
"18","095","G1800950","2010","2","3","Indiana","Madison County",131636,"","Madison County Indiana",131379,139313,-257,-0.195235345953994,0.195235345953994,7677,5.83199124859461,5.83199124859461
"18","097","G1800970","2010","2","3","Indiana","Marion County",903393,"","Marion County Indiana",895901,934783,-7492,-0.829317915901496,0.829317915901496,31390,3.47467824080992,3.47467824080992
"18","099","G1800990","2010","2","3","Indiana","Marshall County",47051,"","Marshall County Indiana",46776,48784,-275,-0.584472168498013,0.584472168498013,1733,3.68323733820748,3.68323733820748
"18","101","G1801010","2010","2","3","Indiana","Martin County",10334,"","Martin County Indiana",10032,10834,-302,-2.92239210373524,2.92239210373524,500,4.83839752274047,4.83839752274047
"18","103","G1801030","2010","2","3","Indiana","Miami County",36903,"","Miami County Indiana",35577,37365,-1326,-3.59320380456873,3.59320380456873,462,1.25193073733843,1.25193073733843
"18","105","G1801050","2010","2","3","Indiana","Monroe County",137974,"","Monroe County Indiana",131712,137620,-6262,-4.53853624595938,4.53853624595938,-354,-0.256570078420572,0.256570078420572
"18","107","G1801070","2010","2","3","Indiana","Montgomery County",38124,"","Montgomery County Indiana",37723,39888,-401,-1.05183086769489,1.05183086769489,1764,4.62700661000944,4.62700661000944
"18","109","G1801090","2010","2","3","Indiana","Morgan County",68894,"","Morgan County Indiana",71384,74413,2490,3.61424797515023,3.61424797515023,5519,8.01085725897756,8.01085725897756
"18","111","G1801110","2010","2","3","Indiana","Newton County",14244,"","Newton County Indiana",13713,15571,-531,-3.72788542544229,3.72788542544229,1327,9.31620331367593,9.31620331367593
"18","113","G1801130","2010","2","3","Indiana","Noble County",47536,"","Noble County Indiana",48219,50725,683,1.43680578929653,1.43680578929653,3189,6.7085997980478,6.7085997980478
"18","115","G1801150","2010","2","3","Indiana","Ohio County",6128,"","Ohio County Indiana",5827,6266,-301,-4.91187989556136,4.91187989556136,138,2.25195822454308,2.25195822454308
"18","117","G1801170","2010","2","3","Indiana","Orange County",19840,"","Orange County Indiana",19505,20344,-335,-1.68850806451613,1.68850806451613,504,2.54032258064516,2.54032258064516
"18","119","G1801190","2010","2","3","Indiana","Owen County",21575,"","Owen County Indiana",22355,23533,780,3.61529548088065,3.61529548088065,1958,9.07531865585168,9.07531865585168
"18","121","G1801210","2010","2","3","Indiana","Parke County",17339,"","Parke County Indiana",16875,18038,-464,-2.67604821500663,2.67604821500663,699,4.03137435838284,4.03137435838284
"18","123","G1801230","2010","2","3","Indiana","Perry County",19338,"","Perry County Indiana",18744,19707,-594,-3.07167235494881,3.07167235494881,369,1.90816009928638,1.90816009928638
"18","125","G1801250","2010","2","3","Indiana","Pike County",12845,"","Pike County Indiana",12190,13906,-655,-5.09926041261191,5.09926041261191,1061,8.2600233553912,8.2600233553912
"18","127","G1801270","2010","2","3","Indiana","Porter County",164343,"","Porter County Indiana",164053,169975,-290,-0.176460208223046,0.176460208223046,5632,3.42697894038687,3.42697894038687
"18","129","G1801290","2010","2","3","Indiana","Posey County",25910,"","Posey County Indiana",26008,28776,98,0.378232342724817,0.378232342724817,2866,11.0613662678503,11.0613662678503
"18","131","G1801310","2010","2","3","Indiana","Pulaski County",13402,"","Pulaski County Indiana",13311,14504,-91,-0.679003133860618,0.679003133860618,1102,8.22265333532309,8.22265333532309
"18","133","G1801330","2010","2","3","Indiana","Putnam County",37963,"","Putnam County Indiana",36642,38898,-1321,-3.47970392224008,3.47970392224008,935,2.46292442641519,2.46292442641519
"18","135","G1801350","2010","2","3","Indiana","Randolph County",26171,"","Randolph County Indiana",25640,28086,-531,-2.02896335638684,2.02896335638684,1915,7.31725956211073,7.31725956211073
"18","137","G1801370","2010","2","3","Indiana","Ripley County",28818,"","Ripley County Indiana",27358,30155,-1460,-5.06627802068152,5.06627802068152,1337,4.63946144770629,4.63946144770629
"18","139","G1801390","2010","2","3","Indiana","Rush County",17392,"","Rush County Indiana",17052,19258,-340,-1.95492180312788,1.95492180312788,1866,10.7290708371665,10.7290708371665
"18","141","G1801410","2010","2","3","Indiana","St. Joseph County",266931,"","St. Joseph County Indiana",266758,285315,-173,-0.0648107563377802,0.0648107563377802,18384,6.88717308967486,6.88717308967486
"18","143","G1801430","2010","2","3","Indiana","Scott County",24181,"","Scott County Indiana",23687,25895,-494,-2.04292626442248,2.04292626442248,1714,7.08820975145776,7.08820975145776
"18","145","G1801450","2010","2","3","Indiana","Shelby County",44436,"","Shelby County Indiana",44240,46766,-196,-0.441083805923125,0.441083805923125,2330,5.24349626429021,5.24349626429021
"18","147","G1801470","2010","2","3","Indiana","Spencer County",20952,"","Spencer County Indiana",19857,22483,-1095,-5.2262313860252,5.2262313860252,1531,7.30717831233295,7.30717831233295
"18","149","G1801490","2010","2","3","Indiana","Starke County",23363,"","Starke County Indiana",23441,25489,78,0.333861233574455,0.333861233574455,2126,9.09985875101657,9.09985875101657
"18","151","G1801510","2010","2","3","Indiana","Steuben County",34185,"","Steuben County Indiana",33542,37364,-643,-1.88094193359661,1.88094193359661,3179,9.29940032177856,9.29940032177856
"18","153","G1801530","2010","2","3","Indiana","Sullivan County",21475,"","Sullivan County Indiana",21227,22637,-248,-1.15483119906868,1.15483119906868,1162,5.41094295692666,5.41094295692666
"18","155","G1801550","2010","2","3","Indiana","Switzerland County",10613,"","Switzerland County Indiana",9713,11423,-900,-8.48016583435409,8.48016583435409,810,7.63214925091869,7.63214925091869
"18","157","G1801570","2010","2","3","Indiana","Tippecanoe County",172780,"","Tippecanoe County Indiana",168323,174390,-4457,-2.57958097001968,2.57958097001968,1610,0.93182081259405,0.93182081259405
"18","159","G1801590","2010","2","3","Indiana","Tipton County",15936,"","Tipton County Indiana",15692,17526,-244,-1.53112449799197,1.53112449799197,1590,9.97740963855422,9.97740963855422
"18","161","G1801610","2010","2","3","Indiana","Union County",7516,"","Union County Indiana",6992,8022,-524,-6.97179350718467,6.97179350718467,506,6.73230441724322,6.73230441724322
"18","163","G1801630","2010","2","3","Indiana","Vanderburgh County",179703,"","Vanderburgh County Indiana",175674,184913,-4029,-2.24203268726732,2.24203268726732,5210,2.89922817092647,2.89922817092647
"18","165","G1801650","2010","2","3","Indiana","Vermillion County",16212,"","Vermillion County Indiana",15917,17280,-295,-1.81963977300765,1.81963977300765,1068,6.58771280532939,6.58771280532939
"18","167","G1801670","2010","2","3","Indiana","Vigo County",107848,"","Vigo County Indiana",106451,111673,-1397,-1.29534159187004,1.29534159187004,3825,3.54665825977301,3.54665825977301
"18","169","G1801690","2010","2","3","Indiana","Wabash County",32888,"","Wabash County Indiana",32400,36089,-488,-1.48382388713208,1.48382388713208,3201,9.73303332522501,9.73303332522501
"18","171","G1801710","2010","2","3","Indiana","Warren County",8508,"","Warren County Indiana",8489,9400,-19,-0.223319228960978,0.223319228960978,892,10.4842501175364,10.4842501175364
"18","173","G1801730","2010","2","3","Indiana","Warrick County",59689,"","Warrick County Indiana",58983,63318,-706,-1.18279750037695,1.18279750037695,3629,6.07984720802828,6.07984720802828
"18","175","G1801750","2010","2","3","Indiana","Washington County",28262,"","Washington County Indiana",27720,29354,-542,-1.91776944306843,1.91776944306843,1092,3.86384544618215,3.86384544618215
"18","177","G1801770","2010","2","3","Indiana","Wayne County",68917,"","Wayne County Indiana",67334,72552,-1583,-2.29696591552157,2.29696591552157,3635,5.27446058302015,5.27446058302015
"18","179","G1801790","2010","2","3","Indiana","Wells County",27636,"","Wells County Indiana",27613,29586,-23,-0.0832247792734115,0.0832247792734115,1950,7.05601389491967,7.05601389491967
"18","181","G1801810","2010","2","3","Indiana","White County",24643,"","White County Indiana",23357,27265,-1286,-5.21852047234509,5.21852047234509,2622,10.6399383191981,10.6399383191981
"18","183","G1801830","2010","2","3","Indiana","Whitley County",33292,"","Whitley County Indiana",32852,34584,-440,-1.32163883215187,1.32163883215187,1292,3.88081220713685,3.88081220713685
"19","001","G1900010","2010","2","4","Iowa","Adair County",7682,"","Adair County Iowa",7322,8500,-360,-4.68627961468368,4.68627961468368,818,10.6482686800312,10.6482686800312
"19","003","G1900030","2010","2","4","Iowa","Adams County",4029,"","Adams County Iowa",3898,4513,-131,-3.25142715313974,3.25142715313974,484,12.0129064283941,12.0129064283941
"19","005","G1900050","2010","2","4","Iowa","Allamakee County",14330,"","Allamakee County Iowa",14518,15875,188,1.3119330076762,1.3119330076762,1545,10.781577110956,10.781577110956
"19","007","G1900070","2010","2","4","Iowa","Appanoose County",12887,"","Appanoose County Iowa",12625,13817,-262,-2.03305656863506,2.03305656863506,930,7.2165748428649,7.2165748428649
"19","009","G1900090","2010","2","4","Iowa","Audubon County",6119,"","Audubon County Iowa",5997,6874,-122,-1.99378983494035,1.99378983494035,755,12.3386174211472,12.3386174211472
"19","011","G1900110","2010","2","4","Iowa","Benton County",26076,"","Benton County Iowa",26719,26932,643,2.46586899831262,2.46586899831262,856,3.28271207240374,3.28271207240374
"19","013","G1900130","2010","2","4","Iowa","Black Hawk County",131090,"","Black Hawk County Iowa",129855,136517,-1235,-0.94210084674651,0.94210084674651,5427,4.13990388282859,4.13990388282859
"19","015","G1900150","2010","2","4","Iowa","Boone County",26306,"","Boone County Iowa",26062,28066,-244,-0.927545046757394,0.927545046757394,1760,6.69048886185661,6.69048886185661
"19","017","G1900170","2010","2","4","Iowa","Bremer County",24276,"","Bremer County Iowa",23531,25633,-745,-3.068874608667,3.068874608667,1357,5.58988301202834,5.58988301202834
"19","019","G1900190","2010","2","4","Iowa","Buchanan County",20958,"","Buchanan County Iowa",20925,22253,-33,-0.157457772688234,0.157457772688234,1295,6.17902471609886,6.17902471609886
"19","021","G1900210","2010","2","4","Iowa","Buena Vista County",20260,"","Buena Vista County Iowa",19832,20560,-428,-2.11253701875617,2.11253701875617,300,1.48075024679171,1.48075024679171
"19","023","G1900230","2010","2","4","Iowa","Butler County",14867,"","Butler County Iowa",14430,16149,-437,-2.93939597766866,2.93939597766866,1282,8.62312504203942,8.62312504203942
"19","025","G1900250","2010","2","4","Iowa","Calhoun County",9670,"","Calhoun County Iowa",9682,11046,12,0.124095139607032,0.124095139607032,1376,14.229576008273,14.229576008273
"19","027","G1900270","2010","2","4","Iowa","Carroll County",20816,"","Carroll County Iowa",20760,22262,-56,-0.26902382782475,0.26902382782475,1446,6.94657955418908,6.94657955418908
"19","029","G1900290","2010","2","4","Iowa","Cass County",13956,"","Cass County Iowa",13804,14988,-152,-1.08913728862138,1.08913728862138,1032,7.39466895958727,7.39466895958727
"19","031","G1900310","2010","2","4","Iowa","Cedar County",18499,"","Cedar County Iowa",17966,19538,-533,-2.88123682361209,2.88123682361209,1039,5.61651981188172,5.61651981188172
"19","033","G1900330","2010","2","4","Iowa","Cerro Gordo County",44151,"","Cerro Gordo County Iowa",43565,47504,-586,-1.3272632556454,1.3272632556454,3353,7.59439197300174,7.59439197300174
"19","035","G1900350","2010","2","4","Iowa","Cherokee County",12072,"","Cherokee County Iowa",11490,13161,-582,-4.82107355864811,4.82107355864811,1089,9.02087475149105,9.02087475149105
"19","037","G1900370","2010","2","4","Iowa","Chickasaw County",12439,"","Chickasaw County Iowa",12070,13500,-369,-2.9664764048557,2.9664764048557,1061,8.52962456789131,8.52962456789131
"19","039","G1900390","2010","2","4","Iowa","Clarke County",9286,"","Clarke County Iowa",9099,9744,-187,-2.01378419125565,2.01378419125565,458,4.93215593366358,4.93215593366358
"19","041","G1900410","2010","2","4","Iowa","Clay County",16667,"","Clay County Iowa",16544,18033,-123,-0.737985240295194,0.737985240295194,1366,8.19583608327834,8.19583608327834
"19","043","G1900430","2010","2","4","Iowa","Clayton County",18129,"","Clayton County Iowa",17381,19520,-748,-4.12598598929891,4.12598598929891,1391,7.67278945336202,7.67278945336202
"19","045","G1900450","2010","2","4","Iowa","Clinton County",49116,"","Clinton County Iowa",48895,51911,-221,-0.449955208078834,0.449955208078834,2795,5.69060998452643,5.69060998452643
"19","047","G1900470","2010","2","4","Iowa","Crawford County",17096,"","Crawford County Iowa",16545,17303,-551,-3.22297613476837,3.22297613476837,207,1.21080954609265,1.21080954609265
"19","049","G1900490","2010","2","4","Iowa","Dallas County",66135,"","Dallas County Iowa",63835,60735,-2300,-3.47773493611552,3.47773493611552,-5400,-8.16511680653209,8.16511680653209
"19","051","G1900510","2010","2","4","Iowa","Davis County",8753,"","Davis County Iowa",8614,8846,-139,-1.58802696218439,1.58802696218439,93,1.062492859591,1.062492859591
"19","053","G1900530","2010","2","4","Iowa","Decatur County",8457,"","Decatur County Iowa",8133,8768,-324,-3.8311457963817,3.8311457963817,311,3.67742698356391,3.67742698356391
"19","055","G1900550","2010","2","4","Iowa","Delaware County",17764,"","Delaware County Iowa",17174,19081,-590,-3.32132402612024,3.32132402612024,1317,7.41387074983112,7.41387074983112
"19","057","G1900570","2010","2","4","Iowa","Des Moines County",40325,"","Des Moines County Iowa",40935,42943,610,1.51270923744575,1.51270923744575,2618,6.4922504649721,6.4922504649721
"19","059","G1900590","2010","2","4","Iowa","Dickinson County",16667,"","Dickinson County Iowa",16622,19119,-45,-0.269994600107998,0.269994600107998,2452,14.7117057658847,14.7117057658847
"19","061","G1900610","2010","2","4","Iowa","Dubuque County",93653,"","Dubuque County Iowa",93788,99253,135,0.144149146316722,0.144149146316722,5600,5.97952014350848,5.97952014350848
"19","063","G1900630","2010","2","4","Iowa","Emmet County",10302,"","Emmet County Iowa",10235,11182,-67,-0.650359153562415,0.650359153562415,880,8.5420306736556,8.5420306736556
"19","065","G1900650","2010","2","4","Iowa","Fayette County",20880,"","Fayette County Iowa",20120,22502,-760,-3.63984674329502,3.63984674329502,1622,7.76819923371647,7.76819923371647
"19","067","G1900670","2010","2","4","Iowa","Floyd County",16303,"","Floyd County Iowa",15999,17189,-304,-1.86468748083175,1.86468748083175,886,5.43458259216095,5.43458259216095
"19","069","G1900690","2010","2","4","Iowa","Franklin County",10680,"","Franklin County Iowa",10518,10691,-162,-1.51685393258427,1.51685393258427,11,0.102996254681648,0.102996254681648
"19","071","G1900710","2010","2","4","Iowa","Fremont County",7441,"","Fremont County Iowa",7325,8213,-116,-1.55893025131031,1.55893025131031,772,10.3749496035479,10.3749496035479
"19","073","G1900730","2010","2","4","Iowa","Greene County",9336,"","Greene County Iowa",9243,10520,-93,-0.996143958868895,0.996143958868895,1184,12.6820908311911,12.6820908311911
"19","075","G1900750","2010","2","4","Iowa","Grundy County",12453,"","Grundy County Iowa",12152,13284,-301,-2.41708825182687,2.41708825182687,831,6.6730908214888,6.6730908214888
"19","077","G1900770","2010","2","4","Iowa","Guthrie County",10954,"","Guthrie County Iowa",10866,12093,-88,-0.803359503377762,0.803359503377762,1139,10.3980281175826,10.3980281175826
"19","079","G1900790","2010","2","4","Iowa","Hamilton County",15673,"","Hamilton County Iowa",15082,17010,-591,-3.77081605308492,3.77081605308492,1337,8.53059401518535,8.53059401518535
"19","081","G1900810","2010","2","4","Iowa","Hancock County",11341,"","Hancock County Iowa",11001,12470,-340,-2.99797196014461,2.99797196014461,1129,9.95503042059783,9.95503042059783
"19","083","G1900830","2010","2","4","Iowa","Hardin County",17534,"","Hardin County Iowa",17137,18980,-397,-2.26417246492529,2.26417246492529,1446,8.24683472111326,8.24683472111326
"19","085","G1900850","2010","2","4","Iowa","Harrison County",14928,"","Harrison County Iowa",15283,16628,355,2.37808145766345,2.37808145766345,1700,11.3879957127546,11.3879957127546
"19","087","G1900870","2010","2","4","Iowa","Henry County",20145,"","Henry County Iowa",19885,21208,-260,-1.29064283941425,1.29064283941425,1063,5.27674360883594,5.27674360883594
"19","089","G1900890","2010","2","4","Iowa","Howard County",9566,"","Howard County Iowa",9375,10231,-191,-1.99665481915116,1.99665481915116,665,6.95170395149488,6.95170395149488
"19","091","G1900910","2010","2","4","Iowa","Humboldt County",9815,"","Humboldt County Iowa",9397,10746,-418,-4.25878757004585,4.25878757004585,931,9.48548140601121,9.48548140601121
"19","093","G1900930","2010","2","4","Iowa","Ida County",7089,"","Ida County Iowa",6748,7935,-341,-4.81026943151361,4.81026943151361,846,11.9339822259839,11.9339822259839
"19","095","G1900950","2010","2","4","Iowa","Iowa County",16355,"","Iowa County Iowa",15667,16389,-688,-4.20666462855396,4.20666462855396,34,0.207887496178539,0.207887496178539
"19","097","G1900970","2010","2","4","Iowa","Jackson County",19848,"","Jackson County Iowa",19723,21341,-125,-0.629786376461104,0.629786376461104,1493,7.52216848045143,7.52216848045143
"19","099","G1900990","2010","2","4","Iowa","Jasper County",36842,"","Jasper County Iowa",36143,38726,-699,-1.89729113511753,1.89729113511753,1884,5.11372889636828,5.11372889636828
"19","101","G1901010","2010","2","4","Iowa","Jefferson County",16843,"","Jefferson County Iowa",15408,17128,-1435,-8.51985988244375,8.51985988244375,285,1.69209760731461,1.69209760731461
"19","103","G1901030","2010","2","4","Iowa","Johnson County",130882,"","Johnson County Iowa",131924,137135,1042,0.796136978346908,0.796136978346908,6253,4.77758591708562,4.77758591708562
"19","105","G1901050","2010","2","4","Iowa","Jones County",20638,"","Jones County Iowa",20140,21018,-498,-2.41302451787964,2.41302451787964,380,1.84126368834189,1.84126368834189
"19","107","G1901070","2010","2","4","Iowa","Keokuk County",10511,"","Keokuk County Iowa",10561,11439,50,0.475692132052136,0.475692132052136,928,8.82884597088764,8.82884597088764
"19","109","G1901090","2010","2","4","Iowa","Kossuth County",15543,"","Kossuth County Iowa",15080,17249,-463,-2.97883291513865,2.97883291513865,1706,10.9760020588046,10.9760020588046
"19","111","G1901110","2010","2","4","Iowa","Lee County",35862,"","Lee County Iowa",35533,38218,-329,-0.917405610395405,0.917405610395405,2356,6.56962801851542,6.56962801851542
"19","113","G1901130","2010","2","4","Iowa","Linn County",211226,"","Linn County Iowa",209809,223910,-1417,-0.670845445163001,0.670845445163001,12684,6.00494257335745,6.00494257335745
"19","115","G1901150","2010","2","4","Iowa","Louisa County",11387,"","Louisa County Iowa",11287,12565,-100,-0.8781944322473,0.8781944322473,1178,10.3451304118732,10.3451304118732
"19","117","G1901170","2010","2","4","Iowa","Lucas County",8898,"","Lucas County Iowa",9106,9483,208,2.33760395594516,2.33760395594516,585,6.57451112609575,6.57451112609575
"19","119","G1901190","2010","2","4","Iowa","Lyon County",11581,"","Lyon County Iowa",11192,12263,-389,-3.35895000431742,3.35895000431742,682,5.88895604870046,5.88895604870046
"19","121","G1901210","2010","2","4","Iowa","Madison County",15679,"","Madison County Iowa",15575,16355,-104,-0.663307608903629,0.663307608903629,676,4.31149945787359,4.31149945787359
"19","123","G1901230","2010","2","4","Iowa","Mahaska County",22381,"","Mahaska County Iowa",21954,22941,-427,-1.90786828113132,1.90786828113132,560,2.50212233590992,2.50212233590992
"19","125","G1901250","2010","2","4","Iowa","Marion County",33309,"","Marion County Iowa",32505,35206,-804,-2.41376204629379,2.41376204629379,1897,5.69515746494941,5.69515746494941
"19","127","G1901270","2010","2","4","Iowa","Marshall County",40648,"","Marshall County Iowa",39679,41261,-969,-2.38388112576265,2.38388112576265,613,1.50806927770124,1.50806927770124
"19","129","G1901290","2010","2","4","Iowa","Mills County",15059,"","Mills County Iowa",15000,15220,-59,-0.391792283684176,0.391792283684176,161,1.06912809615512,1.06912809615512
"19","131","G1901310","2010","2","4","Iowa","Mitchell County",10776,"","Mitchell County Iowa",10756,11149,-20,-0.185597624350408,0.185597624350408,373,3.46139569413512,3.46139569413512
"19","133","G1901330","2010","2","4","Iowa","Monona County",9243,"","Monona County Iowa",8856,10304,-387,-4.18695228821811,4.18695228821811,1061,11.4789570485773,11.4789570485773
"19","135","G1901350","2010","2","4","Iowa","Monroe County",7970,"","Monroe County Iowa",7539,8150,-431,-5.4077791718946,5.4077791718946,180,2.25846925972396,2.25846925972396
"19","137","G1901370","2010","2","4","Iowa","Montgomery County",10740,"","Montgomery County Iowa",10692,11760,-48,-0.446927374301676,0.446927374301676,1020,9.49720670391061,9.49720670391061
"19","139","G1901390","2010","2","4","Iowa","Muscatine County",42745,"","Muscatine County Iowa",42997,44847,252,0.58954263656568,0.58954263656568,2102,4.91753421452802,4.91753421452802
"19","141","G1901410","2010","2","4","Iowa","O'Brien County",14398,"","O'Brien County Iowa",13873,15553,-525,-3.64633976941242,3.64633976941242,1155,8.02194749270732,8.02194749270732
"19","143","G1901430","2010","2","4","Iowa","Osceola County",6462,"","Osceola County Iowa",6258,6980,-204,-3.1569173630455,3.1569173630455,518,8.01609408851749,8.01609408851749
"19","145","G1901450","2010","2","4","Iowa","Page County",15932,"","Page County Iowa",15280,17052,-652,-4.09239266884258,4.09239266884258,1120,7.0298769771529,7.0298769771529
"19","147","G1901470","2010","2","4","Iowa","Palo Alto County",9421,"","Palo Alto County Iowa",9175,10384,-246,-2.61118777199873,2.61118777199873,963,10.2218448147755,10.2218448147755
"19","149","G1901490","2010","2","4","Iowa","Plymouth County",24986,"","Plymouth County Iowa",24221,26715,-765,-3.06171456015369,3.06171456015369,1729,6.91987513007284,6.91987513007284
"19","151","G1901510","2010","2","4","Iowa","Pocahontas County",7310,"","Pocahontas County Iowa",7243,8655,-67,-0.916552667578659,0.916552667578659,1345,18.3994528043776,18.3994528043776
"19","153","G1901530","2010","2","4","Iowa","Polk County",430640,"","Polk County Iowa",433462,448764,2822,0.655303733977336,0.655303733977336,18124,4.20861972877578,4.20861972877578
"19","155","G1901550","2010","2","4","Iowa","Pottawattamie County",93158,"","Pottawattamie County Iowa",91059,98237,-2099,-2.25316129586294,2.25316129586294,5079,5.45202773782176,5.45202773782176
"19","157","G1901570","2010","2","4","Iowa","Poweshiek County",18914,"","Poweshiek County Iowa",18362,20098,-552,-2.91847308871735,2.91847308871735,1184,6.25991329174157,6.25991329174157
"19","159","G1901590","2010","2","4","Iowa","Ringgold County",5131,"","Ringgold County Iowa",4938,5628,-193,-3.76145000974469,3.76145000974469,497,9.6862210095498,9.6862210095498
"19","161","G1901610","2010","2","4","Iowa","Sac County",10350,"","Sac County Iowa",10018,11772,-332,-3.20772946859903,3.20772946859903,1422,13.7391304347826,13.7391304347826
"19","163","G1901630","2010","2","4","Iowa","Scott County",165224,"","Scott County Iowa",168499,173612,3275,1.98215755580303,1.98215755580303,8388,5.07674429864911,5.07674429864911
"19","165","G1901650","2010","2","4","Iowa","Shelby County",12167,"","Shelby County Iowa",11871,13303,-296,-2.43281005999836,2.43281005999836,1136,9.33673050053423,9.33673050053423
"19","167","G1901670","2010","2","4","Iowa","Sioux County",33704,"","Sioux County Iowa",32235,34109,-1469,-4.35853311179682,4.35853311179682,405,1.20163778779967,1.20163778779967
"19","169","G1901690","2010","2","4","Iowa","Story County",89542,"","Story County Iowa",87668,91049,-1874,-2.09287261843604,2.09287261843604,1507,1.68300909070604,1.68300909070604
"19","171","G1901710","2010","2","4","Iowa","Tama County",17767,"","Tama County Iowa",17274,18751,-493,-2.7748072268813,2.7748072268813,984,5.53835762931277,5.53835762931277
"19","173","G1901730","2010","2","4","Iowa","Taylor County",6317,"","Taylor County Iowa",6311,7028,-6,-0.0949817951559284,0.0949817951559284,711,11.2553427259775,11.2553427259775
"19","175","G1901750","2010","2","4","Iowa","Union County",12534,"","Union County Iowa",12182,12586,-352,-2.80836125737993,2.80836125737993,52,0.414871549385671,0.414871549385671
"19","177","G1901770","2010","2","4","Iowa","Van Buren County",7570,"","Van Buren County Iowa",7517,7968,-53,-0.700132100396301,0.700132100396301,398,5.25759577278732,5.25759577278732
"19","179","G1901790","2010","2","4","Iowa","Wapello County",35625,"","Wapello County Iowa",35543,37375,-82,-0.230175438596491,0.230175438596491,1750,4.91228070175439,4.91228070175439
"19","181","G1901810","2010","2","4","Iowa","Warren County",46225,"","Warren County Iowa",45511,47311,-714,-1.54461871281774,1.54461871281774,1086,2.34937804218496,2.34937804218496
"19","183","G1901830","2010","2","4","Iowa","Washington County",21704,"","Washington County Iowa",21229,21734,-475,-2.18853667526723,2.18853667526723,30,0.138223368964246,0.138223368964246
"19","185","G1901850","2010","2","4","Iowa","Wayne County",6403,"","Wayne County Iowa",6276,6792,-127,-1.98344526003436,1.98344526003436,389,6.07527721380603,6.07527721380603
"19","187","G1901870","2010","2","4","Iowa","Webster County",38013,"","Webster County Iowa",38206,40870,193,0.507721042801147,0.507721042801147,2857,7.51584984084392,7.51584984084392
"19","189","G1901890","2010","2","4","Iowa","Winnebago County",10866,"","Winnebago County Iowa",10624,11990,-242,-2.22713049880361,2.22713049880361,1124,10.3441928952696,10.3441928952696
"19","191","G1901910","2010","2","4","Iowa","Winneshiek County",21056,"","Winneshiek County Iowa",20738,22799,-318,-1.51025835866261,1.51025835866261,1743,8.27792553191489,8.27792553191489
"19","193","G1901930","2010","2","4","Iowa","Woodbury County",102172,"","Woodbury County Iowa",103619,105585,1447,1.41623928277806,1.41623928277806,3413,3.34044552323533,3.34044552323533
"19","195","G1901950","2010","2","4","Iowa","Worth County",7598,"","Worth County Iowa",7564,7953,-34,-0.447486180573835,0.447486180573835,355,4.67228217952093,4.67228217952093
"19","197","G1901970","2010","2","4","Iowa","Wright County",13229,"","Wright County Iowa",12629,14368,-600,-4.53549021090029,4.53549021090029,1139,8.60987225035906,8.60987225035906
"20","001","G2000010","2010","2","4","Kansas","Allen County",13371,"","Allen County Kansas",13196,14646,-175,-1.30880263256301,1.30880263256301,1275,9.53556203724478,9.53556203724478
"20","003","G2000030","2010","2","4","Kansas","Anderson County",8102,"","Anderson County Kansas",7839,8453,-263,-3.24611207109356,3.24611207109356,351,4.33226363860775,4.33226363860775
"20","005","G2000050","2010","2","4","Kansas","Atchison County",16924,"","Atchison County Kansas",16391,17269,-533,-3.14937367052706,3.14937367052706,345,2.03852517135429,2.03852517135429
"20","007","G2000070","2010","2","4","Kansas","Barber County",4861,"","Barber County Kansas",4595,5346,-266,-5.47212507714462,5.47212507714462,485,9.97737091133512,9.97737091133512
"20","009","G2000090","2010","2","4","Kansas","Barton County",27674,"","Barton County Kansas",27663,28432,-11,-0.039748500397485,0.039748500397485,758,2.73903302739033,2.73903302739033
"20","011","G2000110","2010","2","4","Kansas","Bourbon County",15173,"","Bourbon County Kansas",14852,15703,-321,-2.11560007908785,2.11560007908785,530,3.49304685955315,3.49304685955315
"20","013","G2000130","2010","2","4","Kansas","Brown County",9984,"","Brown County Kansas",9967,10942,-17,-0.170272435897436,0.170272435897436,958,9.59535256410256,9.59535256410256
"20","015","G2000150","2010","2","4","Kansas","Butler County",65880,"","Butler County Kansas",64027,67204,-1853,-2.81268973891925,2.81268973891925,1324,2.00971463266545,2.00971463266545
"20","017","G2000170","2010","2","4","Kansas","Chase County",2790,"","Chase County Kansas",2803,3058,13,0.465949820788531,0.465949820788531,268,9.60573476702509,9.60573476702509
"20","019","G2000190","2010","2","4","Kansas","Chautauqua County",3669,"","Chautauqua County Kansas",3700,4482,31,0.844916871082039,0.844916871082039,813,22.1586263286999,22.1586263286999
"20","021","G2000210","2010","2","4","Kansas","Cherokee County",21603,"","Cherokee County Kansas",20974,23304,-629,-2.91163264361431,2.91163264361431,1701,7.87390640188863,7.87390640188863
"20","023","G2000230","2010","2","4","Kansas","Cheyenne County",2726,"","Cheyenne County Kansas",2671,3165,-55,-2.01760821716801,2.01760821716801,439,16.1041819515774,16.1041819515774
"20","025","G2000250","2010","2","4","Kansas","Clark County",2215,"","Clark County Kansas",2048,2468,-167,-7.53950338600451,7.53950338600451,253,11.4221218961625,11.4221218961625
"20","027","G2000270","2010","2","4","Kansas","Clay County",8535,"","Clay County Kansas",8755,9133,220,2.5776215582894,2.5776215582894,598,7.00644405389572,7.00644405389572
"20","029","G2000290","2010","2","4","Kansas","Cloud County",9533,"","Cloud County Kansas",9248,10222,-285,-2.98961502150425,2.98961502150425,689,7.22752543795238,7.22752543795238
"20","031","G2000310","2010","2","4","Kansas","Coffey County",8601,"","Coffey County Kansas",8480,9487,-121,-1.40681316126032,1.40681316126032,886,10.30112777584,10.30112777584
"20","033","G2000330","2010","2","4","Kansas","Comanche County",1891,"","Comanche County Kansas",1890,1956,-1,-0.0528820729772607,0.0528820729772607,65,3.43733474352195,3.43733474352195
"20","035","G2000350","2010","2","4","Kansas","Cowley County",36311,"","Cowley County Kansas",33803,37705,-2508,-6.90699787943047,6.90699787943047,1394,3.83905703505825,3.83905703505825
"20","037","G2000370","2010","2","4","Kansas","Crawford County",39134,"","Crawford County Kansas",38974,40948,-160,-0.408851637961875,0.408851637961875,1814,4.63535544539275,4.63535544539275
"20","039","G2000390","2010","2","4","Kansas","Decatur County",2961,"","Decatur County Kansas",2852,3478,-109,-3.68118878757177,3.68118878757177,517,17.4603174603175,17.4603174603175
"20","041","G2000410","2010","2","4","Kansas","Dickinson County",19754,"","Dickinson County Kansas",18907,20147,-847,-4.28773919206237,4.28773919206237,393,1.98947048698998,1.98947048698998
"20","043","G2000430","2010","2","4","Kansas","Doniphan County",7945,"","Doniphan County Kansas",7673,8448,-272,-3.4235368156073,3.4235368156073,503,6.33102580239144,6.33102580239144
"20","045","G2000450","2010","2","4","Kansas","Douglas County",110826,"","Douglas County Kansas",116857,118387,6031,5.44186382256871,5.44186382256871,7561,6.82240629455182,6.82240629455182
"20","047","G2000470","2010","2","4","Kansas","Edwards County",3037,"","Edwards County Kansas",3094,3467,57,1.87685215673362,1.87685215673362,430,14.1587092525519,14.1587092525519
"20","049","G2000490","2010","2","4","Kansas","Elk County",2882,"","Elk County Kansas",2949,3365,67,2.32477446217904,2.32477446217904,483,16.7591950034698,16.7591950034698
"20","051","G2000510","2010","2","4","Kansas","Ellis County",28452,"","Ellis County Kansas",27838,28522,-614,-2.15802052579783,2.15802052579783,70,0.246028398706594,0.246028398706594
"20","053","G2000530","2010","2","4","Kansas","Ellsworth County",6497,"","Ellsworth County Kansas",6207,6690,-290,-4.46359858396183,4.46359858396183,193,2.97060181622287,2.97060181622287
"20","055","G2000550","2010","2","4","Kansas","Finney County",36776,"","Finney County Kansas",42904,41182,6128,16.6630411137699,16.6630411137699,4406,11.980639547531,11.980639547531
"20","057","G2000570","2010","2","4","Kansas","Ford County",33848,"","Ford County Kansas",34582,33589,734,2.16851808083195,2.16851808083195,-259,-0.765185535334436,0.765185535334436
"20","059","G2000590","2010","2","4","Kansas","Franklin County",25992,"","Franklin County Kansas",26607,27536,615,2.36611265004617,2.36611265004617,1544,5.9402893197907,5.9402893197907
"20","061","G2000610","2010","2","4","Kansas","Geary County",34362,"","Geary County Kansas",33947,33395,-415,-1.20772946859903,1.20772946859903,-967,-2.81415517141028,2.81415517141028
"20","063","G2000630","2010","2","4","Kansas","Gove County",2695,"","Gove County Kansas",2520,3128,-175,-6.49350649350649,6.49350649350649,433,16.0667903525046,16.0667903525046
"20","065","G2000650","2010","2","4","Kansas","Graham County",2597,"","Graham County Kansas",2409,2980,-188,-7.23912206391991,7.23912206391991,383,14.7477859068156,14.7477859068156
"20","067","G2000670","2010","2","4","Kansas","Grant County",7829,"","Grant County Kansas",7454,8064,-375,-4.78988376548729,4.78988376548729,235,3.0016604930387,3.0016604930387
"20","069","G2000690","2010","2","4","Kansas","Gray County",6006,"","Gray County Kansas",6115,6318,109,1.81485181485181,1.81485181485181,312,5.19480519480519,5.19480519480519
"20","071","G2000710","2010","2","4","Kansas","Greeley County",1247,"","Greeley County Kansas",1280,1547,33,2.64635124298316,2.64635124298316,300,24.0577385725742,24.0577385725742
"20","073","G2000730","2010","2","4","Kansas","Greenwood County",6689,"","Greenwood County Kansas",6650,7769,-39,-0.583046793242637,0.583046793242637,1080,16.1459111974884,16.1459111974884
"20","075","G2000750","2010","2","4","Kansas","Hamilton County",2690,"","Hamilton County Kansas",2642,2709,-48,-1.78438661710037,1.78438661710037,19,0.706319702602231,0.706319702602231
"20","077","G2000770","2010","2","4","Kansas","Harper County",6034,"","Harper County Kansas",5683,6575,-351,-5.81703679151475,5.81703679151475,541,8.96586012595293,8.96586012595293
"20","079","G2000790","2010","2","4","Kansas","Harvey County",34684,"","Harvey County Kansas",34588,35278,-96,-0.276784684580787,0.276784684580787,594,1.71260523584362,1.71260523584362
"20","081","G2000810","2010","2","4","Kansas","Haskell County",4256,"","Haskell County Kansas",4044,4425,-212,-4.9812030075188,4.9812030075188,169,3.97086466165414,3.97086466165414
"20","083","G2000830","2010","2","4","Kansas","Hodgeman County",1916,"","Hodgeman County Kansas",1880,2147,-36,-1.87891440501044,1.87891440501044,231,12.0563674321503,12.0563674321503
"20","085","G2000850","2010","2","4","Kansas","Jackson County",13462,"","Jackson County Kansas",13448,13758,-14,-0.103996434407963,0.103996434407963,296,2.19878175605408,2.19878175605408
"20","087","G2000870","2010","2","4","Kansas","Jefferson County",19126,"","Jefferson County Kansas",18304,20533,-822,-4.29781449335982,4.29781449335982,1407,7.35647809264875,7.35647809264875
"20","089","G2000890","2010","2","4","Kansas","Jewell County",3077,"","Jewell County Kansas",3039,3843,-38,-1.23496912577186,1.23496912577186,766,24.894377640559,24.894377640559
"20","091","G2000910","2010","2","4","Kansas","Johnson County",544179,"","Johnson County Kansas",547944,543276,3765,0.691867933161699,0.691867933161699,-903,-0.165938046120854,0.165938046120854
"20","093","G2000930","2010","2","4","Kansas","Kearny County",3977,"","Kearny County Kansas",4258,4700,281,7.0656273573045,7.0656273573045,723,18.179532310787,18.179532310787
"20","095","G2000950","2010","2","4","Kansas","Kingman County",7858,"","Kingman County Kansas",7530,8862,-328,-4.1740900992619,4.1740900992619,1004,12.7767879867651,12.7767879867651
"20","097","G2000970","2010","2","4","Kansas","Kiowa County",2553,"","Kiowa County Kansas",2403,3813,-150,-5.87544065804935,5.87544065804935,1260,49.3537015276146,49.3537015276146
"20","099","G2000990","2010","2","4","Kansas","Labette County",21607,"","Labette County Kansas",21654,23014,47,0.217522099319665,0.217522099319665,1407,6.51177859027167,6.51177859027167
"20","101","G2001010","2010","2","4","Kansas","Lane County",1750,"","Lane County Kansas",1718,2133,-32,-1.82857142857143,1.82857142857143,383,21.8857142857143,21.8857142857143
"20","103","G2001030","2010","2","4","Kansas","Leavenworth County",76227,"","Leavenworth County Kansas",75560,80706,-667,-0.875018038227924,0.875018038227924,4479,5.87587075445708,5.87587075445708
"20","105","G2001050","2010","2","4","Kansas","Lincoln County",3241,"","Lincoln County Kansas",3119,3607,-122,-3.76427028694847,3.76427028694847,366,11.2928108608454,11.2928108608454
"20","107","G2001070","2010","2","4","Kansas","Linn County",9656,"","Linn County Kansas",9239,10395,-417,-4.3185584092792,4.3185584092792,739,7.65327257663629,7.65327257663629
"20","109","G2001090","2010","2","4","Kansas","Logan County",2756,"","Logan County Kansas",2556,3060,-200,-7.25689404934688,7.25689404934688,304,11.0304789550073,11.0304789550073
"20","111","G2001110","2010","2","4","Kansas","Lyon County",33690,"","Lyon County Kansas",33407,37420,-283,-0.840011872959335,0.840011872959335,3730,11.0715345799941,11.0715345799941
"20","113","G2001130","2010","2","4","Kansas","McPherson County",29180,"","McPherson County Kansas",28878,31566,-302,-1.03495544893763,1.03495544893763,2386,8.17683344756683,8.17683344756683
"20","115","G2001150","2010","2","4","Kansas","Marion County",12660,"","Marion County Kansas",11975,14101,-685,-5.41074249605055,5.41074249605055,1441,11.3823064770932,11.3823064770932
"20","117","G2001170","2010","2","4","Kansas","Marshall County",10117,"","Marshall County Kansas",10099,11200,-18,-0.177918355243649,0.177918355243649,1083,10.7047543738262,10.7047543738262
"20","119","G2001190","2010","2","4","Kansas","Meade County",4575,"","Meade County Kansas",4425,4666,-150,-3.27868852459016,3.27868852459016,91,1.98907103825137,1.98907103825137
"20","121","G2001210","2010","2","4","Kansas","Miami County",32787,"","Miami County Kansas",31159,32753,-1628,-4.96538262116083,4.96538262116083,-34,-0.10369963705127,0.10369963705127
"20","123","G2001230","2010","2","4","Kansas","Mitchell County",6373,"","Mitchell County Kansas",6281,6956,-92,-1.44359014592813,1.44359014592813,583,9.14796798995763,9.14796798995763
"20","125","G2001250","2010","2","4","Kansas","Montgomery County",35471,"","Montgomery County Kansas",33984,36463,-1487,-4.19215697330213,4.19215697330213,992,2.79665078514843,2.79665078514843
"20","127","G2001270","2010","2","4","Kansas","Morris County",5923,"","Morris County Kansas",5948,6318,25,0.422083403680567,0.422083403680567,395,6.66891777815296,6.66891777815296
"20","129","G2001290","2010","2","4","Kansas","Morton County",3233,"","Morton County Kansas",3025,3586,-208,-6.43365295391277,6.43365295391277,353,10.9186514073616,10.9186514073616
"20","131","G2001310","2010","2","4","Kansas","Nemaha County",10178,"","Nemaha County Kansas",9942,11044,-236,-2.31872666535665,2.31872666535665,866,8.50854784830026,8.50854784830026
"20","133","G2001330","2010","2","4","Kansas","Neosho County",16512,"","Neosho County Kansas",15958,17244,-554,-3.35513565891473,3.35513565891473,732,4.43313953488372,4.43313953488372
"20","135","G2001350","2010","2","4","Kansas","Ness County",3107,"","Ness County Kansas",2825,3452,-282,-9.0762793691664,9.0762793691664,345,11.1039588027036,11.1039588027036
"20","137","G2001370","2010","2","4","Kansas","Norton County",5671,"","Norton County Kansas",5336,5988,-335,-5.90724739904779,5.90724739904779,317,5.5898430611885,5.5898430611885
"20","139","G2001390","2010","2","4","Kansas","Osage County",16295,"","Osage County Kansas",16094,17973,-201,-1.23350721080086,1.23350721080086,1678,10.2976373120589,10.2976373120589
"20","141","G2001410","2010","2","4","Kansas","Osborne County",3858,"","Osborne County Kansas",3773,4448,-85,-2.20321410057024,2.20321410057024,590,15.2928978745464,15.2928978745464
"20","143","G2001430","2010","2","4","Kansas","Ottawa County",6091,"","Ottawa County Kansas",5944,6428,-147,-2.41339681497291,2.41339681497291,337,5.53275324248892,5.53275324248892
"20","145","G2001450","2010","2","4","Kansas","Pawnee County",6973,"","Pawnee County Kansas",6223,7295,-750,-10.7557722644486,10.7557722644486,322,4.61781155886993,4.61781155886993
"20","147","G2001470","2010","2","4","Kansas","Phillips County",5642,"","Phillips County Kansas",5243,6051,-399,-7.07196029776675,7.07196029776675,409,7.24920241049273,7.24920241049273
"20","149","G2001490","2010","2","4","Kansas","Pottawatomie County",21604,"","Pottawatomie County Kansas",20247,21683,-1357,-6.28124421403444,6.28124421403444,79,0.365673023514164,0.365673023514164
"20","151","G2001510","2010","2","4","Kansas","Pratt County",9656,"","Pratt County Kansas",9310,9911,-346,-3.58326429163215,3.58326429163215,255,2.64084507042254,2.64084507042254
"20","153","G2001530","2010","2","4","Kansas","Rawlins County",2519,"","Rawlins County Kansas",2396,2989,-123,-4.88289003572846,4.88289003572846,470,18.658197697499,18.658197697499
"20","155","G2001550","2010","2","4","Kansas","Reno County",64511,"","Reno County Kansas",63767,66376,-744,-1.15329168668909,1.15329168668909,1865,2.89097983289672,2.89097983289672
"20","157","G2001570","2010","2","4","Kansas","Republic County",4980,"","Republic County Kansas",4708,5928,-272,-5.46184738955823,5.46184738955823,948,19.0361445783133,19.0361445783133
"20","159","G2001590","2010","2","4","Kansas","Rice County",10083,"","Rice County Kansas",9988,10795,-95,-0.942179906773778,0.942179906773778,712,7.06139045918873,7.06139045918873
"20","161","G2001610","2010","2","4","Kansas","Riley County",71115,"","Riley County Kansas",70774,72983,-341,-0.479505027068832,0.479505027068832,1868,2.62673135062926,2.62673135062926
"20","163","G2001630","2010","2","4","Kansas","Rooks County",5181,"","Rooks County Kansas",4978,5722,-203,-3.91816251688863,3.91816251688863,541,10.4419996139741,10.4419996139741
"20","165","G2001650","2010","2","4","Kansas","Rush County",3307,"","Rush County Kansas",3168,3562,-139,-4.20320532204415,4.20320532204415,255,7.71091623828243,7.71091623828243
"20","167","G2001670","2010","2","4","Kansas","Russell County",6970,"","Russell County Kansas",6641,7304,-329,-4.72022955523673,4.72022955523673,334,4.79196556671449,4.79196556671449
"20","169","G2001690","2010","2","4","Kansas","Saline County",55606,"","Saline County Kansas",54848,56052,-758,-1.3631622486782,1.3631622486782,446,0.802071718879258,0.802071718879258
"20","171","G2001710","2010","2","4","Kansas","Scott County",4936,"","Scott County Kansas",4685,5160,-251,-5.08508914100486,5.08508914100486,224,4.53808752025932,4.53808752025932
"20","173","G2001730","2010","2","4","Kansas","Sedgwick County",498365,"","Sedgwick County Kansas",493213,501347,-5152,-1.0337804621111,1.0337804621111,2982,0.598356626167568,0.598356626167568
"20","175","G2001750","2010","2","4","Kansas","Seward County",22952,"","Seward County Kansas",23352,23081,400,1.74276751481352,1.74276751481352,129,0.562042523527362,0.562042523527362
"20","177","G2001770","2010","2","4","Kansas","Shawnee County",177934,"","Shawnee County Kansas",177418,183868,-516,-0.289995166747221,0.289995166747221,5934,3.33494441759304,3.33494441759304
"20","179","G2001790","2010","2","4","Kansas","Sheridan County",2556,"","Sheridan County Kansas",2396,2903,-160,-6.25978090766823,6.25978090766823,347,13.5758998435055,13.5758998435055
"20","181","G2001810","2010","2","4","Kansas","Sherman County",6010,"","Sherman County Kansas",5843,6901,-167,-2.77870216306156,2.77870216306156,891,14.8252911813644,14.8252911813644
"20","183","G2001830","2010","2","4","Kansas","Smith County",3853,"","Smith County Kansas",3771,4614,-82,-2.12821178302621,2.12821178302621,761,19.7508434985725,19.7508434985725
"20","185","G2001850","2010","2","4","Kansas","Stafford County",4437,"","Stafford County Kansas",4360,4803,-77,-1.73540680640072,1.73540680640072,366,8.24881676808655,8.24881676808655
"20","187","G2001870","2010","2","4","Kansas","Stanton County",2235,"","Stanton County Kansas",2175,2456,-60,-2.68456375838926,2.68456375838926,221,9.88814317673378,9.88814317673378
"20","189","G2001890","2010","2","4","Kansas","Stevens County",5724,"","Stevens County Kansas",5235,5571,-489,-8.54297693920335,8.54297693920335,-153,-2.67295597484277,2.67295597484277
"20","191","G2001910","2010","2","4","Kansas","Sumner County",24132,"","Sumner County Kansas",23452,26760,-680,-2.817835239516,2.817835239516,2628,10.8901044256589,10.8901044256589
"20","193","G2001930","2010","2","4","Kansas","Thomas County",7900,"","Thomas County Kansas",7496,8206,-404,-5.11392405063291,5.11392405063291,306,3.87341772151899,3.87341772151899
"20","195","G2001950","2010","2","4","Kansas","Trego County",3001,"","Trego County Kansas",2947,3309,-54,-1.79940019993336,1.79940019993336,308,10.2632455848051,10.2632455848051
"20","197","G2001970","2010","2","4","Kansas","Wabaunsee County",7053,"","Wabaunsee County Kansas",6795,7330,-258,-3.65801786473841,3.65801786473841,277,3.9274067772579,3.9274067772579
"20","199","G2001990","2010","2","4","Kansas","Wallace County",1485,"","Wallace County Kansas",1424,1767,-61,-4.10774410774411,4.10774410774411,282,18.989898989899,18.989898989899
"20","201","G2002010","2010","2","4","Kansas","Washington County",5799,"","Washington County Kansas",5629,6579,-170,-2.93153992067598,2.93153992067598,780,13.4505949301604,13.4505949301604
"20","203","G2002030","2010","2","4","Kansas","Wichita County",2234,"","Wichita County Kansas",2107,2551,-127,-5.68487018800358,5.68487018800358,317,14.189794091316,14.189794091316
"20","205","G2002050","2010","2","4","Kansas","Wilson County",9409,"","Wilson County Kansas",9433,10479,24,0.255074928260176,0.255074928260176,1070,11.3720905515995,11.3720905515995
"20","207","G2002070","2010","2","4","Kansas","Woodson County",3309,"","Woodson County Kansas",3195,3810,-114,-3.44514959202176,3.44514959202176,501,15.1405258386219,15.1405258386219
"20","209","G2002090","2010","2","4","Kansas","Wyandotte County",157505,"","Wyandotte County Kansas",156525,162819,-980,-0.622202469762865,0.622202469762865,5314,3.37386114726517,3.37386114726517
"21","001","G2100010","2010","3","6","Kentucky","Adair County",18656,"","Adair County Kentucky",17873,17645,-783,-4.19704116638079,4.19704116638079,-1011,-5.41916809605489,5.41916809605489
"21","003","G2100030","2010","3","6","Kentucky","Allen County",19956,"","Allen County Kentucky",19044,18835,-912,-4.57005411906194,4.57005411906194,-1121,-5.61735818801363,5.61735818801363
"21","005","G2100050","2010","3","6","Kentucky","Anderson County",21421,"","Anderson County Kentucky",21891,22585,470,2.19410858503338,2.19410858503338,1164,5.43391998506139,5.43391998506139
"21","007","G2100070","2010","3","6","Kentucky","Ballard County",8249,"","Ballard County Kentucky",8223,8733,-26,-0.315189719966056,0.315189719966056,484,5.86737786398351,5.86737786398351
"21","009","G2100090","2010","3","6","Kentucky","Barren County",42173,"","Barren County Kentucky",41736,41367,-437,-1.03620800037939,1.03620800037939,-806,-1.91117539658075,1.91117539658075
"21","011","G2100110","2010","3","6","Kentucky","Bath County",11591,"","Bath County Kentucky",11673,11877,82,0.707445431800535,0.707445431800535,286,2.46743162798723,2.46743162798723
"21","013","G2100130","2010","3","6","Kentucky","Bell County",28691,"","Bell County Kentucky",28989,31387,298,1.03865323620648,1.03865323620648,2696,9.39667491547872,9.39667491547872
"21","015","G2100150","2010","3","6","Kentucky","Boone County",118811,"","Boone County Kentucky",119894,118199,1083,0.911531760527224,0.911531760527224,-612,-0.515103820353334,0.515103820353334
"21","017","G2100170","2010","3","6","Kentucky","Bourbon County",19985,"","Bourbon County Kentucky",19646,20969,-339,-1.69627220415311,1.69627220415311,984,4.92369276957718,4.92369276957718
"21","019","G2100190","2010","3","6","Kentucky","Boyd County",49542,"","Boyd County Kentucky",48676,51722,-866,-1.74801178797788,1.74801178797788,2180,4.40030681038311,4.40030681038311
"21","021","G2100210","2010","3","6","Kentucky","Boyle County",28432,"","Boyle County Kentucky",29521,30329,1089,3.8301913337085,3.8301913337085,1897,6.67205965109735,6.67205965109735
"21","023","G2100230","2010","3","6","Kentucky","Bracken County",8488,"","Bracken County Kentucky",8672,8733,184,2.16776625824694,2.16776625824694,245,2.88642789820924,2.88642789820924
"21","025","G2100250","2010","3","6","Kentucky","Breathitt County",13878,"","Breathitt County Kentucky",15591,17121,1713,12.3432771292693,12.3432771292693,3243,23.3679204496325,23.3679204496325
"21","027","G2100270","2010","3","6","Kentucky","Breckinridge County",20059,"","Breckinridge County Kentucky",19014,19812,-1045,-5.20963158681888,5.20963158681888,-247,-1.23136746597537,1.23136746597537
"21","029","G2100290","2010","3","6","Kentucky","Bullitt County",74319,"","Bullitt County Kentucky",76054,80528,1735,2.33453087366622,2.33453087366622,6209,8.35452576057267,8.35452576057267
"21","031","G2100310","2010","3","6","Kentucky","Butler County",12690,"","Butler County Kentucky",13440,13741,750,5.91016548463357,5.91016548463357,1051,8.28211189913318,8.28211189913318
"21","033","G2100330","2010","3","6","Kentucky","Caldwell County",12984,"","Caldwell County Kentucky",12893,13626,-91,-0.700862600123229,0.700862600123229,642,4.9445471349353,4.9445471349353
"21","035","G2100350","2010","3","6","Kentucky","Calloway County",37191,"","Calloway County Kentucky",36694,37134,-497,-1.33634481460568,1.33634481460568,-57,-0.153262886182141,0.153262886182141
"21","037","G2100370","2010","3","6","Kentucky","Campbell County",90336,"","Campbell County Kentucky",89155,94920,-1181,-1.3073414806943,1.3073414806943,4584,5.07438894792774,5.07438894792774
"21","039","G2100390","2010","3","6","Kentucky","Carlisle County",5104,"","Carlisle County Kentucky",5186,5630,82,1.60658307210031,1.60658307210031,526,10.3056426332288,10.3056426332288
"21","041","G2100410","2010","3","6","Kentucky","Carroll County",10811,"","Carroll County Kentucky",10700,10609,-111,-1.02673203218944,1.02673203218944,-202,-1.86846730182222,1.86846730182222
"21","043","G2100430","2010","3","6","Kentucky","Carter County",27720,"","Carter County Kentucky",26890,28725,-830,-2.99422799422799,2.99422799422799,1005,3.62554112554113,3.62554112554113
"21","045","G2100450","2010","3","6","Kentucky","Casey County",15955,"","Casey County Kentucky",16515,16273,560,3.50987151363209,3.50987151363209,318,1.99310560952679,1.99310560952679
"21","047","G2100470","2010","3","6","Kentucky","Christian County",73955,"","Christian County Kentucky",81118,77944,7163,9.68561963356095,9.68561963356095,3989,5.39382056656075,5.39382056656075
"21","049","G2100490","2010","3","6","Kentucky","Clark County",35613,"","Clark County Kentucky",36337,38672,724,2.03296549013001,2.03296549013001,3059,8.5895599921377,8.5895599921377
"21","051","G2100510","2010","3","6","Kentucky","Clay County",21730,"","Clay County Kentucky",23519,26155,1789,8.23285780027612,8.23285780027612,4425,20.3635526921307,20.3635526921307
"21","053","G2100530","2010","3","6","Kentucky","Clinton County",10272,"","Clinton County Kentucky",9341,10083,-931,-9.06347352024922,9.06347352024922,-189,-1.83995327102804,1.83995327102804
"21","055","G2100550","2010","3","6","Kentucky","Crittenden County",9315,"","Crittenden County Kentucky",9075,9846,-240,-2.57648953301127,2.57648953301127,531,5.70048309178744,5.70048309178744
"21","057","G2100570","2010","3","6","Kentucky","Cumberland County",6856,"","Cumberland County Kentucky",6667,7284,-189,-2.75670945157526,2.75670945157526,428,6.24270711785298,6.24270711785298
"21","059","G2100590","2010","3","6","Kentucky","Daviess County",96656,"","Daviess County Kentucky",95839,103394,-817,-0.845265684489323,0.845265684489323,6738,6.97111405396458,6.97111405396458
"21","061","G2100610","2010","3","6","Kentucky","Edmonson County",12161,"","Edmonson County Kentucky",12070,12399,-91,-0.748293725844914,0.748293725844914,238,1.95707589836362,1.95707589836362
"21","063","G2100630","2010","3","6","Kentucky","Elliott County",7852,"","Elliott County Kentucky",8463,7217,611,7.78145695364238,7.78145695364238,-635,-8.08711156393275,8.08711156393275
"21","065","G2100650","2010","3","6","Kentucky","Estill County",14672,"","Estill County Kentucky",14847,16089,175,1.19274809160305,1.19274809160305,1417,9.65785169029444,9.65785169029444
"21","067","G2100670","2010","3","6","Kentucky","Fayette County",295803,"","Fayette County Kentucky",299357,300757,3554,1.20147530620041,1.20147530620041,4954,1.67476327150164,1.67476327150164
"21","069","G2100690","2010","3","6","Kentucky","Fleming County",14348,"","Fleming County Kentucky",14770,14481,422,2.94117647058824,2.94117647058824,133,0.926958461109562,0.926958461109562
"21","071","G2100710","2010","3","6","Kentucky","Floyd County",39451,"","Floyd County Kentucky",41899,45176,2448,6.20516590200502,6.20516590200502,5725,14.5116727079161,14.5116727079161
"21","073","G2100730","2010","3","6","Kentucky","Franklin County",49285,"","Franklin County Kentucky",49003,52404,-282,-0.572182205539211,0.572182205539211,3119,6.32849751445673,6.32849751445673
"21","075","G2100750","2010","3","6","Kentucky","Fulton County",6813,"","Fulton County Kentucky",6823,7885,10,0.146778218112432,0.146778218112432,1072,15.7346249816527,15.7346249816527
"21","077","G2100770","2010","3","6","Kentucky","Gallatin County",8589,"","Gallatin County Kentucky",8198,8720,-391,-4.55233438118524,4.55233438118524,131,1.52520665968099,1.52520665968099
"21","079","G2100790","2010","3","6","Kentucky","Garrard County",16912,"","Garrard County Kentucky",17075,15617,163,0.963812677388836,0.963812677388836,-1295,-7.65728476821192,7.65728476821192
"21","081","G2100810","2010","3","6","Kentucky","Grant County",24662,"","Grant County Kentucky",25528,25600,866,3.51147514394615,3.51147514394615,938,3.80342226907793,3.80342226907793
"21","083","G2100830","2010","3","6","Kentucky","Graves County",37121,"","Graves County Kentucky",38043,38497,922,2.48376929500822,2.48376929500822,1376,3.70679669189946,3.70679669189946
"21","085","G2100850","2010","3","6","Kentucky","Grayson County",25746,"","Grayson County Kentucky",25576,24801,-170,-0.660296745125456,0.660296745125456,-945,-3.67047308319739,3.67047308319739
"21","087","G2100870","2010","3","6","Kentucky","Green County",11258,"","Green County Kentucky",11341,11694,83,0.737253508616095,0.737253508616095,436,3.87280156333274,3.87280156333274
"21","089","G2100890","2010","3","6","Kentucky","Greenup County",36910,"","Greenup County Kentucky",37869,38181,959,2.59821186670279,2.59821186670279,1271,3.44351124356543,3.44351124356543
"21","091","G2100910","2010","3","6","Kentucky","Hancock County",8565,"","Hancock County Kentucky",8649,8658,84,0.980735551663748,0.980735551663748,93,1.08581436077058,1.08581436077058
"21","093","G2100930","2010","3","6","Kentucky","Hardin County",105543,"","Hardin County Kentucky",101222,112042,-4321,-4.09406592573643,4.09406592573643,6499,6.15767980822982,6.15767980822982
"21","095","G2100950","2010","3","6","Kentucky","Harlan County",29278,"","Harlan County Kentucky",30808,34877,1530,5.22576678734886,5.22576678734886,5599,19.1235740146185,19.1235740146185
"21","097","G2100970","2010","3","6","Kentucky","Harrison County",18846,"","Harrison County Kentucky",18624,19351,-222,-1.1779687997453,1.1779687997453,505,2.67961371113234,2.67961371113234
"21","099","G2100990","2010","3","6","Kentucky","Hart County",18199,"","Hart County Kentucky",18410,18308,211,1.15940436287708,1.15940436287708,109,0.598934007363042,0.598934007363042
"21","101","G2101010","2010","3","6","Kentucky","Henderson County",46250,"","Henderson County Kentucky",45595,48637,-655,-1.41621621621622,1.41621621621622,2387,5.16108108108108,5.16108108108108
"21","103","G2101030","2010","3","6","Kentucky","Henry County",15416,"","Henry County Kentucky",15855,16691,439,2.84769071094966,2.84769071094966,1275,8.27062791904515,8.27062791904515
"21","105","G2101050","2010","3","6","Kentucky","Hickman County",4902,"","Hickman County Kentucky",4819,5524,-83,-1.69318645450836,1.69318645450836,622,12.6886984904121,12.6886984904121
"21","107","G2101070","2010","3","6","Kentucky","Hopkins County",46920,"","Hopkins County Kentucky",46151,49206,-769,-1.63895993179881,1.63895993179881,2286,4.87212276214834,4.87212276214834
"21","109","G2101090","2010","3","6","Kentucky","Jackson County",13494,"","Jackson County Kentucky",13305,14295,-189,-1.40062249888839,1.40062249888839,801,5.93597154290796,5.93597154290796
"21","111","G2101110","2010","3","6","Kentucky","Jefferson County",741096,"","Jefferson County Kentucky",725780,755371,-15316,-2.06666882563123,2.06666882563123,14275,1.9262011939074,1.9262011939074
"21","113","G2101130","2010","3","6","Kentucky","Jessamine County",48586,"","Jessamine County Kentucky",47999,50511,-587,-1.2081669616762,1.2081669616762,1925,3.96204668011361,3.96204668011361
"21","115","G2101150","2010","3","6","Kentucky","Johnson County",23356,"","Johnson County Kentucky",24154,24327,798,3.41668093851687,3.41668093851687,971,4.15738996403494,4.15738996403494
"21","117","G2101170","2010","3","6","Kentucky","Kenton County",159720,"","Kenton County Kentucky",159456,169906,-264,-0.165289256198347,0.165289256198347,10186,6.37741046831956,6.37741046831956
"21","119","G2101190","2010","3","6","Kentucky","Knott County",16346,"","Knott County Kentucky",17013,18847,667,4.08050899302582,4.08050899302582,2501,15.3003792976875,15.3003792976875
"21","121","G2101210","2010","3","6","Kentucky","Knox County",31883,"","Knox County Kentucky",32785,33723,902,2.82909387447856,2.82909387447856,1840,5.77110058651946,5.77110058651946
"21","123","G2101230","2010","3","6","Kentucky","Larue County",14193,"","Larue County Kentucky",13597,15133,-596,-4.19925315296273,4.19925315296273,940,6.62298316071303,6.62298316071303
"21","125","G2101250","2010","3","6","Kentucky","Laurel County",58849,"","Laurel County Kentucky",58096,56149,-753,-1.27954595660079,1.27954595660079,-2700,-4.58801339020204,4.58801339020204
"21","127","G2101270","2010","3","6","Kentucky","Lawrence County",15860,"","Lawrence County Kentucky",16602,16562,742,4.67843631778058,4.67843631778058,702,4.42622950819672,4.42622950819672
"21","129","G2101290","2010","3","6","Kentucky","Lee County",7887,"","Lee County Kentucky",6933,8418,-954,-12.0958539368581,12.0958539368581,531,6.73259794598707,6.73259794598707
"21","131","G2101310","2010","3","6","Kentucky","Leslie County",11310,"","Leslie County Kentucky",11477,13272,167,1.47656940760389,1.47656940760389,1962,17.3474801061008,17.3474801061008
"21","133","G2101330","2010","3","6","Kentucky","Letcher County",24519,"","Letcher County Kentucky",23779,26808,-740,-3.01806762102859,3.01806762102859,2289,9.3356172763979,9.3356172763979
"21","135","G2101350","2010","3","6","Kentucky","Lewis County",13870,"","Lewis County Kentucky",13805,14959,-65,-0.468637346791637,0.468637346791637,1089,7.85147801009373,7.85147801009373
"21","137","G2101370","2010","3","6","Kentucky","Lincoln County",24742,"","Lincoln County Kentucky",25149,26767,407,1.64497615390833,1.64497615390833,2025,8.18446366502304,8.18446366502304
"21","139","G2101390","2010","3","6","Kentucky","Livingston County",9519,"","Livingston County Kentucky",9602,10411,83,0.871940329866583,0.871940329866583,892,9.37073221977098,9.37073221977098
"21","141","G2101410","2010","3","6","Kentucky","Logan County",26835,"","Logan County Kentucky",27281,27356,446,1.66200857089622,1.66200857089622,521,1.94149431712316,1.94149431712316
"21","143","G2101430","2010","3","6","Kentucky","Lyon County",8314,"","Lyon County Kentucky",8247,8703,-67,-0.805869617512629,0.805869617512629,389,4.67885494346885,4.67885494346885
"21","145","G2101450","2010","3","6","Kentucky","McCracken County",65565,"","McCracken County Kentucky",65693,69749,128,0.195226111492412,0.195226111492412,4184,6.38145351940822,6.38145351940822
"21","147","G2101470","2010","3","6","Kentucky","McCreary County",18306,"","McCreary County Kentucky",17304,17648,-1002,-5.47361520812848,5.47361520812848,-658,-3.59444990713427,3.59444990713427
"21","149","G2101490","2010","3","6","Kentucky","McLean County",9531,"","McLean County Kentucky",9536,10504,5,0.0524603924037352,0.0524603924037352,973,10.2087923617669,10.2087923617669
"21","151","G2101510","2010","3","6","Kentucky","Madison County",82916,"","Madison County Kentucky",84046,81314,1130,1.36282502773892,1.36282502773892,-1602,-1.93207583578561,1.93207583578561
"21","153","G2101530","2010","3","6","Kentucky","Magoffin County",13333,"","Magoffin County Kentucky",13140,14357,-193,-1.44753618840471,1.44753618840471,1024,7.68019200480012,7.68019200480012
"21","155","G2101550","2010","3","6","Kentucky","Marion County",19820,"","Marion County Kentucky",19537,19022,-283,-1.42785065590313,1.42785065590313,-798,-4.02623612512614,4.02623612512614
"21","157","G2101570","2010","3","6","Kentucky","Marshall County",31448,"","Marshall County Kentucky",31199,31748,-249,-0.791783261256678,0.791783261256678,300,0.953955736453829,0.953955736453829
"21","159","G2101590","2010","3","6","Kentucky","Martin County",12929,"","Martin County Kentucky",13022,13501,93,0.719313171939052,0.719313171939052,572,4.42416273493696,4.42416273493696
"21","161","G2101610","2010","3","6","Kentucky","Mason County",17490,"","Mason County Kentucky",17415,17611,-75,-0.428816466552316,0.428816466552316,121,0.691823899371069,0.691823899371069
"21","163","G2101630","2010","3","6","Kentucky","Meade County",28602,"","Meade County Kentucky",27920,31355,-682,-2.38444863995525,2.38444863995525,2753,9.62520103489267,9.62520103489267
"21","165","G2101650","2010","3","6","Kentucky","Menifee County",6306,"","Menifee County Kentucky",6561,6945,255,4.04376784015224,4.04376784015224,639,10.1332064700285,10.1332064700285
"21","167","G2101670","2010","3","6","Kentucky","Mercer County",21331,"","Mercer County Kentucky",21992,22927,661,3.09877642867189,3.09877642867189,1596,7.48206835122591,7.48206835122591
"21","169","G2101690","2010","3","6","Kentucky","Metcalfe County",10099,"","Metcalfe County Kentucky",10058,10616,-41,-0.405980790177245,0.405980790177245,517,5.11931874443014,5.11931874443014
"21","171","G2101710","2010","3","6","Kentucky","Monroe County",10963,"","Monroe County Kentucky",11628,12366,665,6.06585788561525,6.06585788561525,1403,12.7975919000274,12.7975919000274
"21","173","G2101730","2010","3","6","Kentucky","Montgomery County",26499,"","Montgomery County Kentucky",25967,26227,-532,-2.00762292916714,2.00762292916714,-272,-1.02645382844636,1.02645382844636
"21","175","G2101750","2010","3","6","Kentucky","Morgan County",13923,"","Morgan County Kentucky",14028,14913,105,0.754147812971342,0.754147812971342,990,7.11053652230123,7.11053652230123
"21","177","G2101770","2010","3","6","Kentucky","Muhlenberg County",31499,"","Muhlenberg County Kentucky",31313,33442,-186,-0.590494936347186,0.590494936347186,1943,6.16844979205689,6.16844979205689
"21","179","G2101790","2010","3","6","Kentucky","Nelson County",43437,"","Nelson County Kentucky",44131,46650,694,1.59771623270484,1.59771623270484,3213,7.39691967677326,7.39691967677326
"21","181","G2101810","2010","3","6","Kentucky","Nicholas County",7135,"","Nicholas County Kentucky",6840,7078,-295,-4.13454800280308,4.13454800280308,-57,-0.798878766643308,0.798878766643308
"21","183","G2101830","2010","3","6","Kentucky","Ohio County",23842,"","Ohio County Kentucky",23513,24325,-329,-1.37991779213153,1.37991779213153,483,2.02583675866119,2.02583675866119
"21","185","G2101850","2010","3","6","Kentucky","Oldham County",60316,"","Oldham County Kentucky",58240,61930,-2076,-3.44187280323629,3.44187280323629,1614,2.67590689037735,2.67590689037735
"21","187","G2101870","2010","3","6","Kentucky","Owen County",10841,"","Owen County Kentucky",11357,11185,516,4.75970851397473,4.75970851397473,344,3.17313900931648,3.17313900931648
"21","189","G2101890","2010","3","6","Kentucky","Owsley County",4755,"","Owsley County Kentucky",4593,5144,-162,-3.40694006309148,3.40694006309148,389,8.18086225026288,8.18086225026288
"21","191","G2101910","2010","3","6","Kentucky","Pendleton County",14877,"","Pendleton County Kentucky",14978,15078,101,0.678900315923909,0.678900315923909,201,1.35107884654164,1.35107884654164
"21","193","G2101930","2010","3","6","Kentucky","Perry County",28712,"","Perry County Kentucky",29299,31297,587,2.04444134856506,2.04444134856506,2585,9.003204235163,9.003204235163
"21","195","G2101950","2010","3","6","Kentucky","Pike County",65024,"","Pike County Kentucky",65275,73984,251,0.386011318897638,0.386011318897638,8960,13.7795275590551,13.7795275590551
"21","197","G2101970","2010","3","6","Kentucky","Powell County",12613,"","Powell County Kentucky",13549,14115,936,7.42091492904146,7.42091492904146,1502,11.9083485292952,11.9083485292952
"21","199","G2101990","2010","3","6","Kentucky","Pulaski County",63063,"","Pulaski County Kentucky",61207,58234,-1856,-2.94308865737437,2.94308865737437,-4829,-7.65742194313623,7.65742194313623
"21","201","G2102010","2010","3","6","Kentucky","Robertson County",2282,"","Robertson County Kentucky",2240,2392,-42,-1.84049079754601,1.84049079754601,110,4.82033304119194,4.82033304119194
"21","203","G2102030","2010","3","6","Kentucky","Rockcastle County",17056,"","Rockcastle County Kentucky",16332,17601,-724,-4.24484052532833,4.24484052532833,545,3.1953564727955,3.1953564727955
"21","205","G2102050","2010","3","6","Kentucky","Rowan County",23333,"","Rowan County Kentucky",22909,23453,-424,-1.81716881669738,1.81716881669738,120,0.514293061329448,0.514293061329448
"21","207","G2102070","2010","3","6","Kentucky","Russell County",17565,"","Russell County Kentucky",17212,16873,-353,-2.00967833760319,2.00967833760319,-692,-3.93965271847424,3.93965271847424
"21","209","G2102090","2010","3","6","Kentucky","Scott County",47173,"","Scott County Kentucky",46591,45335,-582,-1.23375659805397,1.23375659805397,-1838,-3.89629661034914,3.89629661034914
"21","211","G2102110","2010","3","6","Kentucky","Shelby County",42074,"","Shelby County Kentucky",42615,42778,541,1.28582972857347,1.28582972857347,704,1.67324238246898,1.67324238246898
"21","213","G2102130","2010","3","6","Kentucky","Simpson County",17327,"","Simpson County Kentucky",17176,18433,-151,-0.871472268713568,0.871472268713568,1106,6.3831015178623,6.3831015178623
"21","215","G2102150","2010","3","6","Kentucky","Spencer County",17061,"","Spencer County Kentucky",17756,17350,695,4.07361819354082,4.07361819354082,289,1.69392180997597,1.69392180997597
"21","217","G2102170","2010","3","6","Kentucky","Taylor County",24512,"","Taylor County Kentucky",24559,23382,47,0.191742819843342,0.191742819843342,-1130,-4.60998694516971,4.60998694516971
"21","219","G2102190","2010","3","6","Kentucky","Todd County",12460,"","Todd County Kentucky",12216,12506,-244,-1.95826645264848,1.95826645264848,46,0.369181380417335,0.369181380417335
"21","221","G2102210","2010","3","6","Kentucky","Trigg County",14339,"","Trigg County Kentucky",13263,13480,-1076,-7.50401004254132,7.50401004254132,-859,-5.99065485738197,5.99065485738197
"21","223","G2102230","2010","3","6","Kentucky","Trimble County",8809,"","Trimble County Kentucky",8998,8697,189,2.14553297763651,2.14553297763651,-112,-1.27142694971052,1.27142694971052
"21","225","G2102250","2010","3","6","Kentucky","Union County",15007,"","Union County Kentucky",14753,15957,-254,-1.69254347970947,1.69254347970947,950,6.33037915639368,6.33037915639368
"21","227","G2102270","2010","3","6","Kentucky","Warren County",113792,"","Warren County Kentucky",109925,112278,-3867,-3.39830568053993,3.39830568053993,-1514,-1.33049775028121,1.33049775028121
"21","229","G2102290","2010","3","6","Kentucky","Washington County",11717,"","Washington County Kentucky",11585,11415,-132,-1.12656823418964,1.12656823418964,-302,-2.57745156610054,2.57745156610054
"21","231","G2102310","2010","3","6","Kentucky","Wayne County",20813,"","Wayne County Kentucky",20649,20426,-164,-0.787969057800413,0.787969057800413,-387,-1.8594147888339,1.8594147888339
"21","233","G2102330","2010","3","6","Kentucky","Webster County",13621,"","Webster County Kentucky",13673,14695,52,0.381763453490933,0.381763453490933,1074,7.88488363556273,7.88488363556273
"21","235","G2102350","2010","3","6","Kentucky","Whitley County",35637,"","Whitley County Kentucky",38484,38083,2847,7.98888795353144,7.98888795353144,2446,6.86365294497292,6.86365294497292
"21","237","G2102370","2010","3","6","Kentucky","Wolfe County",7355,"","Wolfe County Kentucky",7135,7599,-220,-2.99116247450714,2.99116247450714,244,3.31747110808973,3.31747110808973
"21","239","G2102390","2010","3","6","Kentucky","Woodford County",24939,"","Woodford County Kentucky",25251,26603,312,1.25105256826657,1.25105256826657,1664,6.67228036408838,6.67228036408838
"22","001","G2200010","2010","3","7","Louisiana","Acadia Parish",61773,"","Acadia Parish Louisiana",60328,63771,-1445,-2.33920968708012,2.33920968708012,1998,3.23442280608033,3.23442280608033
"22","003","G2200030","2010","3","7","Louisiana","Allen Parish",25764,"","Allen Parish Louisiana",25597,26958,-167,-0.648191274646794,0.648191274646794,1194,4.63437354448067,4.63437354448067
"22","005","G2200050","2010","3","7","Louisiana","Ascension Parish",107215,"","Ascension Parish Louisiana",106780,107409,-435,-0.405726810614186,0.405726810614186,194,0.18094483048081,0.18094483048081
"22","007","G2200070","2010","3","7","Louisiana","Assumption Parish",23421,"","Assumption Parish Louisiana",22731,26105,-690,-2.94607403612143,2.94607403612143,2684,11.4598010332607,11.4598010332607
"22","009","G2200090","2010","3","7","Louisiana","Avoyelles Parish",42073,"","Avoyelles Parish Louisiana",42678,45140,605,1.43797684976113,1.43797684976113,3067,7.28971074085518,7.28971074085518
"22","011","G2200110","2010","3","7","Louisiana","Beauregard Parish",35654,"","Beauregard Parish Louisiana",35784,35340,130,0.364615470914904,0.364615470914904,-314,-0.880686598979077,0.880686598979077
"22","013","G2200130","2010","3","7","Louisiana","Bienville Parish",14353,"","Bienville Parish Louisiana",14620,16872,267,1.86023827771198,1.86023827771198,2519,17.5503379084512,17.5503379084512
"22","015","G2200150","2010","3","7","Louisiana","Bossier Parish",116979,"","Bossier Parish Louisiana",113095,122949,-3884,-3.32025406269501,3.32025406269501,5970,5.10348011181494,5.10348011181494
"22","017","G2200170","2010","3","7","Louisiana","Caddo Parish",254969,"","Caddo Parish Louisiana",254622,265798,-347,-0.136094976252015,0.136094976252015,10829,4.2471829908734,4.2471829908734
"22","019","G2200190","2010","3","7","Louisiana","Calcasieu Parish",192768,"","Calcasieu Parish Louisiana",189033,204436,-3735,-1.93756225099602,1.93756225099602,11668,6.05287184594953,6.05287184594953
"22","021","G2200210","2010","3","7","Louisiana","Caldwell Parish",10132,"","Caldwell Parish Louisiana",10370,11148,238,2.3489932885906,2.3489932885906,1016,10.0276352151599,10.0276352151599
"22","023","G2200230","2010","3","7","Louisiana","Cameron Parish",6839,"","Cameron Parish Louisiana",6446,9471,-393,-5.74645415996491,5.74645415996491,2632,38.4851586489253,38.4851586489253
"22","025","G2200250","2010","3","7","Louisiana","Catahoula Parish",10407,"","Catahoula Parish Louisiana",10337,11787,-70,-0.672624195253195,0.672624195253195,1380,13.260305563563,13.260305563563
"22","027","G2200270","2010","3","7","Louisiana","Claiborne Parish",17195,"","Claiborne Parish Louisiana",15863,17927,-1332,-7.74643791799942,7.74643791799942,732,4.25705146845013,4.25705146845013
"22","029","G2200290","2010","3","7","Louisiana","Concordia Parish",20822,"","Concordia Parish Louisiana",18960,21730,-1862,-8.94246470079723,8.94246470079723,908,4.3607722601095,4.3607722601095
"22","031","G2200310","2010","3","7","Louisiana","De Soto Parish",26656,"","De Soto Parish Louisiana",26531,27350,-125,-0.468937575030012,0.468937575030012,694,2.60354141656663,2.60354141656663
"22","033","G2200330","2010","3","7","Louisiana","East Baton Rouge Parish",440171,"","East Baton Rouge Parish Louisiana",435534,465853,-4637,-1.05345422574409,1.05345422574409,25682,5.83455066326496,5.83455066326496
"22","035","G2200350","2010","3","7","Louisiana","East Carroll Parish",7759,"","East Carroll Parish Louisiana",7992,9512,233,3.00296429952313,3.00296429952313,1753,22.5931176698028,22.5931176698028
"22","037","G2200370","2010","3","7","Louisiana","East Feliciana Parish",20267,"","East Feliciana Parish Louisiana",20857,23196,590,2.91113632999457,2.91113632999457,2929,14.4520649331425,14.4520649331425
"22","039","G2200390","2010","3","7","Louisiana","Evangeline Parish",33984,"","Evangeline Parish Louisiana",35458,38241,1474,4.33733521657251,4.33733521657251,4257,12.5264830508475,12.5264830508475
"22","041","G2200410","2010","3","7","Louisiana","Franklin Parish",20767,"","Franklin Parish Louisiana",19804,22662,-963,-4.63716473250831,4.63716473250831,1895,9.12505417248519,9.12505417248519
"22","043","G2200430","2010","3","7","Louisiana","Grant Parish",22309,"","Grant Parish Louisiana",20268,20459,-2041,-9.14877403738402,9.14877403738402,-1850,-8.29261732932897,8.29261732932897
"22","045","G2200450","2010","3","7","Louisiana","Iberia Parish",73240,"","Iberia Parish Louisiana",75156,79912,1916,2.61605679956308,2.61605679956308,6672,9.10977607864555,9.10977607864555
"22","047","G2200470","2010","3","7","Louisiana","Iberville Parish",33387,"","Iberville Parish Louisiana",32499,36121,-888,-2.65971785425465,2.65971785425465,2734,8.18881600622997,8.18881600622997
"22","049","G2200490","2010","3","7","Louisiana","Jackson Parish",16274,"","Jackson Parish Louisiana",15130,16361,-1144,-7.02961779525624,7.02961779525624,87,0.534595059604277,0.534595059604277
"22","051","G2200510","2010","3","7","Louisiana","Jefferson Parish",432552,"","Jefferson Parish Louisiana",443375,440873,10823,2.50212691190886,2.50212691190886,8321,1.92369934713052,1.92369934713052
"22","053","G2200530","2010","3","7","Louisiana","Jefferson Davis Parish",31594,"","Jefferson Davis Parish Louisiana",31199,33633,-395,-1.2502373868456,1.2502373868456,2039,6.45375704247642,6.45375704247642
"22","055","G2200550","2010","3","7","Louisiana","Lafayette Parish",221578,"","Lafayette Parish Louisiana",212229,222874,-9349,-4.21928169764146,4.21928169764146,1296,0.58489561238029,0.58489561238029
"22","057","G2200570","2010","3","7","Louisiana","Lafourche Parish",96318,"","Lafourche Parish Louisiana",93716,100334,-2602,-2.70146805373866,2.70146805373866,4016,4.16952179239602,4.16952179239602
"22","059","G2200590","2010","3","7","Louisiana","La Salle Parish",14890,"","La Salle Parish Louisiana",14120,15271,-770,-5.17125587642713,5.17125587642713,381,2.55876427132304,2.55876427132304
"22","061","G2200610","2010","3","7","Louisiana","Lincoln Parish",46735,"","Lincoln Parish Louisiana",43157,46921,-3578,-7.65593238472237,7.65593238472237,186,0.397988659462929,0.397988659462929
"22","063","G2200630","2010","3","7","Louisiana","Livingston Parish",128026,"","Livingston Parish Louisiana",124723,122647,-3303,-2.57994469873307,2.57994469873307,-5379,-4.20149032227829,4.20149032227829
"22","065","G2200650","2010","3","7","Louisiana","Madison Parish",12093,"","Madison Parish Louisiana",11429,14267,-664,-5.49077978996113,5.49077978996113,2174,17.9773422641197,17.9773422641197
"22","067","G2200670","2010","3","7","Louisiana","Morehouse Parish",27979,"","Morehouse Parish Louisiana",28172,32728,193,0.689803066585653,0.689803066585653,4749,16.973444368991,16.973444368991
"22","069","G2200690","2010","3","7","Louisiana","Natchitoches Parish",39566,"","Natchitoches Parish Louisiana",39353,43275,-213,-0.538340999848355,0.538340999848355,3709,9.37421018045797,9.37421018045797
"22","071","G2200710","2010","3","7","Louisiana","Orleans Parish",343829,"","Orleans Parish Louisiana",365158,379319,21329,6.20337435178534,6.20337435178534,35490,10.3219914550547,10.3219914550547
"22","073","G2200730","2010","3","7","Louisiana","Ouachita Parish",153720,"","Ouachita Parish Louisiana",152240,159375,-1480,-0.962789487379651,0.962789487379651,5655,3.67876658860265,3.67876658860265
"22","075","G2200750","2010","3","7","Louisiana","Plaquemines Parish",23042,"","Plaquemines Parish Louisiana",21200,23069,-1842,-7.99409773457165,7.99409773457165,27,0.117177328356913,0.117177328356913
"22","077","G2200770","2010","3","7","Louisiana","Pointe Coupee Parish",22802,"","Pointe Coupee Parish Louisiana",22278,25018,-524,-2.29804403122533,2.29804403122533,2216,9.71844575037277,9.71844575037277
"22","079","G2200790","2010","3","7","Louisiana","Rapides Parish",131613,"","Rapides Parish Louisiana",134490,139792,2877,2.18595427503362,2.18595427503362,8179,6.21443170507473,6.21443170507473
"22","081","G2200810","2010","3","7","Louisiana","Red River Parish",9091,"","Red River Parish Louisiana",8943,10301,-148,-1.6279837201628,1.6279837201628,1210,13.309866901331,13.309866901331
"22","083","G2200830","2010","3","7","Louisiana","Richland Parish",20725,"","Richland Parish Louisiana",20448,23156,-277,-1.33655006031363,1.33655006031363,2431,11.729794933655,11.729794933655
"22","085","G2200850","2010","3","7","Louisiana","Sabine Parish",24233,"","Sabine Parish Louisiana",23686,25643,-547,-2.25725250691206,2.25725250691206,1410,5.81851194651921,5.81851194651921
"22","087","G2200870","2010","3","7","Louisiana","St. Bernard Parish",35897,"","St. Bernard Parish Louisiana",42692,43245,6795,18.9291584254952,18.9291584254952,7348,20.4696771317937,20.4696771317937
"22","089","G2200890","2010","3","7","Louisiana","St. Charles Parish",52780,"","St. Charles Parish Louisiana",51650,55744,-1130,-2.14096248579007,2.14096248579007,2964,5.61576354679803,5.61576354679803
"22","091","G2200910","2010","3","7","Louisiana","St. Helena Parish",11203,"","St. Helena Parish Louisiana",10571,11817,-632,-5.6413460680175,5.6413460680175,614,5.48067481924484,5.48067481924484
"22","093","G2200930","2010","3","7","Louisiana","St. James Parish",22102,"","St. James Parish Louisiana",20868,23887,-1234,-5.58320513980635,5.58320513980635,1785,8.07619219980092,8.07619219980092
"22","095","G2200950","2010","3","7","Louisiana","St. John the Baptist Parish",45924,"","St. John the Baptist Parish Louisiana",46905,49310,981,2.13613796707604,2.13613796707604,3386,7.37305112795053,7.37305112795053
"22","097","G2200970","2010","3","7","Louisiana","St. Landry Parish",83384,"","St. Landry Parish Louisiana",92551,95569,9167,10.993715820781,10.993715820781,12185,14.6131152259426,14.6131152259426
"22","099","G2200990","2010","3","7","Louisiana","St. Martin Parish",52160,"","St. Martin Parish Louisiana",52410,54574,250,0.479294478527607,0.479294478527607,2414,4.62806748466258,4.62806748466258
"22","101","G2201010","2010","3","7","Louisiana","St. Mary Parish",54650,"","St. Mary Parish Louisiana",50698,56860,-3952,-7.23147301006404,7.23147301006404,2210,4.04391582799634,4.04391582799634
"22","103","G2201030","2010","3","7","Louisiana","St. Tammany Parish",233740,"","St. Tammany Parish Louisiana",233327,249060,-413,-0.176692050996834,0.176692050996834,15320,6.55429109266707,6.55429109266707
"22","105","G2201050","2010","3","7","Louisiana","Tangipahoa Parish",121097,"","Tangipahoa Parish Louisiana",119498,128538,-1599,-1.32042907751637,1.32042907751637,7441,6.14466089168188,6.14466089168188
"22","107","G2201070","2010","3","7","Louisiana","Tensas Parish",5252,"","Tensas Parish Louisiana",5522,6963,270,5.14089870525514,5.14089870525514,1711,32.5780654988576,32.5780654988576
"22","109","G2201090","2010","3","7","Louisiana","Terrebonne Parish",111860,"","Terrebonne Parish Louisiana",109501,117520,-2359,-2.10888610763454,2.10888610763454,5660,5.05989629894511,5.05989629894511
"22","111","G2201110","2010","3","7","Louisiana","Union Parish",22721,"","Union Parish Louisiana",22628,26088,-93,-0.409312970379825,0.409312970379825,3367,14.8188900136438,14.8188900136438
"22","113","G2201130","2010","3","7","Louisiana","Vermilion Parish",57999,"","Vermilion Parish Louisiana",56542,59922,-1457,-2.51211227779789,2.51211227779789,1923,3.31557440645528,3.31557440645528
"22","115","G2201150","2010","3","7","Louisiana","Vernon Parish",52334,"","Vernon Parish Louisiana",47113,56239,-5221,-9.97630603431803,9.97630603431803,3905,7.46168838613521,7.46168838613521
"22","117","G2201170","2010","3","7","Louisiana","Washington Parish",47168,"","Washington Parish Louisiana",45378,48238,-1790,-3.79494572591587,3.79494572591587,1070,2.26848710990502,2.26848710990502
"22","119","G2201190","2010","3","7","Louisiana","Webster Parish",41207,"","Webster Parish Louisiana",40561,44819,-646,-1.56769480913437,1.56769480913437,3612,8.76550100711044,8.76550100711044
"22","121","G2201210","2010","3","7","Louisiana","West Baton Rouge Parish",23788,"","West Baton Rouge Parish Louisiana",23033,25888,-755,-3.17386917773667,3.17386917773667,2100,8.82798049436691,8.82798049436691
"22","123","G2201230","2010","3","7","Louisiana","West Carroll Parish",11604,"","West Carroll Parish Louisiana",11254,13158,-350,-3.01620130989314,3.01620130989314,1554,13.3919338159255,13.3919338159255
"22","125","G2201250","2010","3","7","Louisiana","West Feliciana Parish",15625,"","West Feliciana Parish Louisiana",14960,17738,-665,-4.256,4.256,2113,13.5232,13.5232
"22","127","G2201270","2010","3","7","Louisiana","Winn Parish",15313,"","Winn Parish Louisiana",15305,17911,-8,-0.0522431920590348,0.0522431920590348,2598,16.9659766211716,16.9659766211716
"23","001","G2300010","2010","1","1","Maine","Androscoggin County",107702,"","Androscoggin County Maine",106399,109952,-1303,-1.20981968765668,1.20981968765668,2250,2.08909769549312,2.08909769549312
"23","003","G2300030","2010","1","1","Maine","Aroostook County",71870,"","Aroostook County Maine",71129,75664,-741,-1.03102824544316,1.03102824544316,3794,5.27897592876026,5.27897592876026
"23","005","G2300050","2010","1","1","Maine","Cumberland County",281674,"","Cumberland County Maine",276732,291424,-4942,-1.75451053345357,1.75451053345357,9750,3.46144834098994,3.46144834098994
"23","007","G2300070","2010","1","1","Maine","Franklin County",30768,"","Franklin County Maine",29683,31573,-1085,-3.52639105564223,3.52639105564223,805,2.61635465418617,2.61635465418617
"23","009","G2300090","2010","1","1","Maine","Hancock County",54418,"","Hancock County Maine",53322,57140,-1096,-2.01403947223345,2.01403947223345,2722,5.00202138998126,5.00202138998126
"23","011","G2300110","2010","1","1","Maine","Kennebec County",122151,"","Kennebec County Maine",120956,126519,-1195,-0.978297353275863,0.978297353275863,4368,3.57590195741337,3.57590195741337
"23","013","G2300130","2010","1","1","Maine","Knox County",39736,"","Knox County Maine",40596,43209,860,2.16428427622307,2.16428427622307,3473,8.74018522246829,8.74018522246829
"23","015","G2300150","2010","1","1","Maine","Lincoln County",34457,"","Lincoln County Maine",34438,36810,-19,-0.0551411904692806,0.0551411904692806,2353,6.82880111443248,6.82880111443248
"23","017","G2300170","2010","1","1","Maine","Oxford County",57833,"","Oxford County Maine",55958,59437,-1875,-3.24209361437242,3.24209361437242,1604,2.77350301730846,2.77350301730846
"23","019","G2300190","2010","1","1","Maine","Penobscot County",153923,"","Penobscot County Maine",148833,155350,-5090,-3.30684822930946,3.30684822930946,1427,0.927086920083418,0.927086920083418
"23","021","G2300210","2010","1","1","Maine","Piscataquis County",17535,"","Piscataquis County Maine",16860,17941,-675,-3.84944396920445,3.84944396920445,406,2.31536926147705,2.31536926147705
"23","023","G2300230","2010","1","1","Maine","Sagadahoc County",35293,"","Sagadahoc County Maine",36100,38322,807,2.28657240812626,2.28657240812626,3029,8.58243844388406,8.58243844388406
"23","025","G2300250","2010","1","1","Maine","Somerset County",52228,"","Somerset County Maine",50897,52447,-1331,-2.54844144903117,2.54844144903117,219,0.419315309795512,0.419315309795512
"23","027","G2300270","2010","1","1","Maine","Waldo County",38786,"","Waldo County Maine",38345,39384,-441,-1.13700819883463,1.13700819883463,598,1.5417934306193,1.5417934306193
"23","029","G2300290","2010","1","1","Maine","Washington County",32856,"","Washington County Maine",31975,35634,-881,-2.68139761383005,2.68139761383005,2778,8.45507669831994,8.45507669831994
"23","031","G2300310","2010","1","1","Maine","York County",197131,"","York County Maine",201474,209692,4343,2.20310351999432,2.20310351999432,12561,6.37190497689354,6.37190497689354
"24","001","G2400010","2010","3","5","Maryland","Allegany County",75087,"","Allegany County Maryland",72659,75838,-2428,-3.23358237777511,3.23358237777511,751,1.00017313249963,1.00017313249963
"24","003","G2400030","2010","3","5","Maryland","Anne Arundel County",537656,"","Anne Arundel County Maryland",523323,537967,-14333,-2.66583094022944,2.66583094022944,311,0.0578436769979318,0.0578436769979318
"24","005","G2400050","2010","3","5","Maryland","Baltimore County",805029,"","Baltimore County Maryland",790956,791236,-14073,-1.7481357814439,1.7481357814439,-13793,-1.71335442574118,1.71335442574118
"24","009","G2400090","2010","3","5","Maryland","Calvert County",88737,"","Calvert County Maryland",89754,89194,1017,1.14608336995842,1.14608336995842,457,0.515005014819072,0.515005014819072
"24","011","G2400110","2010","3","5","Maryland","Caroline County",33066,"","Caroline County Maryland",33461,33895,395,1.1945805358979,1.1945805358979,829,2.50710699812496,2.50710699812496
"24","013","G2400130","2010","3","5","Maryland","Carroll County",167134,"","Carroll County Maryland",170131,171827,2997,1.7931719458638,1.7931719458638,4693,2.80792657388682,2.80792657388682
"24","015","G2400150","2010","3","5","Maryland","Cecil County",101108,"","Cecil County Maryland",100892,102477,-216,-0.213632946947818,0.213632946947818,1369,1.3539977054239,1.3539977054239
"24","017","G2400170","2010","3","5","Maryland","Charles County",146551,"","Charles County Maryland",143487,149450,-3064,-2.09073974247873,2.09073974247873,2899,1.97815095086352,1.97815095086352
"24","019","G2400190","2010","3","5","Maryland","Dorchester County",32618,"","Dorchester County Maryland",32048,35202,-570,-1.74750137960635,1.74750137960635,2584,7.92200625421546,7.92200625421546
"24","021","G2400210","2010","3","5","Maryland","Frederick County",233385,"","Frederick County Maryland",229526,235798,-3859,-1.65349101270433,1.65349101270433,2413,1.03391391906078,1.03391391906078
"24","023","G2400230","2010","3","5","Maryland","Garrett County",30097,"","Garrett County Maryland",29471,34399,-626,-2.07994152241087,2.07994152241087,4302,14.2937834335648,14.2937834335648
"24","025","G2400250","2010","3","5","Maryland","Harford County",244826,"","Harford County Maryland",242767,256818,-2059,-0.841005448767696,0.841005448767696,11992,4.89817257970967,4.89817257970967
"24","027","G2400270","2010","3","5","Maryland","Howard County",287085,"","Howard County Maryland",284835,286129,-2250,-0.783740007314907,0.783740007314907,-956,-0.3330024208858,0.3330024208858
"24","029","G2400290","2010","3","5","Maryland","Kent County",20197,"","Kent County Maryland",20257,22321,60,0.297073822844977,0.297073822844977,2124,10.5164133287122,10.5164133287122
"24","031","G2400310","2010","3","5","Maryland","Montgomery County",971777,"","Montgomery County Maryland",984048,955219,12271,1.26273826196751,1.26273826196751,-16558,-1.70388885515916,1.70388885515916
"24","033","G2400330","2010","3","5","Maryland","Prince George's County",863420,"","Prince George's County Maryland",837407,854815,-26013,-3.0127863612147,3.0127863612147,-8605,-0.996618100113502,0.996618100113502
"24","035","G2400350","2010","3","5","Maryland","Queen Anne's County",47798,"","Queen Anne's County Maryland",48359,48615,561,1.17368927570191,1.17368927570191,817,1.70927653876731,1.70927653876731
"24","037","G2400370","2010","3","5","Maryland","St. Mary's County",105151,"","St. Mary's County Maryland",104378,107318,-773,-0.73513328451465,0.73513328451465,2167,2.06084583123318,2.06084583123318
"24","039","G2400390","2010","3","5","Maryland","Somerset County",26470,"","Somerset County Maryland",26078,27416,-392,-1.48092179826218,1.48092179826218,946,3.5738571968266,3.5738571968266
"24","041","G2400410","2010","3","5","Maryland","Talbot County",37782,"","Talbot County Maryland",36300,42168,-1482,-3.92250277910116,3.92250277910116,4386,11.6087025567731,11.6087025567731
"24","043","G2400430","2010","3","5","Maryland","Washington County",147430,"","Washington County Maryland",146036,152020,-1394,-0.945533473512854,0.945533473512854,4590,3.11334192498135,3.11334192498135
"24","045","G2400450","2010","3","5","Maryland","Wicomico County",98733,"","Wicomico County Maryland",94698,101327,-4035,-4.08677949621707,4.08677949621707,2594,2.62728773561018,2.62728773561018
"24","047","G2400470","2010","3","5","Maryland","Worcester County",51454,"","Worcester County Maryland",48912,53978,-2542,-4.94033505655537,4.94033505655537,2524,4.90535235355852,4.90535235355852
"24","510","G2405100","2010","3","5","Maryland","Baltimore City",620961,"","Baltimore City Maryland",635073,637679,14112,2.27260649219516,2.27260649219516,16718,2.69227858110252,2.69227858110252
"25","001","G2500010","2010","1","1","Massachusetts","Barnstable County",215888,"","Barnstable County Massachusetts",220540,235377,4652,2.15482101830579,2.15482101830579,19489,9.02736604165123,9.02736604165123
"25","003","G2500030","2010","1","1","Massachusetts","Berkshire County",131219,"","Berkshire County Massachusetts",129099,139458,-2120,-1.61561968922184,1.61561968922184,8239,6.27881632995222,6.27881632995222
"25","005","G2500050","2010","1","1","Massachusetts","Bristol County",548285,"","Bristol County Massachusetts",548060,556348,-225,-0.0410370518981916,0.0410370518981916,8063,1.47058555313386,1.47058555313386
"25","007","G2500070","2010","1","1","Massachusetts","Dukes County",16535,"","Dukes County Massachusetts",16100,16623,-435,-2.63078318717871,2.63078318717871,88,0.532204414877533,0.532204414877533
"25","009","G2500090","2010","1","1","Massachusetts","Essex County",743159,"","Essex County Massachusetts",748057,754318,4898,0.659078339897653,0.659078339897653,11159,1.50156292260472,1.50156292260472
"25","011","G2500110","2010","1","1","Massachusetts","Franklin County",71372,"","Franklin County Massachusetts",71581,74239,209,0.292831922882923,0.292831922882923,2867,4.01698144930785,4.01698144930785
"25","013","G2500130","2010","1","1","Massachusetts","Hampden County",463490,"","Hampden County Massachusetts",469828,469205,6338,1.36745129344754,1.36745129344754,5715,1.23303631146303,1.23303631146303
"25","015","G2500150","2010","1","1","Massachusetts","Hampshire County",158080,"","Hampshire County Massachusetts",155845,160598,-2235,-1.41384109311741,1.41384109311741,2518,1.59286437246964,1.59286437246964
"25","017","G2500170","2010","1","1","Massachusetts","Middlesex County",1503085,"","Middlesex County Massachusetts",1513979,1521173,10894,0.724776043936304,0.724776043936304,18088,1.20339169108866,1.20339169108866
"25","019","G2500190","2010","1","1","Massachusetts","Nantucket County",10172,"","Nantucket County Massachusetts",11262,11039,1090,10.715690129768,10.715690129768,867,8.52339756193472,8.52339756193472
"25","021","G2500210","2010","1","1","Massachusetts","Norfolk County",670850,"","Norfolk County Massachusetts",671338,681046,488,0.0727435343221286,0.0727435343221286,10196,1.51986286055005,1.51986286055005
"25","023","G2500230","2010","1","1","Massachusetts","Plymouth County",494919,"","Plymouth County Massachusetts",499927,506836,5008,1.01188275253122,1.01188275253122,11917,2.40786876236313,2.40786876236313
"25","025","G2500250","2010","1","1","Massachusetts","Suffolk County",722023,"","Suffolk County Massachusetts",758664,719711,36641,5.07476908630334,5.07476908630334,-2312,-0.320211406007842,0.320211406007842
"25","027","G2500270","2010","1","1","Massachusetts","Worcester County",798552,"","Worcester County Massachusetts",807308,807133,8756,1.09648463719332,1.09648463719332,8581,1.07456997164868,1.07456997164868
"26","001","G2600010","2010","2","3","Michigan","Alcona County",10942,"","Alcona County Michigan",10907,12395,-35,-0.319868397002376,0.319868397002376,1453,13.2791080241272,13.2791080241272
"26","003","G2600030","2010","2","3","Michigan","Alger County",9601,"","Alger County Michigan",9444,10944,-157,-1.63524632850745,1.63524632850745,1343,13.9881262368503,13.9881262368503
"26","005","G2600050","2010","2","3","Michigan","Allegan County",111408,"","Allegan County Michigan",113530,119492,2122,1.90471061324142,1.90471061324142,8084,7.25621140313083,7.25621140313083
"26","007","G2600070","2010","2","3","Michigan","Alpena County",29598,"","Alpena County Michigan",28986,32010,-612,-2.06770727751875,2.06770727751875,2412,8.14919927022096,8.14919927022096
"26","009","G2600090","2010","2","3","Michigan","Antrim County",23580,"","Antrim County Michigan",23521,25529,-59,-0.250212044105174,0.250212044105174,1949,8.26547921967769,8.26547921967769
"26","011","G2600110","2010","2","3","Michigan","Arenac County",15899,"","Arenac County Michigan",15570,18236,-329,-2.06931253537958,2.06931253537958,2337,14.6990376753255,14.6990376753255
"26","013","G2600130","2010","2","3","Michigan","Baraga County",8860,"","Baraga County Michigan",8556,9243,-304,-3.43115124153499,3.43115124153499,383,4.32279909706546,4.32279909706546
"26","015","G2600150","2010","2","3","Michigan","Barry County",59173,"","Barry County Michigan",58021,62553,-1152,-1.94683386003752,1.94683386003752,3380,5.71206462406841,5.71206462406841
"26","017","G2600170","2010","2","3","Michigan","Bay County",107771,"","Bay County Michigan",107047,114582,-724,-0.671794824210595,0.671794824210595,6811,6.31988197195906,6.31988197195906
"26","019","G2600190","2010","2","3","Michigan","Benzie County",17525,"","Benzie County Michigan",17073,18739,-452,-2.57917261055635,2.57917261055635,1214,6.92724679029957,6.92724679029957
"26","021","G2600210","2010","2","3","Michigan","Berrien County",156813,"","Berrien County Michigan",160421,171288,3608,2.30082965060295,2.30082965060295,14475,9.23073979835855,9.23073979835855
"26","023","G2600230","2010","2","3","Michigan","Branch County",45248,"","Branch County Michigan",44647,48017,-601,-1.32823550212164,1.32823550212164,2769,6.11960749646393,6.11960749646393
"26","025","G2600250","2010","2","3","Michigan","Calhoun County",136146,"","Calhoun County Michigan",135201,142695,-945,-0.694107796042484,0.694107796042484,6549,4.81027720241505,4.81027720241505
"26","027","G2600270","2010","2","3","Michigan","Cass County",52293,"","Cass County Michigan",49587,55604,-2706,-5.17468877287591,5.17468877287591,3311,6.33163138469776,6.33163138469776
"26","029","G2600290","2010","2","3","Michigan","Charlevoix County",25949,"","Charlevoix County Michigan",25564,30123,-385,-1.48367952522255,1.48367952522255,4174,16.085398281244,16.085398281244
"26","031","G2600310","2010","2","3","Michigan","Cheboygan County",26152,"","Cheboygan County Michigan",25811,28668,-341,-1.30391557051086,1.30391557051086,2516,9.62067910676048,9.62067910676048
"26","033","G2600330","2010","2","3","Michigan","Chippewa County",38520,"","Chippewa County Michigan",37827,41221,-693,-1.79906542056075,1.79906542056075,2701,7.01194184839045,7.01194184839045
"26","035","G2600350","2010","2","3","Michigan","Clare County",30926,"","Clare County Michigan",30090,32539,-836,-2.70322705813878,2.70322705813878,1613,5.21567613011705,5.21567613011705
"26","037","G2600370","2010","2","3","Michigan","Clinton County",75382,"","Clinton County Michigan",69848,78569,-5534,-7.34127510546284,7.34127510546284,3187,4.22779973999098,4.22779973999098
"26","039","G2600390","2010","2","3","Michigan","Crawford County",14074,"","Crawford County Michigan",13476,15295,-598,-4.24896973141964,4.24896973141964,1221,8.67557197669461,8.67557197669461
"26","041","G2600410","2010","2","3","Michigan","Delta County",37069,"","Delta County Michigan",36849,40586,-220,-0.59348782001133,0.59348782001133,3517,9.48771210445386,9.48771210445386
"26","043","G2600430","2010","2","3","Michigan","Dickinson County",26168,"","Dickinson County Michigan",26494,28583,326,1.24579639254051,1.24579639254051,2415,9.22882910424947,9.22882910424947
"26","045","G2600450","2010","2","3","Michigan","Eaton County",107759,"","Eaton County Michigan",106392,112909,-1367,-1.2685715346282,1.2685715346282,5150,4.77918317727522,4.77918317727522
"26","047","G2600470","2010","2","3","Michigan","Emmet County",32694,"","Emmet County Michigan",33585,35900,891,2.72527069187007,2.72527069187007,3206,9.80608062641463,9.80608062641463
"26","049","G2600490","2010","2","3","Michigan","Genesee County",425790,"","Genesee County Michigan",420367,468237,-5423,-1.27363254186336,1.27363254186336,42447,9.96899880222645,9.96899880222645
"26","051","G2600510","2010","2","3","Michigan","Gladwin County",25692,"","Gladwin County Michigan",25736,28395,44,0.171259536042348,0.171259536042348,2703,10.520784680056,10.520784680056
"26","053","G2600530","2010","2","3","Michigan","Gogebic County",16427,"","Gogebic County Michigan",15907,17774,-520,-3.16552018019115,3.16552018019115,1347,8.19991477445669,8.19991477445669
"26","055","G2600550","2010","2","3","Michigan","Grand Traverse County",86986,"","Grand Traverse County Michigan",86587,91572,-399,-0.458694502563631,0.458694502563631,4586,5.27211275377647,5.27211275377647
"26","057","G2600570","2010","2","3","Michigan","Gratiot County",42476,"","Gratiot County Michigan",41989,43376,-487,-1.14652980506639,1.14652980506639,900,2.11884358225822,2.11884358225822
"26","059","G2600590","2010","2","3","Michigan","Hillsdale County",46688,"","Hillsdale County Michigan",45573,50308,-1115,-2.38819396847156,2.38819396847156,3620,7.7535983550377,7.7535983550377
"26","061","G2600610","2010","2","3","Michigan","Houghton County",36628,"","Houghton County Michigan",35314,37728,-1314,-3.58741946052201,3.58741946052201,1100,3.00316697608387,3.00316697608387
"26","063","G2600630","2010","2","3","Michigan","Huron County",33118,"","Huron County Michigan",32074,37778,-1044,-3.1523642732049,3.1523642732049,4660,14.070898001087,14.070898001087
"26","065","G2600650","2010","2","3","Michigan","Ingham County",280895,"","Ingham County Michigan",276599,293642,-4296,-1.52939710568006,1.52939710568006,12747,4.53799462432582,4.53799462432582
"26","067","G2600670","2010","2","3","Michigan","Ionia County",63905,"","Ionia County Michigan",62437,67737,-1468,-2.29715984664737,2.29715984664737,3832,5.99640090759721,5.99640090759721
"26","069","G2600690","2010","2","3","Michigan","Iosco County",25887,"","Iosco County Michigan",25372,28407,-515,-1.9894155367559,1.9894155367559,2520,9.73461583033955,9.73461583033955
"26","071","G2600710","2010","2","3","Michigan","Iron County",11817,"","Iron County Michigan",11397,13629,-420,-3.55420157400355,3.55420157400355,1812,15.3338410764153,15.3338410764153
"26","073","G2600730","2010","2","3","Michigan","Isabella County",70311,"","Isabella County Michigan",67099,74805,-3212,-4.56827523431611,4.56827523431611,4494,6.39160302086444,6.39160302086444
"26","075","G2600750","2010","2","3","Michigan","Jackson County",160248,"","Jackson County Michigan",159644,171811,-604,-0.376915780540163,0.376915780540163,11563,7.21569067944686,7.21569067944686
"26","077","G2600770","2010","2","3","Michigan","Kalamazoo County",250331,"","Kalamazoo County Michigan",249096,261503,-1235,-0.493346808825116,0.493346808825116,11172,4.46289113214105,4.46289113214105
"26","079","G2600790","2010","2","3","Michigan","Kalkaska County",17153,"","Kalkaska County Michigan",16686,18097,-467,-2.72255582113916,2.72255582113916,944,5.50341048213141,5.50341048213141
"26","081","G2600810","2010","2","3","Michigan","Kent County",602622,"","Kent County Michigan",609979,627965,7357,1.22083163243293,1.22083163243293,25343,4.20545549282967,4.20545549282967
"26","083","G2600830","2010","2","3","Michigan","Keweenaw County",2156,"","Keweenaw County Michigan",2339,2454,183,8.48794063079777,8.48794063079777,298,13.821892393321,13.821892393321
"26","085","G2600850","2010","2","3","Michigan","Lake County",11539,"","Lake County Michigan",10821,12048,-718,-6.22237628910651,6.22237628910651,509,4.41112748071757,4.41112748071757
"26","087","G2600870","2010","2","3","Michigan","Lapeer County",88319,"","Lapeer County Michigan",89601,96173,1282,1.45155629026597,1.45155629026597,7854,8.89276373147341,8.89276373147341
"26","089","G2600890","2010","2","3","Michigan","Leelanau County",21708,"","Leelanau County Michigan",21842,24047,134,0.617283950617284,0.617283950617284,2339,10.7748295559241,10.7748295559241
"26","091","G2600910","2010","2","3","Michigan","Lenawee County",99892,"","Lenawee County Michigan",99468,107302,-424,-0.424458415088295,0.424458415088295,7410,7.41801145236856,7.41801145236856
"26","093","G2600930","2010","2","3","Michigan","Livingston County",180967,"","Livingston County Michigan",182246,194005,1279,0.706758690811032,0.706758690811032,13038,7.20462846817376,7.20462846817376
"26","095","G2600950","2010","2","3","Michigan","Luce County",6631,"","Luce County Michigan",6540,7638,-91,-1.37234202985975,1.37234202985975,1007,15.1862464183381,15.1862464183381
"26","097","G2600970","2010","2","3","Michigan","Mackinac County",11113,"","Mackinac County Michigan",10370,12735,-743,-6.68586340322145,6.68586340322145,1622,14.5955187618105,14.5955187618105
"26","099","G2600990","2010","2","3","Michigan","Macomb County",840978,"","Macomb County Michigan",831009,870696,-9969,-1.18540556352247,1.18540556352247,29718,3.53374285653132,3.53374285653132
"26","101","G2601010","2010","2","3","Michigan","Manistee County",24733,"","Manistee County Michigan",24338,26964,-395,-1.59705656410464,1.59705656410464,2231,9.02033720130999,9.02033720130999
"26","103","G2601030","2010","2","3","Michigan","Marquette County",67077,"","Marquette County Michigan",65957,68210,-1120,-1.66972285582241,1.66972285582241,1133,1.68910356754178,1.68910356754178
"26","105","G2601050","2010","2","3","Michigan","Mason County",28705,"","Mason County Michigan",28692,30446,-13,-0.0452882773036056,0.0452882773036056,1741,6.06514544504442,6.06514544504442
"26","107","G2601070","2010","2","3","Michigan","Mecosta County",42798,"","Mecosta County Michigan",41792,44897,-1006,-2.35057712977242,2.35057712977242,2099,4.90443478667227,4.90443478667227
"26","109","G2601090","2010","2","3","Michigan","Menominee County",24029,"","Menominee County Michigan",23804,26833,-225,-0.936368554663115,0.936368554663115,2804,11.6692330101128,11.6692330101128
"26","111","G2601110","2010","2","3","Michigan","Midland County",83629,"","Midland County Michigan",82268,86713,-1361,-1.62742589293188,1.62742589293188,3084,3.68771598368987,3.68771598368987
"26","113","G2601130","2010","2","3","Michigan","Missaukee County",14849,"","Missaukee County Michigan",14776,15472,-73,-0.4916155970099,0.4916155970099,623,4.19556872516668,4.19556872516668
"26","115","G2601150","2010","2","3","Michigan","Monroe County",152021,"","Monroe County Michigan",152011,164341,-10,-0.00657803856046204,0.00657803856046204,12320,8.10414350648924,8.10414350648924
"26","117","G2601170","2010","2","3","Michigan","Montcalm County",63342,"","Montcalm County Michigan",62472,65398,-870,-1.37349625840674,1.37349625840674,2056,3.24587161756812,3.24587161756812
"26","119","G2601190","2010","2","3","Michigan","Montmorency County",9765,"","Montmorency County Michigan",10050,10947,285,2.91858678955453,2.91858678955453,1182,12.1044546850998,12.1044546850998
"26","121","G2601210","2010","2","3","Michigan","Muskegon County",172188,"","Muskegon County Michigan",173183,182642,995,0.577856761214486,0.577856761214486,10454,6.07127093641833,6.07127093641833
"26","123","G2601230","2010","2","3","Michigan","Newaygo County",48460,"","Newaygo County Michigan",48437,51407,-23,-0.0474618241848948,0.0474618241848948,2947,6.0813041683863,6.0813041683863
"26","125","G2601250","2010","2","3","Michigan","Oakland County",1202362,"","Oakland County Michigan",1206919,1274667,4557,0.379003993805526,0.379003993805526,72305,6.01357993682435,6.01357993682435
"26","127","G2601270","2010","2","3","Michigan","Oceana County",26570,"","Oceana County Michigan",27351,28618,781,2.93940534437335,2.93940534437335,2048,7.70794128716598,7.70794128716598
"26","129","G2601290","2010","2","3","Michigan","Ogemaw County",21699,"","Ogemaw County Michigan",20892,23040,-807,-3.71906539471865,3.71906539471865,1341,6.18000829531315,6.18000829531315
"26","131","G2601310","2010","2","3","Michigan","Ontonagon County",6780,"","Ontonagon County Michigan",6552,8186,-228,-3.36283185840708,3.36283185840708,1406,20.7374631268437,20.7374631268437
"26","133","G2601330","2010","2","3","Michigan","Osceola County",23528,"","Osceola County Michigan",22595,24471,-933,-3.96548792927576,3.96548792927576,943,4.00799047942877,4.00799047942877
"26","135","G2601350","2010","2","3","Michigan","Oscoda County",8640,"","Oscoda County Michigan",8522,9861,-118,-1.36574074074074,1.36574074074074,1221,14.1319444444444,14.1319444444444
"26","137","G2601370","2010","2","3","Michigan","Otsego County",24164,"","Otsego County Michigan",23345,25958,-819,-3.38933951332561,3.38933951332561,1794,7.4242675053799,7.4242675053799
"26","139","G2601390","2010","2","3","Michigan","Ottawa County",263801,"","Ottawa County Michigan",261731,279524,-2070,-0.784682393167577,0.784682393167577,15723,5.9601745254946,5.9601745254946
"26","141","G2601410","2010","2","3","Michigan","Presque Isle County",13376,"","Presque Isle County Michigan",13230,15549,-146,-1.09150717703349,1.09150717703349,2173,16.245514354067,16.245514354067
"26","143","G2601430","2010","2","3","Michigan","Roscommon County",24449,"","Roscommon County Michigan",24567,27571,118,0.482637326680028,0.482637326680028,3122,12.7694384228394,12.7694384228394
"26","145","G2601450","2010","2","3","Michigan","Saginaw County",200169,"","Saginaw County Michigan",198730,218213,-1439,-0.718892535807243,0.718892535807243,18044,9.01438284649471,9.01438284649471
"26","147","G2601470","2010","2","3","Michigan","St. Clair County",163040,"","St. Clair County Michigan",166241,179156,3201,1.9633218842002,1.9633218842002,16116,9.8846908734053,9.8846908734053
"26","149","G2601490","2010","2","3","Michigan","St. Joseph County",61295,"","St. Joseph County Michigan",61646,65084,351,0.572640509013786,0.572640509013786,3789,6.18158087935394,6.18158087935394
"26","151","G2601510","2010","2","3","Michigan","Sanilac County",43114,"","Sanilac County Michigan",41673,46245,-1441,-3.34230180451825,3.34230180451825,3131,7.26214222758269,7.26214222758269
"26","153","G2601530","2010","2","3","Michigan","Schoolcraft County",8485,"","Schoolcraft County Michigan",8118,9546,-367,-4.32527990571597,4.32527990571597,1061,12.5044195639364,12.5044195639364
"26","155","G2601550","2010","2","3","Michigan","Shiawassee County",70648,"","Shiawassee County Michigan",69851,74926,-797,-1.12812818480353,1.12812818480353,4278,6.05537311742725,6.05537311742725
"26","157","G2601570","2010","2","3","Michigan","Tuscola County",55729,"","Tuscola County Michigan",55278,60549,-451,-0.809273448294425,0.809273448294425,4820,8.64899782877855,8.64899782877855
"26","159","G2601590","2010","2","3","Michigan","Van Buren County",76258,"","Van Buren County Michigan",78029,82946,1771,2.32237929135304,2.32237929135304,6688,8.77022738597918,8.77022738597918
"26","161","G2601610","2010","2","3","Michigan","Washtenaw County",344791,"","Washtenaw County Michigan",348074,363650,3283,0.952171025345789,0.952171025345789,18859,5.46969033414445,5.46969033414445
"26","163","G2601630","2010","2","3","Michigan","Wayne County",1820584,"","Wayne County Michigan",1909760,2084193,89176,4.89820848694705,4.89820848694705,263609,14.4793648631428,14.4793648631428
"26","165","G2601650","2010","2","3","Michigan","Wexford County",32735,"","Wexford County Michigan",31490,33707,-1245,-3.80326867267451,3.80326867267451,972,2.96929891553383,2.96929891553383
"27","001","G2700010","2010","2","4","Minnesota","Aitkin County",16202,"","Aitkin County Minnesota",15497,17937,-705,-4.35131465251203,4.35131465251203,1735,10.7085544994445,10.7085544994445
"27","003","G2700030","2010","2","4","Minnesota","Anoka County",330844,"","Anoka County Minnesota",332298,346774,1454,0.439482051964068,0.439482051964068,15930,4.81495810714415,4.81495810714415
"27","005","G2700050","2010","2","4","Minnesota","Becker County",32504,"","Becker County Minnesota",32243,34055,-261,-0.802978095003692,0.802978095003692,1551,4.77172040364263,4.77172040364263
"27","007","G2700070","2010","2","4","Minnesota","Beltrami County",44442,"","Beltrami County Minnesota",44506,43874,64,0.144007920435624,0.144007920435624,-568,-1.27807029386616,1.27807029386616
"27","009","G2700090","2010","2","4","Minnesota","Benton County",38451,"","Benton County Minnesota",40458,42326,2007,5.21963017866896,5.21963017866896,3875,10.077761306598,10.077761306598
"27","011","G2700110","2010","2","4","Minnesota","Big Stone County",5269,"","Big Stone County Minnesota",5233,6058,-36,-0.683241601821978,0.683241601821978,789,14.9743784399317,14.9743784399317
"27","013","G2700130","2010","2","4","Minnesota","Blue Earth County",64013,"","Blue Earth County Minnesota",61367,65863,-2646,-4.13353537562683,4.13353537562683,1850,2.89003796103916,2.89003796103916
"27","015","G2700150","2010","2","4","Minnesota","Brown County",25893,"","Brown County Minnesota",25660,28336,-233,-0.899857104236666,0.899857104236666,2443,9.43498242768316,9.43498242768316
"27","017","G2700170","2010","2","4","Minnesota","Carlton County",35386,"","Carlton County Minnesota",34336,36598,-1050,-2.96727519357938,2.96727519357938,1212,3.42508336630306,3.42508336630306
"27","019","G2700190","2010","2","4","Minnesota","Carver County",91042,"","Carver County Minnesota",92812,97010,1770,1.94415764152809,1.94415764152809,5968,6.55521627380769,6.55521627380769
"27","021","G2700210","2010","2","4","Minnesota","Cass County",28567,"","Cass County Minnesota",28540,33346,-27,-0.0945146497707145,0.0945146497707145,4779,16.7290930094165,16.7290930094165
"27","023","G2700230","2010","2","4","Minnesota","Chippewa County",12441,"","Chippewa County Minnesota",12277,13305,-164,-1.31822200787718,1.31822200787718,864,6.94477935857246,6.94477935857246
"27","025","G2700250","2010","2","4","Minnesota","Chisago County",53887,"","Chisago County Minnesota",50588,51347,-3299,-6.12207025813276,6.12207025813276,-2540,-4.71356727967784,4.71356727967784
"27","027","G2700270","2010","2","4","Minnesota","Clay County",58999,"","Clay County Minnesota",57421,62445,-1578,-2.674621603756,2.674621603756,3446,5.84077696232139,5.84077696232139
"27","029","G2700290","2010","2","4","Minnesota","Clearwater County",8695,"","Clearwater County Minnesota",8234,8790,-461,-5.30189764232317,5.30189764232317,95,1.09258194364577,1.09258194364577
"27","031","G2700310","2010","2","4","Minnesota","Cook County",5176,"","Cook County Minnesota",5458,6265,282,5.44822256568779,5.44822256568779,1089,21.0394126738794,21.0394126738794
"27","033","G2700330","2010","2","4","Minnesota","Cottonwood County",11687,"","Cottonwood County Minnesota",11141,12339,-546,-4.67185761957731,4.67185761957731,652,5.5788482929751,5.5788482929751
"27","035","G2700350","2010","2","4","Minnesota","Crow Wing County",62500,"","Crow Wing County Minnesota",62463,66639,-37,-0.0592,0.0592,4139,6.6224,6.6224
"27","037","G2700370","2010","2","4","Minnesota","Dakota County",398552,"","Dakota County Minnesota",397883,419025,-669,-0.167857644673719,0.167857644673719,20473,5.1368453802766,5.1368453802766
"27","039","G2700390","2010","2","4","Minnesota","Dodge County",20087,"","Dodge County Minnesota",19840,21122,-247,-1.22965101807139,1.22965101807139,1035,5.15258624981331,5.15258624981331
"27","041","G2700410","2010","2","4","Minnesota","Douglas County",36009,"","Douglas County Minnesota",36146,39864,137,0.380460440445444,0.380460440445444,3855,10.7056569191036,10.7056569191036
"27","043","G2700430","2010","2","4","Minnesota","Faribault County",14553,"","Faribault County Minnesota",14382,16298,-171,-1.17501546072975,1.17501546072975,1745,11.9906548477977,11.9906548477977
"27","045","G2700450","2010","2","4","Minnesota","Fillmore County",20866,"","Fillmore County Minnesota",20761,23307,-105,-0.503210965206556,0.503210965206556,2441,11.6984568197067,11.6984568197067
"27","047","G2700470","2010","2","4","Minnesota","Freeborn County",31255,"","Freeborn County Minnesota",30933,32975,-322,-1.03023516237402,1.03023516237402,1720,5.50311950087986,5.50311950087986
"27","049","G2700490","2010","2","4","Minnesota","Goodhue County",46183,"","Goodhue County Minnesota",46096,49756,-87,-0.188381005997878,0.188381005997878,3573,7.73661303943009,7.73661303943009
"27","051","G2700510","2010","2","4","Minnesota","Grant County",6018,"","Grant County Minnesota",5784,6489,-234,-3.88833499501496,3.88833499501496,471,7.82652043868395,7.82652043868395
"27","053","G2700530","2010","2","4","Minnesota","Hennepin County",1152425,"","Hennepin County Minnesota",1164727,1204550,12302,1.06748812287134,1.06748812287134,52125,4.52307091567781,4.52307091567781
"27","055","G2700550","2010","2","4","Minnesota","Houston County",19027,"","Houston County Minnesota",19193,21103,166,0.872444421085825,0.872444421085825,2076,10.9108109528565,10.9108109528565
"27","057","G2700570","2010","2","4","Minnesota","Hubbard County",20428,"","Hubbard County Minnesota",18409,19722,-2019,-9.88349324456628,9.88349324456628,-706,-3.45604072841198,3.45604072841198
"27","059","G2700590","2010","2","4","Minnesota","Isanti County",37816,"","Isanti County Minnesota",39506,41171,1690,4.46900782737466,4.46900782737466,3355,8.87190607150412,8.87190607150412
"27","061","G2700610","2010","2","4","Minnesota","Itasca County",45058,"","Itasca County Minnesota",44563,49292,-495,-1.09858404722802,1.09858404722802,4234,9.3967774867948,9.3967774867948
"27","063","G2700630","2010","2","4","Minnesota","Jackson County",10266,"","Jackson County Minnesota",10776,11525,510,4.96785505552309,4.96785505552309,1259,12.263783362556,12.263783362556
"27","065","G2700650","2010","2","4","Minnesota","Kanabec County",16239,"","Kanabec County Minnesota",15775,16872,-464,-2.85731880041874,2.85731880041874,633,3.8980232772954,3.8980232772954
"27","067","G2700670","2010","2","4","Minnesota","Kandiyohi County",42239,"","Kandiyohi County Minnesota",41194,44804,-1045,-2.47401690380928,2.47401690380928,2565,6.07258694571368,6.07258694571368
"27","069","G2700690","2010","2","4","Minnesota","Kittson County",4552,"","Kittson County Minnesota",4338,5326,-214,-4.701230228471,4.701230228471,774,17.0035149384886,17.0035149384886
"27","071","G2700710","2010","2","4","Minnesota","Koochiching County",13311,"","Koochiching County Minnesota",13009,15250,-302,-2.26880024040267,2.26880024040267,1939,14.5668995567576,14.5668995567576
"27","073","G2700730","2010","2","4","Minnesota","Lac qui Parle County",7259,"","Lac qui Parle County Minnesota",7057,8111,-202,-2.78275244524039,2.78275244524039,852,11.7371538779446,11.7371538779446
"27","075","G2700750","2010","2","4","Minnesota","Lake County",10866,"","Lake County Minnesota",10620,12356,-246,-2.263942573164,2.263942573164,1490,13.7124976992454,13.7124976992454
"27","077","G2700770","2010","2","4","Minnesota","Lake of the Woods County",4045,"","Lake of the Woods County Minnesota",3833,4962,-212,-5.24103831891224,5.24103831891224,917,22.6699629171817,22.6699629171817
"27","079","G2700790","2010","2","4","Minnesota","Le Sueur County",27703,"","Le Sueur County Minnesota",27953,29408,250,0.902429339782695,0.902429339782695,1705,6.15456809731798,6.15456809731798
"27","081","G2700810","2010","2","4","Minnesota","Lincoln County",5896,"","Lincoln County Minnesota",5705,6698,-191,-3.23948439620081,3.23948439620081,802,13.6024423337856,13.6024423337856
"27","083","G2700830","2010","2","4","Minnesota","Lyon County",25857,"","Lyon County Minnesota",25090,27378,-767,-2.96631473102061,2.96631473102061,1521,5.88235294117647,5.88235294117647
"27","085","G2700850","2010","2","4","Minnesota","McLeod County",36651,"","McLeod County Minnesota",36891,39149,240,0.654825243513137,0.654825243513137,2498,6.81563940956591,6.81563940956591
"27","087","G2700870","2010","2","4","Minnesota","Mahnomen County",5413,"","Mahnomen County Minnesota",4999,5398,-414,-7.648254202845,7.648254202845,-15,-0.27711065952337,0.27711065952337
"27","089","G2700890","2010","2","4","Minnesota","Marshall County",9439,"","Marshall County Minnesota",9143,10480,-296,-3.13592541582795,3.13592541582795,1041,11.028710668503,11.028710668503
"27","091","G2700910","2010","2","4","Minnesota","Martin County",20840,"","Martin County Minnesota",20244,22423,-596,-2.85988483685221,2.85988483685221,1583,7.59596928982725,7.59596928982725
"27","093","G2700930","2010","2","4","Minnesota","Meeker County",23300,"","Meeker County Minnesota",23177,25106,-123,-0.527896995708155,0.527896995708155,1806,7.75107296137339,7.75107296137339
"27","095","G2700950","2010","2","4","Minnesota","Mille Lacs County",26097,"","Mille Lacs County Minnesota",26278,26258,181,0.693566310303866,0.693566310303866,161,0.616929148944323,0.616929148944323
"27","097","G2700970","2010","2","4","Minnesota","Morrison County",33198,"","Morrison County Minnesota",32876,37299,-322,-0.969937948069161,0.969937948069161,4101,12.3531538044461,12.3531538044461
"27","099","G2700990","2010","2","4","Minnesota","Mower County",39163,"","Mower County Minnesota",38331,40545,-832,-2.12445420422337,2.12445420422337,1382,3.52884099788065,3.52884099788065
"27","101","G2701010","2010","2","4","Minnesota","Murray County",8725,"","Murray County Minnesota",8310,9691,-415,-4.75644699140401,4.75644699140401,966,11.0716332378223,11.0716332378223
"27","103","G2701030","2010","2","4","Minnesota","Nicollet County",32727,"","Nicollet County Minnesota",32321,34083,-406,-1.24056589360467,1.24056589360467,1356,4.14336786139885,4.14336786139885
"27","105","G2701050","2010","2","4","Minnesota","Nobles County",21378,"","Nobles County Minnesota",20528,21292,-850,-3.97605014500889,3.97605014500889,-86,-0.40228272055384,0.40228272055384
"27","107","G2701070","2010","2","4","Minnesota","Norman County",6852,"","Norman County Minnesota",6484,7576,-368,-5.37069468768243,5.37069468768243,724,10.5662580268535,10.5662580268535
"27","109","G2701090","2010","2","4","Minnesota","Olmsted County",144248,"","Olmsted County Minnesota",145002,151715,754,0.522710886806056,0.522710886806056,7467,5.17650158061117,5.17650158061117
"27","111","G2701110","2010","2","4","Minnesota","Otter Tail County",57303,"","Otter Tail County Minnesota",56386,60142,-917,-1.60026525661833,1.60026525661833,2839,4.95436539099175,4.95436539099175
"27","113","G2701130","2010","2","4","Minnesota","Pennington County",13930,"","Pennington County Minnesota",13866,14302,-64,-0.459440057430007,0.459440057430007,372,2.67049533381192,2.67049533381192
"27","115","G2701150","2010","2","4","Minnesota","Pine County",29750,"","Pine County Minnesota",28230,28831,-1520,-5.10924369747899,5.10924369747899,-919,-3.0890756302521,3.0890756302521
"27","117","G2701170","2010","2","4","Minnesota","Pipestone County",9596,"","Pipestone County Minnesota",9240,10110,-356,-3.70987911629846,3.70987911629846,514,5.35639849937474,5.35639849937474
"27","119","G2701190","2010","2","4","Minnesota","Polk County",31600,"","Polk County Minnesota",30911,33139,-689,-2.18037974683544,2.18037974683544,1539,4.87025316455696,4.87025316455696
"27","121","G2701210","2010","2","4","Minnesota","Pope County",10995,"","Pope County Minnesota",10825,12565,-170,-1.54615734424739,1.54615734424739,1570,14.2792178262847,14.2792178262847
"27","123","G2701230","2010","2","4","Minnesota","Ramsey County",508640,"","Ramsey County Minnesota",509031,533022,391,0.0768716577540107,0.0768716577540107,24382,4.79356715948412,4.79356715948412
"27","125","G2701250","2010","2","4","Minnesota","Red Lake County",4089,"","Red Lake County Minnesota",4134,4437,45,1.10051357300073,1.10051357300073,348,8.51063829787234,8.51063829787234
"27","127","G2701270","2010","2","4","Minnesota","Redwood County",16059,"","Redwood County Minnesota",15457,17111,-602,-3.7486767544679,3.7486767544679,1052,6.55084376362165,6.55084376362165
"27","129","G2701290","2010","2","4","Minnesota","Renville County",15730,"","Renville County Minnesota",15650,17325,-80,-0.508582326764145,0.508582326764145,1595,10.1398601398601,10.1398601398601
"27","131","G2701310","2010","2","4","Minnesota","Rice County",64142,"","Rice County Minnesota",63595,67611,-547,-0.852795360294347,0.852795360294347,3469,5.40831280596177,5.40831280596177
"27","133","G2701330","2010","2","4","Minnesota","Rock County",9687,"","Rock County Minnesota",9498,10087,-189,-1.95106844224218,1.95106844224218,400,4.12924538040673,4.12924538040673
"27","135","G2701350","2010","2","4","Minnesota","Roseau County",15629,"","Roseau County Minnesota",15642,17279,13,0.0831787062511997,0.0831787062511997,1650,10.557297331883,10.557297331883
"27","137","G2701370","2010","2","4","Minnesota","St. Louis County",200226,"","St. Louis County Minnesota",196692,210993,-3534,-1.76500554373558,1.76500554373558,10767,5.37742351143208,5.37742351143208
"27","139","G2701390","2010","2","4","Minnesota","Scott County",129928,"","Scott County Minnesota",133311,133685,3383,2.60374976910289,2.60374976910289,3757,2.89160150237054,2.89160150237054
"27","141","G2701410","2010","2","4","Minnesota","Sherburne County",88499,"","Sherburne County Minnesota",88283,90489,-216,-0.244070554469542,0.244070554469542,1990,2.24861297867773,2.24861297867773
"27","143","G2701430","2010","2","4","Minnesota","Sibley County",15226,"","Sibley County Minnesota",14959,16552,-267,-1.75357940365165,1.75357940365165,1326,8.70878760015762,8.70878760015762
"27","145","G2701450","2010","2","4","Minnesota","Stearns County",150642,"","Stearns County Minnesota",149308,160449,-1334,-0.885543208401375,0.885543208401375,9807,6.51013661528657,6.51013661528657
"27","147","G2701470","2010","2","4","Minnesota","Steele County",36576,"","Steele County Minnesota",36598,38229,22,0.0601487314085739,0.0601487314085739,1653,4.51935695538058,4.51935695538058
"27","149","G2701490","2010","2","4","Minnesota","Stevens County",9726,"","Stevens County Minnesota",9633,10569,-93,-0.956199876619371,0.956199876619371,843,8.66748920419494,8.66748920419494
"27","151","G2701510","2010","2","4","Minnesota","Swift County",9783,"","Swift County Minnesota",9465,12329,-318,-3.25053664520086,3.25053664520086,2546,26.0247367883062,26.0247367883062
"27","153","G2701530","2010","2","4","Minnesota","Todd County",24895,"","Todd County Minnesota",23807,26828,-1088,-4.3703554930709,4.3703554930709,1933,7.76461136774453,7.76461136774453
"27","155","G2701550","2010","2","4","Minnesota","Traverse County",3558,"","Traverse County Minnesota",3517,4265,-41,-1.15233277121979,1.15233277121979,707,19.8707138842046,19.8707138842046
"27","157","G2701570","2010","2","4","Minnesota","Wabasha County",21676,"","Wabasha County Minnesota",21809,24665,133,0.613581841668204,0.613581841668204,2989,13.7894445469644,13.7894445469644
"27","159","G2701590","2010","2","4","Minnesota","Wadena County",13843,"","Wadena County Minnesota",13239,14911,-604,-4.36321606588167,4.36321606588167,1068,7.71509065953912,7.71509065953912
"27","161","G2701610","2010","2","4","Minnesota","Waseca County",19136,"","Waseca County Minnesota",19214,20943,78,0.407608695652174,0.407608695652174,1807,9.4429347826087,9.4429347826087
"27","163","G2701630","2010","2","4","Minnesota","Washington County",238136,"","Washington County Minnesota",233046,249212,-5090,-2.137434071287,2.137434071287,11076,4.65112372761783,4.65112372761783
"27","165","G2701650","2010","2","4","Minnesota","Watonwan County",11211,"","Watonwan County Minnesota",10936,12153,-275,-2.45294799750245,2.45294799750245,942,8.4024618678084,8.4024618678084
"27","167","G2701670","2010","2","4","Minnesota","Wilkin County",6576,"","Wilkin County Minnesota",6247,7496,-329,-5.00304136253041,5.00304136253041,920,13.9902676399027,13.9902676399027
"27","169","G2701690","2010","2","4","Minnesota","Winona County",51461,"","Winona County Minnesota",49331,54117,-2130,-4.13905676143099,4.13905676143099,2656,5.16119002739939,5.16119002739939
"27","171","G2701710","2010","2","4","Minnesota","Wright County",124700,"","Wright County Minnesota",122930,128289,-1770,-1.41940657578188,1.41940657578188,3589,2.87810745789896,2.87810745789896
"27","173","G2701730","2010","2","4","Minnesota","Yellow Medicine County",10438,"","Yellow Medicine County Minnesota",9945,11479,-493,-4.72312703583062,4.72312703583062,1041,9.97317493772753,9.97317493772753
"28","001","G2800010","2010","3","6","Mississippi","Adams County",32297,"","Adams County Mississippi",30585,35215,-1712,-5.30080193206799,5.30080193206799,2918,9.03489488187757,9.03489488187757
"28","003","G2800030","2010","3","6","Mississippi","Alcorn County",37057,"","Alcorn County Mississippi",35864,36323,-1193,-3.21936476239307,3.21936476239307,-734,-1.98073238524435,1.98073238524435
"28","005","G2800050","2010","3","6","Mississippi","Amite County",13131,"","Amite County Mississippi",12967,14530,-164,-1.24895285964511,1.24895285964511,1399,10.6541771380702,10.6541771380702
"28","007","G2800070","2010","3","6","Mississippi","Attala County",19564,"","Attala County Mississippi",19647,21049,83,0.424248619914128,0.424248619914128,1485,7.59047229605398,7.59047229605398
"28","009","G2800090","2010","3","6","Mississippi","Benton County",8729,"","Benton County Mississippi",7907,8507,-822,-9.41688624126475,9.41688624126475,-222,-2.5432466491007,2.5432466491007
"28","011","G2800110","2010","3","6","Mississippi","Bolivar County",34145,"","Bolivar County Mississippi",36547,42583,2402,7.03470493483673,7.03470493483673,8438,24.712256552936,24.712256552936
"28","013","G2800130","2010","3","6","Mississippi","Calhoun County",14962,"","Calhoun County Mississippi",14468,15897,-494,-3.30169763400615,3.30169763400615,935,6.24916455019382,6.24916455019382
"28","015","G2800150","2010","3","6","Mississippi","Carroll County",10597,"","Carroll County Mississippi",10167,11546,-430,-4.05775219401717,4.05775219401717,949,8.95536472586581,8.95536472586581
"28","017","G2800170","2010","3","6","Mississippi","Chickasaw County",17392,"","Chickasaw County Mississippi",18812,20665,1420,8.16467341306348,8.16467341306348,3273,18.8189972401104,18.8189972401104
"28","019","G2800190","2010","3","6","Mississippi","Choctaw County",8547,"","Choctaw County Mississippi",8980,10296,433,5.06610506610507,5.06610506610507,1749,20.4633204633205,20.4633204633205
"28","021","G2800210","2010","3","6","Mississippi","Claiborne County",9604,"","Claiborne County Mississippi",10686,12621,1082,11.2661391087047,11.2661391087047,3017,31.4139941690962,31.4139941690962
"28","023","G2800230","2010","3","6","Mississippi","Clarke County",16732,"","Clarke County Mississippi",17249,19002,517,3.08988764044944,3.08988764044944,2270,13.5668180731532,13.5668180731532
"28","025","G2800250","2010","3","6","Mississippi","Clay County",20634,"","Clay County Mississippi",20475,22999,-159,-0.770572840942134,0.770572840942134,2365,11.4616652127556,11.4616652127556
"28","027","G2800270","2010","3","6","Mississippi","Coahoma County",26151,"","Coahoma County Mississippi",26943,31342,792,3.0285648732362,3.0285648732362,5191,19.850101334557,19.850101334557
"28","029","G2800290","2010","3","6","Mississippi","Copiah County",29449,"","Copiah County Mississippi",29048,30071,-401,-1.36167611803457,1.36167611803457,622,2.1121260484227,2.1121260484227
"28","031","G2800310","2010","3","6","Mississippi","Covington County",19568,"","Covington County Mississippi",20701,20759,1133,5.79006541291905,5.79006541291905,1191,6.08646770237122,6.08646770237122
"28","033","G2800330","2010","3","6","Mississippi","DeSoto County",161252,"","DeSoto County Mississippi",160111,160540,-1141,-0.70758812293801,0.70758812293801,-712,-0.44154491107087,0.44154491107087
"28","035","G2800350","2010","3","6","Mississippi","Forrest County",74934,"","Forrest County Mississippi",81091,83389,6157,8.21656390957376,8.21656390957376,8455,11.2832626044252,11.2832626044252
"28","037","G2800370","2010","3","6","Mississippi","Franklin County",8118,"","Franklin County Mississippi",8326,9009,208,2.56220744025622,2.56220744025622,891,10.9756097560976,10.9756097560976
"28","039","G2800390","2010","3","6","Mississippi","George County",22578,"","George County Mississippi",23109,20789,531,2.35184693064045,2.35184693064045,-1789,-7.92364248383382,7.92364248383382
"28","041","G2800410","2010","3","6","Mississippi","Greene County",14400,"","Greene County Mississippi",14455,14112,55,0.381944444444444,0.381944444444444,-288,-2,2
"28","043","G2800430","2010","3","6","Mississippi","Grenada County",21906,"","Grenada County Mississippi",22988,24724,1082,4.93928604035424,4.93928604035424,2818,12.864055509906,12.864055509906
"28","045","G2800450","2010","3","6","Mississippi","Hancock County",43929,"","Hancock County Mississippi",41143,42260,-2786,-6.34205194746067,6.34205194746067,-1669,-3.79931252703226,3.79931252703226
"28","047","G2800470","2010","3","6","Mississippi","Harrison County",187105,"","Harrison County Mississippi",181590,202203,-5515,-2.94754282354827,2.94754282354827,15098,8.06926592020523,8.06926592020523
"28","049","G2800490","2010","3","6","Mississippi","Hinds County",245285,"","Hinds County Mississippi",248276,268482,2991,1.21939784332511,1.21939784332511,23197,9.45716207676784,9.45716207676784
"28","051","G2800510","2010","3","6","Mississippi","Holmes County",19198,"","Holmes County Mississippi",20032,23099,834,4.34420252109595,4.34420252109595,3901,20.3198249817689,20.3198249817689
"28","053","G2800530","2010","3","6","Mississippi","Humphreys County",9375,"","Humphreys County Mississippi",9711,11538,336,3.584,3.584,2163,23.072,23.072
"28","055","G2800550","2010","3","6","Mississippi","Issaquena County",1406,"","Issaquena County Mississippi",1571,2386,165,11.7354196301565,11.7354196301565,980,69.701280227596,69.701280227596
"28","057","G2800570","2010","3","6","Mississippi","Itawamba County",23401,"","Itawamba County Mississippi",22984,24365,-417,-1.78197512926798,1.78197512926798,964,4.11948207341567,4.11948207341567
"28","059","G2800590","2010","3","6","Mississippi","Jackson County",139668,"","Jackson County Mississippi",132304,149053,-7364,-5.27250336512301,5.27250336512301,9385,6.71950625769682,6.71950625769682
"28","061","G2800610","2010","3","6","Mississippi","Jasper County",17062,"","Jasper County Mississippi",17670,19348,608,3.56347438752784,3.56347438752784,2286,13.3981948188958,13.3981948188958
"28","063","G2800630","2010","3","6","Mississippi","Jefferson County",7726,"","Jefferson County Mississippi",8860,10460,1134,14.6777116230909,14.6777116230909,2734,35.3870049184572,35.3870049184572
"28","065","G2800650","2010","3","6","Mississippi","Jefferson Davis County",12487,"","Jefferson Davis County Mississippi",12455,14796,-32,-0.256266517177865,0.256266517177865,2309,18.4912308801153,18.4912308801153
"28","067","G2800670","2010","3","6","Mississippi","Jones County",67761,"","Jones County Mississippi",68120,68640,359,0.529803279172385,0.529803279172385,879,1.29720635763935,1.29720635763935
"28","069","G2800690","2010","3","6","Mississippi","Kemper County",10456,"","Kemper County Mississippi",9839,11190,-617,-5.9009181331293,5.9009181331293,734,7.01989288446825,7.01989288446825
"28","071","G2800710","2010","3","6","Mississippi","Lafayette County",47351,"","Lafayette County Mississippi",44755,45721,-2596,-5.48246077168381,5.48246077168381,-1630,-3.44237714092627,3.44237714092627
"28","073","G2800730","2010","3","6","Mississippi","Lamar County",55658,"","Lamar County Mississippi",51958,43985,-3700,-6.64774156455496,6.64774156455496,-11673,-20.9727262927162,20.9727262927162
"28","075","G2800750","2010","3","6","Mississippi","Lauderdale County",80261,"","Lauderdale County Mississippi",78775,83852,-1486,-1.85145961301255,1.85145961301255,3591,4.47415307559088,4.47415307559088
"28","077","G2800770","2010","3","6","Mississippi","Lawrence County",12929,"","Lawrence County Mississippi",13122,13858,193,1.49276819552943,1.49276819552943,929,7.18539716915461,7.18539716915461
"28","079","G2800790","2010","3","6","Mississippi","Leake County",23805,"","Leake County Mississippi",23050,22411,-755,-3.17160260449485,3.17160260449485,-1394,-5.85591262339845,5.85591262339845
"28","081","G2800810","2010","3","6","Mississippi","Lee County",82910,"","Lee County Mississippi",82252,81262,-658,-0.793631648775781,0.793631648775781,-1648,-1.98769750331685,1.98769750331685
"28","083","G2800830","2010","3","6","Mississippi","Leflore County",32317,"","Leflore County Mississippi",34524,41001,2207,6.82922300956153,6.82922300956153,8684,26.871306123712,26.871306123712
"28","085","G2800850","2010","3","6","Mississippi","Lincoln County",34869,"","Lincoln County Mississippi",34808,35051,-61,-0.174940491554102,0.174940491554102,182,0.521953597751585,0.521953597751585
"28","087","G2800870","2010","3","6","Mississippi","Lowndes County",59779,"","Lowndes County Mississippi",59913,67164,134,0.224158985596949,0.224158985596949,7385,12.353836631593,12.353836631593
"28","089","G2800890","2010","3","6","Mississippi","Madison County",95203,"","Madison County Mississippi",94300,99005,-903,-0.948499522073884,0.948499522073884,3802,3.99357163114608,3.99357163114608
"28","091","G2800910","2010","3","6","Mississippi","Marion County",27088,"","Marion County Mississippi",25707,27084,-1381,-5.09819846426462,5.09819846426462,-4,-0.0147666863555818,0.0147666863555818
"28","093","G2800930","2010","3","6","Mississippi","Marshall County",37144,"","Marshall County Mississippi",36614,39819,-530,-1.42687917294852,1.42687917294852,2675,7.20170148610812,7.20170148610812
"28","095","G2800950","2010","3","6","Mississippi","Monroe County",36989,"","Monroe County Mississippi",36640,39892,-349,-0.943523750304144,0.943523750304144,2903,7.84827921814594,7.84827921814594
"28","097","G2800970","2010","3","6","Mississippi","Montgomery County",10925,"","Montgomery County Mississippi",11161,14187,236,2.16018306636156,2.16018306636156,3262,29.858123569794,29.858123569794
"28","099","G2800990","2010","3","6","Mississippi","Neshoba County",29676,"","Neshoba County Mississippi",30340,30855,664,2.23749831513681,2.23749831513681,1179,3.97290739991913,3.97290739991913
"28","101","G2801010","2010","3","6","Mississippi","Newton County",21720,"","Newton County Mississippi",22481,23211,761,3.5036832412523,3.5036832412523,1491,6.8646408839779,6.8646408839779
"28","103","G2801030","2010","3","6","Mississippi","Noxubee County",11545,"","Noxubee County Mississippi",11552,13328,7,0.0606323083585968,0.0606323083585968,1783,15.4439151147683,15.4439151147683
"28","105","G2801050","2010","3","6","Mississippi","Oktibbeha County",47671,"","Oktibbeha County Mississippi",44767,51101,-2904,-6.09175389649892,6.09175389649892,3430,7.19515009125045,7.19515009125045
"28","107","G2801070","2010","3","6","Mississippi","Panola County",34707,"","Panola County Mississippi",35201,37281,494,1.42334399400697,1.42334399400697,2574,7.41637133719423,7.41637133719423
"28","109","G2801090","2010","3","6","Mississippi","Pearl River County",55834,"","Pearl River County Mississippi",57266,61261,1432,2.56474549557617,2.56474549557617,5427,9.71988394168428,9.71988394168428
"28","111","G2801110","2010","3","6","Mississippi","Perry County",12250,"","Perry County Mississippi",12039,12707,-211,-1.72244897959184,1.72244897959184,457,3.73061224489796,3.73061224489796
"28","113","G2801130","2010","3","6","Mississippi","Pike County",40404,"","Pike County Mississippi",39989,41717,-415,-1.02712602712603,1.02712602712603,1313,3.24967824967825,3.24967824967825
"28","115","G2801150","2010","3","6","Mississippi","Pontotoc County",29957,"","Pontotoc County Mississippi",29525,28986,-432,-1.44206696264646,1.44206696264646,-971,-3.24131254798545,3.24131254798545
"28","117","G2801170","2010","3","6","Mississippi","Prentiss County",25276,"","Prentiss County Mississippi",25468,27239,192,0.759613862952999,0.759613862952999,1963,7.76626048425384,7.76626048425384
"28","119","G2801190","2010","3","6","Mississippi","Quitman County",8223,"","Quitman County Mississippi",8339,10345,116,1.41067736835705,1.41067736835705,2122,25.805667031497,25.805667031497
"28","121","G2801210","2010","3","6","Mississippi","Rankin County",141617,"","Rankin County Mississippi",144359,146041,2742,1.93620822358898,1.93620822358898,4424,3.12391873856952,3.12391873856952
"28","123","G2801230","2010","3","6","Mississippi","Scott County",28264,"","Scott County Mississippi",29814,30362,1550,5.48400792527597,5.48400792527597,2098,7.42287008208322,7.42287008208322
"28","125","G2801250","2010","3","6","Mississippi","Sharkey County",4916,"","Sharkey County Mississippi",5245,6925,329,6.69243287225386,6.69243287225386,2009,40.86655817738,40.86655817738
"28","127","G2801270","2010","3","6","Mississippi","Simpson County",27503,"","Simpson County Mississippi",27958,29072,455,1.654364978366,1.654364978366,1569,5.70483220012362,5.70483220012362
"28","129","G2801290","2010","3","6","Mississippi","Smith County",16491,"","Smith County Mississippi",15743,17239,-748,-4.53580741010248,4.53580741010248,748,4.53580741010248,4.53580741010248
"28","131","G2801310","2010","3","6","Mississippi","Stone County",17786,"","Stone County Mississippi",16857,15295,-929,-5.22320926571461,5.22320926571461,-2491,-14.0053975036546,14.0053975036546
"28","133","G2801330","2010","3","6","Mississippi","Sunflower County",29450,"","Sunflower County Mississippi",29161,35967,-289,-0.98132427843803,0.98132427843803,6517,22.1290322580645,22.1290322580645
"28","135","G2801350","2010","3","6","Mississippi","Tallahatchie County",15378,"","Tallahatchie County Mississippi",12560,15893,-2818,-18.3248796982703,18.3248796982703,515,3.34894004421901,3.34894004421901
"28","137","G2801370","2010","3","6","Mississippi","Tate County",28886,"","Tate County Mississippi",27667,30364,-1219,-4.22003738835422,4.22003738835422,1478,5.11666551270512,5.11666551270512
"28","139","G2801390","2010","3","6","Mississippi","Tippah County",22232,"","Tippah County Mississippi",21742,22340,-490,-2.20403022670025,2.20403022670025,108,0.485786254048219,0.485786254048219
"28","141","G2801410","2010","3","6","Mississippi","Tishomingo County",19593,"","Tishomingo County Mississippi",19054,20202,-539,-2.75098249374777,2.75098249374777,609,3.10825294748124,3.10825294748124
"28","143","G2801430","2010","3","6","Mississippi","Tunica County",10778,"","Tunica County Mississippi",10327,11379,-451,-4.18444980515866,4.18444980515866,601,5.57617368714047,5.57617368714047
"28","145","G2801450","2010","3","6","Mississippi","Union County",27134,"","Union County Mississippi",27446,26999,312,1.14984889806147,1.14984889806147,-135,-0.497530773199676,0.497530773199676
"28","147","G2801470","2010","3","6","Mississippi","Walthall County",15443,"","Walthall County Mississippi",15238,16386,-205,-1.32746228064495,1.32746228064495,943,6.10632649096678,6.10632649096678
"28","149","G2801490","2010","3","6","Mississippi","Warren County",48773,"","Warren County Mississippi",48522,51688,-251,-0.514628995550817,0.514628995550817,2915,5.97666741844873,5.97666741844873
"28","151","G2801510","2010","3","6","Mississippi","Washington County",51137,"","Washington County Mississippi",54510,65285,3373,6.59600680524865,6.59600680524865,14148,27.6668557013513,27.6668557013513
"28","153","G2801530","2010","3","6","Mississippi","Wayne County",20747,"","Wayne County Mississippi",20757,22659,10,0.0481997397214055,0.0481997397214055,1912,9.21579023473273,9.21579023473273
"28","155","G2801550","2010","3","6","Mississippi","Webster County",10253,"","Webster County Mississippi",9862,10872,-391,-3.81351799473325,3.81351799473325,619,6.03725738808154,6.03725738808154
"28","157","G2801570","2010","3","6","Mississippi","Wilkinson County",9878,"","Wilkinson County Mississippi",10053,11128,175,1.77161368698117,1.77161368698117,1250,12.6543834784369,12.6543834784369
"28","159","G2801590","2010","3","6","Mississippi","Winston County",19198,"","Winston County Mississippi",19340,21289,142,0.739660381289718,0.739660381289718,2091,10.8917595582873,10.8917595582873
"28","161","G2801610","2010","3","6","Mississippi","Yalobusha County",12678,"","Yalobusha County Mississippi",13654,14194,976,7.69837513803439,7.69837513803439,1516,11.9577220381764,11.9577220381764
"28","163","G2801630","2010","3","6","Mississippi","Yazoo County",28065,"","Yazoo County Mississippi",27653,29442,-412,-1.46802066631035,1.46802066631035,1377,4.90646712987707,4.90646712987707
"29","001","G2900010","2010","2","4","Missouri","Adair County",25607,"","Adair County Missouri",25128,26302,-479,-1.87058226266255,1.87058226266255,695,2.71410161284024,2.71410161284024
"29","003","G2900030","2010","2","4","Missouri","Andrew County",17291,"","Andrew County Missouri",17281,17378,-10,-0.0578335550286276,0.0578335550286276,87,0.50315192874906,0.50315192874906
"29","005","G2900050","2010","2","4","Missouri","Atchison County",5685,"","Atchison County Missouri",5921,6461,236,4.15127528583993,4.15127528583993,776,13.6499560246262,13.6499560246262
"29","007","G2900070","2010","2","4","Missouri","Audrain County",25529,"","Audrain County Missouri",25269,26408,-260,-1.01844960633006,1.01844960633006,879,3.44314309216969,3.44314309216969
"29","009","G2900090","2010","2","4","Missouri","Barry County",35597,"","Barry County Missouri",35916,36163,319,0.896142933393263,0.896142933393263,566,1.59002163103632,1.59002163103632
"29","011","G2900110","2010","2","4","Missouri","Barton County",12402,"","Barton County Missouri",12306,13069,-96,-0.774068698597,0.774068698597,667,5.37816481212708,5.37816481212708
"29","013","G2900130","2010","2","4","Missouri","Bates County",17049,"","Bates County Missouri",16724,17372,-325,-1.90627016247287,1.90627016247287,323,1.89453926916535,1.89453926916535
"29","015","G2900150","2010","2","4","Missouri","Benton County",19056,"","Benton County Missouri",18397,17820,-659,-3.45822837951301,3.45822837951301,-1236,-6.48614609571788,6.48614609571788
"29","017","G2900170","2010","2","4","Missouri","Bollinger County",12363,"","Bollinger County Missouri",11762,12358,-601,-4.86127962468656,4.86127962468656,-5,-0.0404432581088733,0.0404432581088733
"29","019","G2900190","2010","2","4","Missouri","Boone County",162642,"","Boone County Missouri",158108,169738,-4534,-2.78771780966786,2.78771780966786,7096,4.36295667785689,4.36295667785689
"29","021","G2900210","2010","2","4","Missouri","Buchanan County",89201,"","Buchanan County Missouri",89866,88002,665,0.745507337361689,0.745507337361689,-1199,-1.34415533458145,1.34415533458145
"29","023","G2900230","2010","2","4","Missouri","Butler County",42794,"","Butler County Missouri",41502,42177,-1292,-3.01911482918166,3.01911482918166,-617,-1.44179090526709,1.44179090526709
"29","025","G2900250","2010","2","4","Missouri","Caldwell County",9424,"","Caldwell County Missouri",9214,9461,-210,-2.22835314091681,2.22835314091681,37,0.392614601018676,0.392614601018676
"29","027","G2900270","2010","2","4","Missouri","Callaway County",44332,"","Callaway County Missouri",44062,44360,-270,-0.609040873409727,0.609040873409727,28,0.0631597942795272,0.0631597942795272
"29","029","G2900290","2010","2","4","Missouri","Camden County",44002,"","Camden County Missouri",40433,39494,-3569,-8.11099495477478,8.11099495477478,-4508,-10.2449888641425,10.2449888641425
"29","031","G2900310","2010","2","4","Missouri","Cape Girardeau County",75674,"","Cape Girardeau County Missouri",74562,73674,-1112,-1.469461109496,1.469461109496,-2000,-2.64291566456114,2.64291566456114
"29","033","G2900330","2010","2","4","Missouri","Carroll County",9295,"","Carroll County Missouri",9599,10583,304,3.27057557826789,3.27057557826789,1288,13.8569123184508,13.8569123184508
"29","035","G2900350","2010","2","4","Missouri","Carter County",6265,"","Carter County Missouri",6026,6181,-239,-3.81484437350359,3.81484437350359,-84,-1.34078212290503,1.34078212290503
"29","037","G2900370","2010","2","4","Missouri","Cass County",99478,"","Cass County Missouri",100904,103010,1426,1.43348278011219,1.43348278011219,3532,3.55053378636482,3.55053378636482
"29","039","G2900390","2010","2","4","Missouri","Cedar County",13982,"","Cedar County Missouri",13426,14307,-556,-3.97654126734373,3.97654126734373,325,2.32441710770991,2.32441710770991
"29","041","G2900410","2010","2","4","Missouri","Chariton County",7831,"","Chariton County Missouri",7626,8700,-205,-2.61780104712042,2.61780104712042,869,11.0969224875495,11.0969224875495
"29","043","G2900430","2010","2","4","Missouri","Christian County",77422,"","Christian County Missouri",78655,76956,1233,1.5925705871716,1.5925705871716,-466,-0.601896101883186,0.601896101883186
"29","045","G2900450","2010","2","4","Missouri","Clark County",7139,"","Clark County Missouri",7124,7663,-15,-0.210113461269085,0.210113461269085,524,7.33996358033338,7.33996358033338
"29","047","G2900470","2010","2","4","Missouri","Clay County",221939,"","Clay County Missouri",229855,229390,7916,3.56674581754446,3.56674581754446,7451,3.35722878809042,3.35722878809042
"29","049","G2900490","2010","2","4","Missouri","Clinton County",20743,"","Clinton County Missouri",21086,21704,343,1.65356987899532,1.65356987899532,961,4.63288820324929,4.63288820324929
"29","051","G2900510","2010","2","4","Missouri","Cole County",75990,"","Cole County Missouri",75747,80081,-243,-0.319778918278721,0.319778918278721,4091,5.3836031056718,5.3836031056718
"29","053","G2900530","2010","2","4","Missouri","Cooper County",17601,"","Cooper County Missouri",17482,17794,-119,-0.676097948980172,0.676097948980172,193,1.09652860632919,1.09652860632919
"29","055","G2900550","2010","2","4","Missouri","Crawford County",24696,"","Crawford County Missouri",23726,24031,-970,-3.92776158082281,3.92776158082281,-665,-2.69274376417234,2.69274376417234
"29","057","G2900570","2010","2","4","Missouri","Dade County",7883,"","Dade County Missouri",7320,8127,-563,-7.14195103387035,7.14195103387035,244,3.09526829887099,3.09526829887099
"29","059","G2900590","2010","2","4","Missouri","Dallas County",16777,"","Dallas County Missouri",16663,16610,-114,-0.679501698754247,0.679501698754247,-167,-0.9954103832628,0.9954103832628
"29","061","G2900610","2010","2","4","Missouri","Daviess County",8433,"","Daviess County Missouri",8073,8276,-360,-4.26894343649947,4.26894343649947,-157,-1.86173366536227,1.86173366536227
"29","063","G2900630","2010","2","4","Missouri","DeKalb County",12892,"","DeKalb County Missouri",12229,14333,-663,-5.14272417002792,5.14272417002792,1441,11.1774744027304,11.1774744027304
"29","065","G2900650","2010","2","4","Missouri","Dent County",15657,"","Dent County Missouri",15151,15406,-506,-3.23178131187328,3.23178131187328,-251,-1.60311681675928,1.60311681675928
"29","067","G2900670","2010","2","4","Missouri","Douglas County",13684,"","Douglas County Missouri",13415,13657,-269,-1.96579947383806,1.96579947383806,-27,-0.197310727857352,0.197310727857352
"29","069","G2900690","2010","2","4","Missouri","Dunklin County",31953,"","Dunklin County Missouri",31065,34141,-888,-2.77908177635903,2.77908177635903,2188,6.8475573498576,6.8475573498576
"29","071","G2900710","2010","2","4","Missouri","Franklin County",101492,"","Franklin County Missouri",101289,107261,-203,-0.200015764789343,0.200015764789343,5769,5.6841918574863,5.6841918574863
"29","073","G2900730","2010","2","4","Missouri","Gasconade County",15222,"","Gasconade County Missouri",15172,16014,-50,-0.328471948495598,0.328471948495598,792,5.20299566417028,5.20299566417028
"29","075","G2900750","2010","2","4","Missouri","Gentry County",6738,"","Gentry County Missouri",6047,6984,-691,-10.255268625705,10.255268625705,246,3.65093499554764,3.65093499554764
"29","077","G2900770","2010","2","4","Missouri","Greene County",275174,"","Greene County Missouri",269261,287734,-5913,-2.14882219977178,2.14882219977178,12560,4.56438471657933,4.56438471657933
"29","079","G2900790","2010","2","4","Missouri","Grundy County",10261,"","Grundy County Missouri",10243,10800,-18,-0.175421498879252,0.175421498879252,539,5.25289932755092,5.25289932755092
"29","081","G2900810","2010","2","4","Missouri","Harrison County",8957,"","Harrison County Missouri",8699,9114,-258,-2.88042871497153,2.88042871497153,157,1.75281902422686,1.75281902422686
"29","083","G2900830","2010","2","4","Missouri","Henry County",22272,"","Henry County Missouri",22184,23015,-88,-0.395114942528736,0.395114942528736,743,3.33602729885057,3.33602729885057
"29","085","G2900850","2010","2","4","Missouri","Hickory County",9627,"","Hickory County Missouri",8867,9379,-760,-7.89446348810637,7.89446348810637,-248,-2.5760880855926,2.5760880855926
"29","087","G2900870","2010","2","4","Missouri","Holt County",4912,"","Holt County Missouri",4868,5528,-44,-0.895765472312704,0.895765472312704,616,12.5407166123778,12.5407166123778
"29","089","G2900890","2010","2","4","Missouri","Howard County",10144,"","Howard County Missouri",9804,10469,-340,-3.35173501577287,3.35173501577287,325,3.2038643533123,3.2038643533123
"29","091","G2900910","2010","2","4","Missouri","Howell County",40400,"","Howell County Missouri",39299,39956,-1101,-2.72524752475248,2.72524752475248,-444,-1.0990099009901,1.0990099009901
"29","093","G2900930","2010","2","4","Missouri","Iron County",10630,"","Iron County Missouri",9787,11064,-843,-7.93038570084666,7.93038570084666,434,4.08278457196613,4.08278457196613
"29","095","G2900950","2010","2","4","Missouri","Jackson County",674158,"","Jackson County Missouri",709346,709316,35188,5.21954793980046,5.21954793980046,35158,5.21509794439879,5.21509794439879
"29","097","G2900970","2010","2","4","Missouri","Jasper County",117404,"","Jasper County Missouri",119330,114053,1926,1.64048925079214,1.64048925079214,-3351,-2.85424687404177,2.85424687404177
"29","099","G2900990","2010","2","4","Missouri","Jefferson County",218733,"","Jefferson County Missouri",219710,232680,977,0.446663283546607,0.446663283546607,13947,6.37626695560341,6.37626695560341
"29","101","G2901010","2010","2","4","Missouri","Johnson County",52595,"","Johnson County Missouri",52583,53588,-12,-0.0228158570206293,0.0228158570206293,993,1.88801216845708,1.88801216845708
"29","103","G2901030","2010","2","4","Missouri","Knox County",4131,"","Knox County Missouri",3977,4471,-154,-3.7279109174534,3.7279109174534,340,8.23045267489712,8.23045267489712
"29","105","G2901050","2010","2","4","Missouri","Laclede County",35571,"","Laclede County Missouri",35554,35713,-17,-0.0477917404627365,0.0477917404627365,142,0.399201596806387,0.399201596806387
"29","107","G2901070","2010","2","4","Missouri","Lafayette County",33381,"","Lafayette County Missouri",32694,35152,-687,-2.05805697852072,2.05805697852072,1771,5.30541325903957,5.30541325903957
"29","109","G2901090","2010","2","4","Missouri","Lawrence County",38634,"","Lawrence County Missouri",37678,37114,-956,-2.47450432261738,2.47450432261738,-1520,-3.93435833721592,3.93435833721592
"29","111","G2901110","2010","2","4","Missouri","Lewis County",10211,"","Lewis County Missouri",9812,10906,-399,-3.90755068063853,3.90755068063853,695,6.80638527078641,6.80638527078641
"29","113","G2901130","2010","2","4","Missouri","Lincoln County",52566,"","Lincoln County Missouri",53642,44866,1076,2.0469505003234,2.0469505003234,-7700,-14.6482517216452,14.6482517216452
"29","115","G2901150","2010","2","4","Missouri","Linn County",12761,"","Linn County Missouri",12615,13972,-146,-1.14411096309067,1.14411096309067,1211,9.48985189248491,9.48985189248491
"29","117","G2901170","2010","2","4","Missouri","Livingston County",15195,"","Livingston County Missouri",14196,15334,-999,-6.57453109575518,6.57453109575518,139,0.914774596906877,0.914774596906877
"29","119","G2901190","2010","2","4","Missouri","McDonald County",23083,"","McDonald County Missouri",23065,22707,-18,-0.0779794654074427,0.0779794654074427,-376,-1.62890438851103,1.62890438851103
"29","121","G2901210","2010","2","4","Missouri","Macon County",15566,"","Macon County Missouri",15474,16212,-92,-0.591031735834511,0.591031735834511,646,4.15007066683798,4.15007066683798
"29","123","G2901230","2010","2","4","Missouri","Madison County",12226,"","Madison County Missouri",12263,12419,37,0.302633731392115,0.302633731392115,193,1.57860297726157,1.57860297726157
"29","125","G2901250","2010","2","4","Missouri","Maries County",9176,"","Maries County Missouri",8866,9302,-310,-3.37837837837838,3.37837837837838,126,1.37314734088928,1.37314734088928
"29","127","G2901270","2010","2","4","Missouri","Marion County",28781,"","Marion County Missouri",28444,29240,-337,-1.17091136513672,1.17091136513672,459,1.59480212640284,1.59480212640284
"29","129","G2901290","2010","2","4","Missouri","Mercer County",3785,"","Mercer County Missouri",3441,3860,-344,-9.0885072655218,9.0885072655218,75,1.98150594451783,1.98150594451783
"29","131","G2901310","2010","2","4","Missouri","Miller County",24748,"","Miller County Missouri",24681,25189,-67,-0.270728947793761,0.270728947793761,441,1.78196217876192,1.78196217876192
"29","133","G2901330","2010","2","4","Missouri","Mississippi County",14358,"","Mississippi County Missouri",13319,13711,-1039,-7.23638389747876,7.23638389747876,-647,-4.50619863490737,4.50619863490737
"29","135","G2901350","2010","2","4","Missouri","Moniteau County",15607,"","Moniteau County Missouri",15207,15350,-400,-2.56295252130454,2.56295252130454,-257,-1.64669699493817,1.64669699493817
"29","137","G2901370","2010","2","4","Missouri","Monroe County",8840,"","Monroe County Missouri",8796,10129,-44,-0.497737556561086,0.497737556561086,1289,14.5814479638009,14.5814479638009
"29","139","G2901390","2010","2","4","Missouri","Montgomery County",12236,"","Montgomery County Missouri",11750,13349,-486,-3.97188623733246,3.97188623733246,1113,9.09610983981693,9.09610983981693
"29","141","G2901410","2010","2","4","Missouri","Morgan County",20565,"","Morgan County Missouri",20532,20049,-33,-0.160466812545587,0.160466812545587,-516,-2.509117432531,2.509117432531
"29","143","G2901430","2010","2","4","Missouri","New Madrid County",18956,"","New Madrid County Missouri",17373,20533,-1583,-8.35091791517198,8.35091791517198,1577,8.31926566786242,8.31926566786242
"29","145","G2901450","2010","2","4","Missouri","Newton County",58114,"","Newton County Missouri",56150,55767,-1964,-3.3795643046426,3.3795643046426,-2347,-4.03861375916302,4.03861375916302
"29","147","G2901470","2010","2","4","Missouri","Nodaway County",23370,"","Nodaway County Missouri",22207,23581,-1163,-4.97646555412923,4.97646555412923,211,0.902866923406076,0.902866923406076
"29","149","G2901490","2010","2","4","Missouri","Oregon County",10881,"","Oregon County Missouri",10410,10628,-471,-4.32864626413013,4.32864626413013,-253,-2.32515393805716,2.32515393805716
"29","151","G2901510","2010","2","4","Missouri","Osage County",13878,"","Osage County Missouri",13442,13467,-436,-3.14166306384205,3.14166306384205,-411,-2.96152183311716,2.96152183311716
"29","153","G2901530","2010","2","4","Missouri","Ozark County",9723,"","Ozark County Missouri",9312,9952,-411,-4.22709040419624,4.22709040419624,229,2.35524015221639,2.35524015221639
"29","155","G2901550","2010","2","4","Missouri","Pemiscot County",18296,"","Pemiscot County Missouri",18136,20522,-160,-0.874508089199825,0.874508089199825,2226,12.1665937909926,12.1665937909926
"29","157","G2901570","2010","2","4","Missouri","Perry County",18971,"","Perry County Missouri",18683,19144,-288,-1.51810658373307,1.51810658373307,173,0.911918190922988,0.911918190922988
"29","159","G2901590","2010","2","4","Missouri","Pettis County",42201,"","Pettis County Missouri",41689,40489,-512,-1.21324139238407,1.21324139238407,-1712,-4.05677590578422,4.05677590578422
"29","161","G2901610","2010","2","4","Missouri","Phelps County",45156,"","Phelps County Missouri",42672,44190,-2484,-5.50093010895562,5.50093010895562,-966,-2.13925059792719,2.13925059792719
"29","163","G2901630","2010","2","4","Missouri","Pike County",18516,"","Pike County Missouri",18454,19003,-62,-0.334845538993303,0.334845538993303,487,2.6301577014474,2.6301577014474
"29","165","G2901650","2010","2","4","Missouri","Platte County",89322,"","Platte County Missouri",91662,92658,2340,2.619735339558,2.619735339558,3336,3.73480217639551,3.73480217639551
"29","167","G2901670","2010","2","4","Missouri","Polk County",31137,"","Polk County Missouri",30547,29478,-590,-1.89485178405113,1.89485178405113,-1659,-5.32806628769631,5.32806628769631
"29","169","G2901690","2010","2","4","Missouri","Pulaski County",52274,"","Pulaski County Missouri",46150,44734,-6124,-11.7151930213873,11.7151930213873,-7540,-14.4239966331255,14.4239966331255
"29","171","G2901710","2010","2","4","Missouri","Putnam County",4979,"","Putnam County Missouri",4751,5392,-228,-4.5792327776662,4.5792327776662,413,8.29483832094798,8.29483832094798
"29","173","G2901730","2010","2","4","Missouri","Ralls County",10167,"","Ralls County Missouri",9591,9984,-576,-5.66538802006492,5.66538802006492,-183,-1.79994098554146,1.79994098554146
"29","175","G2901750","2010","2","4","Missouri","Randolph County",25414,"","Randolph County Missouri",25517,25657,103,0.405288423703471,0.405288423703471,243,0.956165892814984,0.956165892814984
"29","177","G2901770","2010","2","4","Missouri","Ray County",23494,"","Ray County Missouri",23304,25603,-190,-0.808717119264493,0.808717119264493,2109,8.97676002383587,8.97676002383587
"29","179","G2901790","2010","2","4","Missouri","Reynolds County",6696,"","Reynolds County Missouri",6240,6945,-456,-6.81003584229391,6.81003584229391,249,3.71863799283154,3.71863799283154
"29","181","G2901810","2010","2","4","Missouri","Ripley County",14100,"","Ripley County Missouri",13413,14036,-687,-4.87234042553191,4.87234042553191,-64,-0.453900709219858,0.453900709219858
"29","183","G2901830","2010","2","4","Missouri","St. Charles County",360485,"","St. Charles County Missouri",357549,374500,-2936,-0.814458299235752,0.814458299235752,14015,3.88781780101807,3.88781780101807
"29","185","G2901850","2010","2","4","Missouri","St. Clair County",9805,"","St. Clair County Missouri",9317,10067,-488,-4.97705252422234,4.97705252422234,262,2.67210606833248,2.67210606833248
"29","186","G2901860","2010","2","4","Missouri","Ste. Genevieve County",18145,"","Ste. Genevieve County Missouri",17620,18449,-525,-2.89335905208046,2.89335905208046,304,1.67539267015707,1.67539267015707
"29","187","G2901870","2010","2","4","Missouri","St. Francois County",65359,"","St. Francois County Missouri",64136,61263,-1223,-1.87120365978672,1.87120365978672,-4096,-6.26692574855796,6.26692574855796
"29","189","G2901890","2010","2","4","Missouri","St. Louis County",998954,"","St. Louis County Missouri",992030,1045264,-6924,-0.693125008759162,0.693125008759162,46310,4.63584909815667,4.63584909815667
"29","195","G2901950","2010","2","4","Missouri","Saline County",23370,"","Saline County Missouri",22976,24468,-394,-1.68592212237912,1.68592212237912,1098,4.69833119383825,4.69833119383825
"29","197","G2901970","2010","2","4","Missouri","Schuyler County",4431,"","Schuyler County Missouri",4125,4463,-306,-6.90589031821259,6.90589031821259,32,0.722184608440533,0.722184608440533
"29","199","G2901990","2010","2","4","Missouri","Scotland County",4843,"","Scotland County Missouri",4804,5081,-39,-0.805285979764609,0.805285979764609,238,4.91430931240966,4.91430931240966
"29","201","G2902010","2010","2","4","Missouri","Scott County",39191,"","Scott County Missouri",41073,42284,1882,4.80212293638846,4.80212293638846,3093,7.89211808833661,7.89211808833661
"29","203","G2902030","2010","2","4","Missouri","Shannon County",8441,"","Shannon County Missouri",8338,8655,-103,-1.22023456936382,1.22023456936382,214,2.53524463926075,2.53524463926075
"29","205","G2902050","2010","2","4","Missouri","Shelby County",6373,"","Shelby County Missouri",6314,6957,-59,-0.925780637062608,0.925780637062608,584,9.16365918719598,9.16365918719598
"29","207","G2902070","2010","2","4","Missouri","Stoddard County",29968,"","Stoddard County Missouri",29225,31005,-743,-2.47931126534971,2.47931126534971,1037,3.46035771489589,3.46035771489589
"29","209","G2902090","2010","2","4","Missouri","Stone County",32202,"","Stone County Missouri",31317,33123,-885,-2.74827650456493,2.74827650456493,921,2.86007080305571,2.86007080305571
"29","211","G2902110","2010","2","4","Missouri","Sullivan County",6714,"","Sullivan County Missouri",6809,7436,95,1.41495382782246,1.41495382782246,722,10.7536490914507,10.7536490914507
"29","213","G2902130","2010","2","4","Missouri","Taney County",51675,"","Taney County Missouri",48693,54493,-2982,-5.77068214804064,5.77068214804064,2818,5.45331398161587,5.45331398161587
"29","215","G2902150","2010","2","4","Missouri","Texas County",26008,"","Texas County Missouri",24611,23971,-1397,-5.37142417717625,5.37142417717625,-2037,-7.83220547523839,7.83220547523839
"29","217","G2902170","2010","2","4","Missouri","Vernon County",21159,"","Vernon County Missouri",20248,21095,-911,-4.30549647903965,4.30549647903965,-64,-0.302471761425398,0.302471761425398
"29","219","G2902190","2010","2","4","Missouri","Warren County",32513,"","Warren County Missouri",31567,31965,-946,-2.90960538861379,2.90960538861379,-548,-1.68547965429213,1.68547965429213
"29","221","G2902210","2010","2","4","Missouri","Washington County",25195,"","Washington County Missouri",24479,24314,-716,-2.84183369716213,2.84183369716213,-881,-3.4967255407819,3.4967255407819
"29","223","G2902230","2010","2","4","Missouri","Wayne County",13521,"","Wayne County Missouri",12353,13859,-1168,-8.63841431846757,8.63841431846757,338,2.49981510243325,2.49981510243325
"29","225","G2902250","2010","2","4","Missouri","Webster County",36202,"","Webster County Missouri",36889,34627,687,1.89768521076184,1.89768521076184,-1575,-4.35058836528369,4.35058836528369
"29","227","G2902270","2010","2","4","Missouri","Worth County",2171,"","Worth County Missouri",1966,2411,-205,-9.442653155228,9.442653155228,240,11.054813450023,11.054813450023
"29","229","G2902290","2010","2","4","Missouri","Wright County",18815,"","Wright County Missouri",17971,18467,-844,-4.4857826202498,4.4857826202498,-348,-1.84958809460537,1.84958809460537
"29","510","G2905100","2010","2","4","Missouri","St. Louis city",319294,"","St. Louis city Missouri",356141,358025,36847,11.5401479514178,11.5401479514178,38731,12.1301997532055,12.1301997532055
"30","001","G3000010","2010","4","8","Montana","Beaverhead County",9246,"","Beaverhead County Montana",9040,9305,-206,-2.22799048237076,2.22799048237076,59,0.63811377893143,0.63811377893143
"30","003","G3000030","2010","4","8","Montana","Big Horn County",12865,"","Big Horn County Montana",13180,12725,315,2.44850369218811,2.44850369218811,-140,-1.08822386319471,1.08822386319471
"30","005","G3000050","2010","4","8","Montana","Blaine County",6491,"","Blaine County Montana",6502,6969,11,0.169465413649669,0.169465413649669,478,7.36404252041288,7.36404252041288
"30","007","G3000070","2010","4","8","Montana","Broadwater County",5612,"","Broadwater County Montana",4851,4419,-761,-13.56022808268,13.56022808268,-1193,-21.2580185317177,21.2580185317177
"30","009","G3000090","2010","4","8","Montana","Carbon County",10078,"","Carbon County Montana",9757,10056,-321,-3.18515578487795,3.18515578487795,-22,-0.218297281206589,0.218297281206589
"30","011","G3000110","2010","4","8","Montana","Carter County",1160,"","Carter County Montana",1182,1346,22,1.89655172413793,1.89655172413793,186,16.0344827586207,16.0344827586207
"30","013","G3000130","2010","4","8","Montana","Cascade County",81327,"","Cascade County Montana",82135,83100,808,0.993519987212119,0.993519987212119,1773,2.18008779372164,2.18008779372164
"30","015","G3000150","2010","4","8","Montana","Chouteau County",5813,"","Chouteau County Montana",5172,6003,-641,-11.0270084293824,11.0270084293824,190,3.26853603991055,3.26853603991055
"30","017","G3000170","2010","4","8","Montana","Custer County",11699,"","Custer County Montana",11213,11644,-486,-4.15420121377896,4.15420121377896,-55,-0.470125651765108,0.470125651765108
"30","019","G3000190","2010","4","8","Montana","Daniels County",1751,"","Daniels County Montana",1718,2000,-33,-1.88463735008567,1.88463735008567,249,14.2204454597373,14.2204454597373
"30","021","G3000210","2010","4","8","Montana","Dawson County",8966,"","Dawson County Montana",8518,9024,-448,-4.99665402632166,4.99665402632166,58,0.646888244479143,0.646888244479143
"30","023","G3000230","2010","4","8","Montana","Deer Lodge County",9298,"","Deer Lodge County Montana",8724,9644,-574,-6.17337061733706,6.17337061733706,346,3.72123037212304,3.72123037212304
"30","025","G3000250","2010","4","8","Montana","Fallon County",2890,"","Fallon County Montana",2711,2835,-179,-6.19377162629758,6.19377162629758,-55,-1.90311418685121,1.90311418685121
"30","027","G3000270","2010","4","8","Montana","Fergus County",11586,"","Fergus County Montana",11277,11841,-309,-2.66701191092698,2.66701191092698,255,2.20093215950285,2.20093215950285
"30","029","G3000290","2010","4","8","Montana","Flathead County",90928,"","Flathead County Montana",89652,82300,-1276,-1.40330811191272,1.40330811191272,-8628,-9.48882632412458,9.48882632412458
"30","031","G3000310","2010","4","8","Montana","Gallatin County",89513,"","Gallatin County Montana",90710,90292,1197,1.33723593221096,1.33723593221096,779,0.870264654296024,0.870264654296024
"30","033","G3000330","2010","4","8","Montana","Garfield County",1206,"","Garfield County Montana",1155,1276,-51,-4.22885572139304,4.22885572139304,70,5.80431177446103,5.80431177446103
"30","035","G3000350","2010","4","8","Montana","Glacier County",13399,"","Glacier County Montana",13665,13179,266,1.98522277781924,1.98522277781924,-220,-1.64191357563997,1.64191357563997
"30","037","G3000370","2010","4","8","Montana","Golden Valley County",884,"","Golden Valley County Montana",1072,1028,188,21.2669683257919,21.2669683257919,144,16.289592760181,16.289592760181
"30","039","G3000390","2010","4","8","Montana","Granite County",3079,"","Granite County Montana",2875,2831,-204,-6.62552776875609,6.62552776875609,-248,-8.05456316986034,8.05456316986034
"30","041","G3000410","2010","4","8","Montana","Hill County",16096,"","Hill County Montana",16766,16651,670,4.16252485089463,4.16252485089463,555,3.44806163021869,3.44806163021869
"30","043","G3000430","2010","4","8","Montana","Jefferson County",11406,"","Jefferson County Montana",11496,10022,90,0.789058390320884,0.789058390320884,-1384,-12.1339645800456,12.1339645800456
"30","045","G3000450","2010","4","8","Montana","Judith Basin County",2072,"","Judith Basin County Montana",2031,2308,-41,-1.97876447876448,1.97876447876448,236,11.3899613899614,11.3899613899614
"30","047","G3000470","2010","4","8","Montana","Lake County",28746,"","Lake County Montana",28576,27753,-170,-0.591386627704724,0.591386627704724,-993,-3.45439365476936,3.45439365476936
"30","049","G3000490","2010","4","8","Montana","Lewis and Clark County",63395,"","Lewis and Clark County Montana",62728,57978,-667,-1.05213344901017,1.05213344901017,-5417,-8.54483792097169,8.54483792097169
"30","051","G3000510","2010","4","8","Montana","Liberty County",2339,"","Liberty County Montana",1752,2142,-587,-25.096194955109,25.096194955109,-197,-8.42240273621206,8.42240273621206
"30","053","G3000530","2010","4","8","Montana","Lincoln County",19687,"","Lincoln County Montana",18705,18953,-982,-4.98806318890639,4.98806318890639,-734,-3.72834865647381,3.72834865647381
"30","055","G3000550","2010","4","8","Montana","McCone County",1734,"","McCone County Montana",1670,1951,-64,-3.69088811995386,3.69088811995386,217,12.5144175317186,12.5144175317186
"30","057","G3000570","2010","4","8","Montana","Madison County",7691,"","Madison County Montana",7435,6939,-256,-3.32856585619555,3.32856585619555,-752,-9.77766220257444,9.77766220257444
"30","059","G3000590","2010","4","8","Montana","Meagher County",1891,"","Meagher County Montana",1893,1914,2,0.105764145954521,0.105764145954521,23,1.216287678477,1.216287678477
"30","061","G3000610","2010","4","8","Montana","Mineral County",4223,"","Mineral County Montana",3822,3926,-401,-9.49561922803694,9.49561922803694,-297,-7.03291498934407,7.03291498934407
"30","063","G3000630","2010","4","8","Montana","Missoula County",109299,"","Missoula County Montana",109129,108684,-170,-0.15553664717884,0.15553664717884,-615,-0.562676694205802,0.562676694205802
"30","065","G3000650","2010","4","8","Montana","Musselshell County",4538,"","Musselshell County Montana",4615,4476,77,1.69678272366681,1.69678272366681,-62,-1.36624063464081,1.36624063464081
"30","067","G3000670","2010","4","8","Montana","Park County",15636,"","Park County Montana",15888,16204,252,1.61166538756715,1.61166538756715,568,3.6326426195958,3.6326426195958
"30","069","G3000690","2010","4","8","Montana","Petroleum County",494,"","Petroleum County Montana",443,490,-51,-10.3238866396761,10.3238866396761,-4,-0.809716599190283,0.809716599190283
"30","071","G3000710","2010","4","8","Montana","Phillips County",4253,"","Phillips County Montana",3895,4573,-358,-8.41758758523395,8.41758758523395,320,7.52410063484599,7.52410063484599
"30","073","G3000730","2010","4","8","Montana","Pondera County",6153,"","Pondera County Montana",5815,6357,-338,-5.49325532260686,5.49325532260686,204,3.31545587518284,3.31545587518284
"30","075","G3000750","2010","4","8","Montana","Powder River County",1743,"","Powder River County Montana",1655,1852,-88,-5.04876649454963,5.04876649454963,109,6.25358577165806,6.25358577165806
"30","077","G3000770","2010","4","8","Montana","Powell County",7027,"","Powell County Montana",7027,7138,0,0,0,111,1.57962146008254,1.57962146008254
"30","079","G3000790","2010","4","8","Montana","Prairie County",1179,"","Prairie County Montana",1137,1189,-42,-3.56234096692112,3.56234096692112,10,0.848176420695505,0.848176420695505
"30","081","G3000810","2010","4","8","Montana","Ravalli County",40212,"","Ravalli County Montana",40735,37493,523,1.30060678404456,1.30060678404456,-2719,-6.76166318511887,6.76166318511887
"30","083","G3000830","2010","4","8","Montana","Richland County",9746,"","Richland County Montana",9380,9793,-366,-3.75538682536425,3.75538682536425,47,0.482249127847322,0.482249127847322
"30","085","G3000850","2010","4","8","Montana","Roosevelt County",10425,"","Roosevelt County Montana",10367,10598,-58,-0.556354916067146,0.556354916067146,173,1.65947242206235,1.65947242206235
"30","087","G3000870","2010","4","8","Montana","Rosebud County",9233,"","Rosebud County Montana",9324,9466,91,0.985595147839272,0.985595147839272,233,2.52355680710495,2.52355680710495
"30","089","G3000890","2010","4","8","Montana","Sanders County",11413,"","Sanders County Montana",10963,10294,-450,-3.94287216332253,3.94287216332253,-1119,-9.80460877946202,9.80460877946202
"30","091","G3000910","2010","4","8","Montana","Sheridan County",3384,"","Sheridan County Montana",3184,4054,-200,-5.91016548463357,5.91016548463357,670,19.7990543735225,19.7990543735225
"30","093","G3000930","2010","4","8","Montana","Silver Bow County",34200,"","Silver Bow County Montana",33017,35119,-1183,-3.45906432748538,3.45906432748538,919,2.68713450292398,2.68713450292398
"30","095","G3000950","2010","4","8","Montana","Stillwater County",9117,"","Stillwater County Montana",8851,8387,-266,-2.91762641219699,2.91762641219699,-730,-8.00701985302183,8.00701985302183
"30","097","G3000970","2010","4","8","Montana","Sweet Grass County",3651,"","Sweet Grass County Montana",3577,3704,-74,-2.02684196110655,2.02684196110655,53,1.45165708025199,1.45165708025199
"30","099","G3000990","2010","4","8","Montana","Teton County",6073,"","Teton County Montana",6097,6442,24,0.395191832702124,0.395191832702124,369,6.07607442779516,6.07607442779516
"30","101","G3001010","2010","4","8","Montana","Toole County",5324,"","Toole County Montana",5196,5205,-128,-2.40420736288505,2.40420736288505,-119,-2.23516153268219,2.23516153268219
"30","103","G3001030","2010","4","8","Montana","Treasure County",718,"","Treasure County Montana",603,847,-115,-16.016713091922,16.016713091922,129,17.966573816156,17.966573816156
"30","105","G3001050","2010","4","8","Montana","Valley County",7369,"","Valley County Montana",6743,7583,-626,-8.49504681775003,8.49504681775003,214,2.90405753833627,2.90405753833627
"30","107","G3001070","2010","4","8","Montana","Wheatland County",2168,"","Wheatland County Montana",2034,2234,-134,-6.18081180811808,6.18081180811808,66,3.04428044280443,3.04428044280443
"30","109","G3001090","2010","4","8","Montana","Wibaux County",1017,"","Wibaux County Montana",871,1062,-146,-14.3559488692232,14.3559488692232,45,4.42477876106195,4.42477876106195
"30","111","G3001110","2010","4","8","Montana","Yellowstone County",147972,"","Yellowstone County Montana",146120,142365,-1852,-1.25158813829643,1.25158813829643,-5607,-3.78923039493958,3.78923039493958
"31","001","G3100010","2010","2","4","Nebraska","Adams County",31364,"","Adams County Nebraska",33495,33659,2131,6.79441397780895,6.79441397780895,2295,7.31730646601199,7.31730646601199
"31","003","G3100030","2010","2","4","Nebraska","Antelope County",6685,"","Antelope County Nebraska",6583,7670,-102,-1.52580403889304,1.52580403889304,985,14.7344801795064,14.7344801795064
"31","005","G3100050","2010","2","4","Nebraska","Arthur County",460,"","Arthur County Nebraska",353,455,-107,-23.2608695652174,23.2608695652174,-5,-1.08695652173913,1.08695652173913
"31","007","G3100070","2010","2","4","Nebraska","Banner County",690,"","Banner County Nebraska",687,835,-3,-0.434782608695652,0.434782608695652,145,21.0144927536232,21.0144927536232
"31","009","G3100090","2010","2","4","Nebraska","Blaine County",478,"","Blaine County Nebraska",452,599,-26,-5.43933054393306,5.43933054393306,121,25.3138075313808,25.3138075313808
"31","011","G3100110","2010","2","4","Nebraska","Boone County",5505,"","Boone County Nebraska",5415,6406,-90,-1.63487738419619,1.63487738419619,901,16.3669391462307,16.3669391462307
"31","013","G3100130","2010","2","4","Nebraska","Box Butte County",11308,"","Box Butte County Nebraska",10969,12208,-339,-2.99787760877255,2.99787760877255,900,7.95896710293597,7.95896710293597
"31","015","G3100150","2010","2","4","Nebraska","Boyd County",2099,"","Boyd County Nebraska",2103,2492,4,0.190566936636494,0.190566936636494,393,18.7232015245355,18.7232015245355
"31","017","G3100170","2010","2","4","Nebraska","Brown County",3145,"","Brown County Nebraska",3101,3564,-44,-1.39904610492846,1.39904610492846,419,13.3227344992051,13.3227344992051
"31","019","G3100190","2010","2","4","Nebraska","Buffalo County",46102,"","Buffalo County Nebraska",45943,47424,-159,-0.344887423539109,0.344887423539109,1322,2.86755455294781,2.86755455294781
"31","021","G3100210","2010","2","4","Nebraska","Burt County",6858,"","Burt County Nebraska",6852,7900,-6,-0.0874890638670166,0.0874890638670166,1042,15.1939340915719,15.1939340915719
"31","023","G3100230","2010","2","4","Nebraska","Butler County",8395,"","Butler County Nebraska",8385,9137,-10,-0.119118522930316,0.119118522930316,742,8.83859440142942,8.83859440142942
"31","025","G3100250","2010","2","4","Nebraska","Cass County",25241,"","Cass County Nebraska",25602,26937,361,1.43021274909869,1.43021274909869,1696,6.71922665504536,6.71922665504536
"31","027","G3100270","2010","2","4","Nebraska","Cedar County",8852,"","Cedar County Nebraska",8324,9867,-528,-5.96475372797108,5.96475372797108,1015,11.4663352914596,11.4663352914596
"31","029","G3100290","2010","2","4","Nebraska","Chase County",3966,"","Chase County Nebraska",3671,4119,-295,-7.43822491174987,7.43822491174987,153,3.85779122541604,3.85779122541604
"31","031","G3100310","2010","2","4","Nebraska","Cherry County",5713,"","Cherry County Nebraska",5497,6334,-216,-3.78085069140557,3.78085069140557,621,10.869945737791,10.869945737791
"31","033","G3100330","2010","2","4","Nebraska","Cheyenne County",9998,"","Cheyenne County Nebraska",9662,10461,-336,-3.36067213442689,3.36067213442689,463,4.63092618523705,4.63092618523705
"31","035","G3100350","2010","2","4","Nebraska","Clay County",6542,"","Clay County Nebraska",6209,7130,-333,-5.09018648731275,5.09018648731275,588,8.98807704066035,8.98807704066035
"31","037","G3100370","2010","2","4","Nebraska","Colfax County",10515,"","Colfax County Nebraska",10466,10524,-49,-0.466000951022349,0.466000951022349,9,0.0855920114122682,0.0855920114122682
"31","039","G3100390","2010","2","4","Nebraska","Cuming County",9139,"","Cuming County Nebraska",9115,10327,-24,-0.262610788926578,0.262610788926578,1188,12.9992340518656,12.9992340518656
"31","041","G3100410","2010","2","4","Nebraska","Custer County",10939,"","Custer County Nebraska",10704,11993,-235,-2.14827680775208,2.14827680775208,1054,9.63525002285401,9.63525002285401
"31","043","G3100430","2010","2","4","Nebraska","Dakota County",21006,"","Dakota County Nebraska",20734,20938,-272,-1.29486813291441,1.29486813291441,-68,-0.323717033228601,0.323717033228601
"31","045","G3100450","2010","2","4","Nebraska","Dawes County",9182,"","Dawes County Nebraska",8666,9119,-516,-5.61969069919408,5.61969069919408,-63,-0.686125027227184,0.686125027227184
"31","047","G3100470","2010","2","4","Nebraska","Dawson County",24326,"","Dawson County Nebraska",25173,24591,847,3.48187124886952,3.48187124886952,265,1.08936939899696,1.08936939899696
"31","049","G3100490","2010","2","4","Nebraska","Deuel County",1941,"","Deuel County Nebraska",1802,2054,-139,-7.16125708397733,7.16125708397733,113,5.82174137042762,5.82174137042762
"31","051","G3100510","2010","2","4","Nebraska","Dixon County",6000,"","Dixon County Nebraska",6263,6426,263,4.38333333333333,4.38333333333333,426,7.1,7.1
"31","053","G3100530","2010","2","4","Nebraska","Dodge County",36691,"","Dodge County Nebraska",35632,37641,-1059,-2.88626638685236,2.88626638685236,950,2.58919080973536,2.58919080973536
"31","055","G3100550","2010","2","4","Nebraska","Douglas County",517110,"","Douglas County Nebraska",515018,523203,-2092,-0.404556090580341,0.404556090580341,6093,1.17827928293787,1.17827928293787
"31","057","G3100570","2010","2","4","Nebraska","Dundy County",2008,"","Dundy County Nebraska",1925,2302,-83,-4.13346613545817,4.13346613545817,294,14.6414342629482,14.6414342629482
"31","059","G3100590","2010","2","4","Nebraska","Fillmore County",5890,"","Fillmore County Nebraska",5970,6621,80,1.35823429541596,1.35823429541596,731,12.4108658743633,12.4108658743633
"31","061","G3100610","2010","2","4","Nebraska","Franklin County",3225,"","Franklin County Nebraska",3104,3528,-121,-3.75193798449612,3.75193798449612,303,9.3953488372093,9.3953488372093
"31","063","G3100630","2010","2","4","Nebraska","Frontier County",2756,"","Frontier County Nebraska",2478,3165,-278,-10.0870827285922,10.0870827285922,409,14.8403483309144,14.8403483309144
"31","065","G3100650","2010","2","4","Nebraska","Furnas County",4959,"","Furnas County Nebraska",4588,5326,-371,-7.48134704577536,7.48134704577536,367,7.40068562210123,7.40068562210123
"31","067","G3100670","2010","2","4","Nebraska","Gage County",22311,"","Gage County Nebraska",22681,24122,370,1.65837479270315,1.65837479270315,1811,8.11707229617677,8.11707229617677
"31","069","G3100690","2010","2","4","Nebraska","Garden County",2057,"","Garden County Nebraska",1790,2324,-267,-12.980068060282,12.980068060282,267,12.980068060282,12.980068060282
"31","071","G3100710","2010","2","4","Nebraska","Garfield County",2049,"","Garfield County Nebraska",1707,1919,-342,-16.6910688140556,16.6910688140556,-130,-6.34455832113226,6.34455832113226
"31","073","G3100730","2010","2","4","Nebraska","Gosper County",2044,"","Gosper County Nebraska",1868,2195,-176,-8.6105675146771,8.6105675146771,151,7.38747553816047,7.38747553816047
"31","075","G3100750","2010","2","4","Nebraska","Grant County",614,"","Grant County Nebraska",553,755,-61,-9.93485342019544,9.93485342019544,141,22.9641693811075,22.9641693811075
"31","077","G3100770","2010","2","4","Nebraska","Greeley County",2538,"","Greeley County Nebraska",2270,2773,-268,-10.5594956658786,10.5594956658786,235,9.25925925925926,9.25925925925926
"31","079","G3100790","2010","2","4","Nebraska","Hall County",58607,"","Hall County Nebraska",58258,57286,-349,-0.59549200607436,0.59549200607436,-1321,-2.25399696282014,2.25399696282014
"31","081","G3100810","2010","2","4","Nebraska","Hamilton County",9124,"","Hamilton County Nebraska",9293,9884,169,1.8522577816747,1.8522577816747,760,8.32967996492766,8.32967996492766
"31","083","G3100830","2010","2","4","Nebraska","Harlan County",3423,"","Harlan County Nebraska",3230,3845,-193,-5.63832895121239,5.63832895121239,422,12.3283669295939,12.3283669295939
"31","085","G3100850","2010","2","4","Nebraska","Hayes County",967,"","Hayes County Nebraska",959,1088,-8,-0.827300930713547,0.827300930713547,121,12.5129265770424,12.5129265770424
"31","087","G3100870","2010","2","4","Nebraska","Hitchcock County",2908,"","Hitchcock County Nebraska",2794,3119,-114,-3.92022008253095,3.92022008253095,211,7.25584594222834,7.25584594222834
"31","089","G3100890","2010","2","4","Nebraska","Holt County",10435,"","Holt County Nebraska",9999,11902,-436,-4.1782462865357,4.1782462865357,1467,14.0584571154768,14.0584571154768
"31","091","G3100910","2010","2","4","Nebraska","Hooker County",736,"","Hooker County Nebraska",725,792,-11,-1.4945652173913,1.4945652173913,56,7.60869565217391,7.60869565217391
"31","093","G3100930","2010","2","4","Nebraska","Howard County",6274,"","Howard County Nebraska",6447,7174,173,2.7574115396876,2.7574115396876,900,14.3449155243864,14.3449155243864
"31","095","G3100950","2010","2","4","Nebraska","Jefferson County",7547,"","Jefferson County Nebraska",7108,8450,-439,-5.8168808798198,5.8168808798198,903,11.9650192129323,11.9650192129323
"31","097","G3100970","2010","2","4","Nebraska","Johnson County",5217,"","Johnson County Nebraska",5138,4594,-79,-1.51428023768449,1.51428023768449,-623,-11.9417289630056,11.9417289630056
"31","099","G3100990","2010","2","4","Nebraska","Kearney County",6489,"","Kearney County Nebraska",6480,6918,-9,-0.13869625520111,0.13869625520111,429,6.61118816458622,6.61118816458622
"31","101","G3101010","2010","2","4","Nebraska","Keith County",8368,"","Keith County Nebraska",7763,9367,-605,-7.22992351816444,7.22992351816444,999,11.9383365200765,11.9383365200765
"31","103","G3101030","2010","2","4","Nebraska","Keya Paha County",824,"","Keya Paha County Nebraska",811,1028,-13,-1.57766990291262,1.57766990291262,204,24.7572815533981,24.7572815533981
"31","105","G3101050","2010","2","4","Nebraska","Kimball County",3821,"","Kimball County Nebraska",3560,4068,-261,-6.83067259879613,6.83067259879613,247,6.46427636744308,6.46427636744308
"31","107","G3101070","2010","2","4","Nebraska","Knox County",8701,"","Knox County Nebraska",8393,9698,-308,-3.53982300884956,3.53982300884956,997,11.4584530513734,11.4584530513734
"31","109","G3101090","2010","2","4","Nebraska","Lancaster County",285407,"","Lancaster County Nebraska",282718,284123,-2689,-0.942163296625521,0.942163296625521,-1284,-0.449883850080762,0.449883850080762
"31","111","G3101110","2010","2","4","Nebraska","Lincoln County",36288,"","Lincoln County Nebraska",35567,36584,-721,-1.98688271604938,1.98688271604938,296,0.815696649029982,0.815696649029982
"31","113","G3101130","2010","2","4","Nebraska","Logan County",763,"","Logan County Nebraska",755,796,-8,-1.04849279161206,1.04849279161206,33,4.32503276539974,4.32503276539974
"31","115","G3101150","2010","2","4","Nebraska","Loup County",632,"","Loup County Nebraska",674,744,42,6.64556962025316,6.64556962025316,112,17.7215189873418,17.7215189873418
"31","117","G3101170","2010","2","4","Nebraska","McPherson County",539,"","McPherson County Nebraska",495,548,-44,-8.16326530612245,8.16326530612245,9,1.66975881261596,1.66975881261596
"31","119","G3101190","2010","2","4","Nebraska","Madison County",34876,"","Madison County Nebraska",34799,37112,-77,-0.220782199793554,0.220782199793554,2236,6.41128569790114,6.41128569790114
"31","121","G3101210","2010","2","4","Nebraska","Merrick County",7845,"","Merrick County Nebraska",7649,8650,-196,-2.49840662842575,2.49840662842575,805,10.2613129381772,10.2613129381772
"31","123","G3101230","2010","2","4","Nebraska","Morrill County",5042,"","Morrill County Nebraska",4875,5483,-167,-3.31217770725902,3.31217770725902,441,8.74652915509718,8.74652915509718
"31","125","G3101250","2010","2","4","Nebraska","Nance County",3735,"","Nance County Nebraska",3454,4033,-281,-7.52342704149933,7.52342704149933,298,7.97858099062918,7.97858099062918
"31","127","G3101270","2010","2","4","Nebraska","Nemaha County",7248,"","Nemaha County Nebraska",6875,7851,-373,-5.1462472406181,5.1462472406181,603,8.31953642384106,8.31953642384106
"31","129","G3101290","2010","2","4","Nebraska","Nuckolls County",4500,"","Nuckolls County Nebraska",4325,5100,-175,-3.88888888888889,3.88888888888889,600,13.3333333333333,13.3333333333333
"31","131","G3101310","2010","2","4","Nebraska","Otoe County",15740,"","Otoe County Nebraska",15367,16457,-373,-2.36975857687421,2.36975857687421,717,4.55527318932656,4.55527318932656
"31","133","G3101330","2010","2","4","Nebraska","Pawnee County",2773,"","Pawnee County Nebraska",2641,3159,-132,-4.76018752253877,4.76018752253877,386,13.9199423007573,13.9199423007573
"31","135","G3101350","2010","2","4","Nebraska","Perkins County",2970,"","Perkins County Nebraska",2784,3219,-186,-6.26262626262626,6.26262626262626,249,8.38383838383838,8.38383838383838
"31","137","G3101370","2010","2","4","Nebraska","Phelps County",9188,"","Phelps County Nebraska",9097,9967,-91,-0.990422289943404,0.990422289943404,779,8.47845015237266,8.47845015237266
"31","139","G3101390","2010","2","4","Nebraska","Pierce County",7266,"","Pierce County Nebraska",7173,8179,-93,-1.27993393889348,1.27993393889348,913,12.5653729699972,12.5653729699972
"31","141","G3101410","2010","2","4","Nebraska","Platte County",32237,"","Platte County Nebraska",32839,33199,602,1.86741942488445,1.86741942488445,962,2.98414864906784,2.98414864906784
"31","143","G3101430","2010","2","4","Nebraska","Polk County",5406,"","Polk County Nebraska",5050,5756,-356,-6.58527561968183,6.58527561968183,350,6.47428782833888,6.47428782833888
"31","145","G3101450","2010","2","4","Nebraska","Red Willow County",11055,"","Red Willow County Nebraska",10676,11564,-379,-3.42831298055179,3.42831298055179,509,4.60425146992311,4.60425146992311
"31","147","G3101470","2010","2","4","Nebraska","Richardson County",8363,"","Richardson County Nebraska",8136,9514,-227,-2.7143369604209,2.7143369604209,1151,13.7630037068038,13.7630037068038
"31","149","G3101490","2010","2","4","Nebraska","Rock County",1526,"","Rock County Nebraska",1461,1775,-65,-4.25950196592398,4.25950196592398,249,16.3171690694626,16.3171690694626
"31","151","G3101510","2010","2","4","Nebraska","Saline County",14200,"","Saline County Nebraska",13914,14428,-286,-2.01408450704225,2.01408450704225,228,1.6056338028169,1.6056338028169
"31","153","G3101530","2010","2","4","Nebraska","Sarpy County",158840,"","Sarpy County Nebraska",154887,166579,-3953,-2.48866784185344,2.48866784185344,7739,4.87219843868043,4.87219843868043
"31","155","G3101550","2010","2","4","Nebraska","Saunders County",20780,"","Saunders County Nebraska",20305,22297,-475,-2.28585178055823,2.28585178055823,1517,7.30028873917228,7.30028873917228
"31","157","G3101570","2010","2","4","Nebraska","Scotts Bluff County",36970,"","Scotts Bluff County Nebraska",37135,37498,165,0.44630781714904,0.44630781714904,528,1.42818501487693,1.42818501487693
"31","159","G3101590","2010","2","4","Nebraska","Seward County",16750,"","Seward County Nebraska",16770,17820,20,0.119402985074627,0.119402985074627,1070,6.38805970149254,6.38805970149254
"31","161","G3101610","2010","2","4","Nebraska","Sheridan County",5469,"","Sheridan County Nebraska",5197,6147,-272,-4.97348692631194,4.97348692631194,678,12.3971475589687,12.3971475589687
"31","163","G3101630","2010","2","4","Nebraska","Sherman County",3152,"","Sherman County Nebraska",2883,3346,-269,-8.53426395939086,8.53426395939086,194,6.15482233502538,6.15482233502538
"31","165","G3101650","2010","2","4","Nebraska","Sioux County",1311,"","Sioux County Nebraska",1262,1528,-49,-3.73760488176964,3.73760488176964,217,16.5522501906941,16.5522501906941
"31","167","G3101670","2010","2","4","Nebraska","Stanton County",6129,"","Stanton County Nebraska",6273,6687,144,2.34948604992658,2.34948604992658,558,9.10425844346549,9.10425844346549
"31","169","G3101690","2010","2","4","Nebraska","Thayer County",5228,"","Thayer County Nebraska",5025,6117,-203,-3.88293802601377,3.88293802601377,889,17.0045906656465,17.0045906656465
"31","171","G3101710","2010","2","4","Nebraska","Thomas County",647,"","Thomas County Nebraska",557,749,-90,-13.9103554868624,13.9103554868624,102,15.7650695517774,15.7650695517774
"31","173","G3101730","2010","2","4","Nebraska","Thurston County",6940,"","Thurston County Nebraska",7386,7388,446,6.42651296829971,6.42651296829971,448,6.45533141210375,6.45533141210375
"31","175","G3101750","2010","2","4","Nebraska","Valley County",4260,"","Valley County Nebraska",4146,4665,-114,-2.67605633802817,2.67605633802817,405,9.50704225352113,9.50704225352113
"31","177","G3101770","2010","2","4","Nebraska","Washington County",20234,"","Washington County Nebraska",19809,20762,-425,-2.10042502718197,2.10042502718197,528,2.60946921024019,2.60946921024019
"31","179","G3101790","2010","2","4","Nebraska","Wayne County",9595,"","Wayne County Nebraska",9335,10146,-260,-2.70974465867639,2.70974465867639,551,5.74257425742574,5.74257425742574
"31","181","G3101810","2010","2","4","Nebraska","Webster County",3812,"","Webster County Nebraska",3416,4090,-396,-10.3882476390346,10.3882476390346,278,7.29275970619098,7.29275970619098
"31","183","G3101830","2010","2","4","Nebraska","Wheeler County",818,"","Wheeler County Nebraska",775,921,-43,-5.25672371638142,5.25672371638142,103,12.5916870415648,12.5916870415648
"31","185","G3101850","2010","2","4","Nebraska","York County",13665,"","York County Nebraska",13759,14869,94,0.687888766922795,0.687888766922795,1204,8.81083058909623,8.81083058909623
"32","001","G3200010","2010","4","8","Nevada","Churchill County",24877,"","Churchill County Nevada",24428,27092,-449,-1.80488000964747,1.80488000964747,2215,8.90380672910721,8.90380672910721
"32","003","G3200030","2010","4","8","Nevada","Clark County",1951269,"","Clark County Nevada",1908805,2021912,-42464,-2.17622480549837,2.17622480549837,70643,3.62036192857059,3.62036192857059
"32","005","G3200050","2010","4","8","Nevada","Douglas County",46997,"","Douglas County Nevada",45179,50809,-1818,-3.86833202119284,3.86833202119284,3812,8.11115603123604,8.11115603123604
"32","007","G3200070","2010","4","8","Nevada","Elko County",48818,"","Elko County Nevada",48142,48426,-676,-1.38473513867836,1.38473513867836,-392,-0.802982506452538,0.802982506452538
"32","009","G3200090","2010","4","8","Nevada","Esmeralda County",783,"","Esmeralda County Nevada",607,1000,-176,-22.477650063857,22.477650063857,217,27.7139208173691,27.7139208173691
"32","011","G3200110","2010","4","8","Nevada","Eureka County",1987,"","Eureka County Nevada",1760,1701,-227,-11.4242576748868,11.4242576748868,-286,-14.3935581278309,14.3935581278309
"32","013","G3200130","2010","4","8","Nevada","Humboldt County",16528,"","Humboldt County Nevada",18473,17169,1945,11.7679090029042,11.7679090029042,641,3.87826718296225,3.87826718296225
"32","015","G3200150","2010","4","8","Nevada","Lander County",5775,"","Lander County Nevada",5250,5790,-525,-9.09090909090909,9.09090909090909,15,0.25974025974026,0.25974025974026
"32","017","G3200170","2010","4","8","Nevada","Lincoln County",5345,"","Lincoln County Nevada",4743,4419,-602,-11.2628624883068,11.2628624883068,-926,-17.3246024321796,17.3246024321796
"32","019","G3200190","2010","4","8","Nevada","Lyon County",51980,"","Lyon County Nevada",52797,44020,817,1.57175836860331,1.57175836860331,-7960,-15.3135821469796,15.3135821469796
"32","021","G3200210","2010","4","8","Nevada","Mineral County",4772,"","Mineral County Nevada",4591,5070,-181,-3.7929589270746,3.7929589270746,298,6.24476110645432,6.24476110645432
"32","023","G3200230","2010","4","8","Nevada","Nye County",43946,"","Nye County Nevada",43720,33492,-226,-0.514267510126064,0.514267510126064,-10454,-23.7882856232649,23.7882856232649
"32","027","G3200270","2010","4","8","Nevada","Pershing County",6753,"","Pershing County Nevada",6311,6736,-442,-6.54523915296905,6.54523915296905,-17,-0.251739967421887,0.251739967421887
"32","029","G3200290","2010","4","8","Nevada","Storey County",4010,"","Storey County Nevada",4438,3958,428,10.6733167082294,10.6733167082294,-52,-1.29675810473815,1.29675810473815
"32","031","G3200310","2010","4","8","Nevada","Washoe County",421407,"","Washoe County Nevada",417135,427140,-4272,-1.01374680534495,1.01374680534495,5733,1.36044251756615,1.36044251756615
"32","033","G3200330","2010","4","8","Nevada","White Pine County",10030,"","White Pine County Nevada",9312,9270,-718,-7.15852442671984,7.15852442671984,-760,-7.57726819541376,7.57726819541376
"32","510","G3205100","2010","4","8","Nevada","Carson City",55274,"","Carson City Nevada",54986,56546,-288,-0.521040633932771,0.521040633932771,1272,2.30126279986974,2.30126279986974
"33","001","G3300010","2010","1","1","New Hampshire","Belknap County",60088,"","Belknap County New Hampshire",61320,63375,1232,2.05032618825722,2.05032618825722,3287,5.47031021168952,5.47031021168952
"33","003","G3300030","2010","1","1","New Hampshire","Carroll County",47818,"","Carroll County New Hampshire",47990,48885,172,0.3596971851604,0.3596971851604,1067,2.23137730561713,2.23137730561713
"33","005","G3300050","2010","1","1","New Hampshire","Cheshire County",77117,"","Cheshire County New Hampshire",76841,78748,-276,-0.357897739797969,0.357897739797969,1631,2.11496816525539,2.11496816525539
"33","007","G3300070","2010","1","1","New Hampshire","Coos County",33055,"","Coos County New Hampshire",31146,34054,-1909,-5.7752231129935,5.7752231129935,999,3.02223566782635,3.02223566782635
"33","009","G3300090","2010","1","1","New Hampshire","Grafton County",89118,"","Grafton County New Hampshire",86256,89558,-2862,-3.21147242981216,3.21147242981216,440,0.493727417581185,0.493727417581185
"33","011","G3300110","2010","1","1","New Hampshire","Hillsborough County",400721,"","Hillsborough County New Hampshire",406077,414897,5356,1.33659079509185,1.33659079509185,14176,3.53762343376065,3.53762343376065
"33","013","G3300130","2010","1","1","New Hampshire","Merrimack County",146445,"","Merrimack County New Hampshire",148646,151151,2201,1.50295332718768,1.50295332718768,4706,3.21349312028407,3.21349312028407
"33","015","G3300150","2010","1","1","New Hampshire","Rockingham County",295223,"","Rockingham County New Hampshire",298589,306938,3366,1.14015506921886,1.14015506921886,11715,3.96818676051663,3.96818676051663
"33","017","G3300170","2010","1","1","New Hampshire","Strafford County",123143,"","Strafford County New Hampshire",123734,125781,591,0.479929837668402,0.479929837668402,2638,2.14222489301057,2.14222489301057
"33","019","G3300190","2010","1","1","New Hampshire","Sullivan County",43742,"","Sullivan County New Hampshire",42603,43747,-1139,-2.60390471400485,2.60390471400485,5,0.0114306616066938,0.0114306616066938
"34","001","G3400010","2010","1","2","New Jersey","Atlantic County",274549,"","Atlantic County New Jersey",272301,283981,-2248,-0.818797373146506,0.818797373146506,9432,3.43545232362893,3.43545232362893
"34","003","G3400030","2010","1","2","New Jersey","Bergen County",905116,"","Bergen County New Jersey",899341,914477,-5775,-0.638039765068787,0.638039765068787,9361,1.03423207633055,1.03423207633055
"34","005","G3400050","2010","1","2","New Jersey","Burlington County",448734,"","Burlington County New Jersey",445352,462870,-3382,-0.753675897079339,0.753675897079339,14136,3.15019588442151,3.15019588442151
"34","007","G3400070","2010","1","2","New Jersey","Camden County",513657,"","Camden County New Jersey",515916,527199,2259,0.439787640390377,0.439787640390377,13542,2.63638965301748,2.63638965301748
"34","009","G3400090","2010","1","2","New Jersey","Cape May County",97265,"","Cape May County New Jersey",95972,115508,-1293,-1.32935793964941,1.32935793964941,18243,18.7559759420141,18.7559759420141
"34","011","G3400110","2010","1","2","New Jersey","Cumberland County",156898,"","Cumberland County New Jersey",158154,155631,1256,0.800520083111321,0.800520083111321,-1267,-0.807531007406086,0.807531007406086
"34","013","G3400130","2010","1","2","New Jersey","Essex County",783969,"","Essex County New Jersey",768895,823318,-15074,-1.92278010992782,1.92278010992782,39349,5.0192035654471,5.0192035654471
"34","015","G3400150","2010","1","2","New Jersey","Gloucester County",288288,"","Gloucester County New Jersey",289983,290412,1695,0.587953712953713,0.587953712953713,2124,0.736763236763237,0.736763236763237
"34","017","G3400170","2010","1","2","New Jersey","Hudson County",634266,"","Hudson County New Jersey",599675,659060,-34591,-5.45370554310021,5.45370554310021,24794,3.90908546256618,3.90908546256618
"34","019","G3400190","2010","1","2","New Jersey","Hunterdon County",128349,"","Hunterdon County New Jersey",130210,133345,1861,1.44995286289726,1.44995286289726,4996,3.89251182323197,3.89251182323197
"34","021","G3400210","2010","1","2","New Jersey","Mercer County",366513,"","Mercer County New Jersey",366679,371485,166,0.0452917086160655,0.0452917086160655,4972,1.35656852553661,1.35656852553661
"34","023","G3400230","2010","1","2","New Jersey","Middlesex County",809858,"","Middlesex County New Jersey",793726,793317,-16132,-1.99195414504765,1.99195414504765,-16541,-2.04245682576452,2.04245682576452
"34","025","G3400250","2010","1","2","New Jersey","Monmouth County",630380,"","Monmouth County New Jersey",644988,659237,14608,2.31733240267775,2.31733240267775,28857,4.57771502903011,4.57771502903011
"34","027","G3400270","2010","1","2","New Jersey","Morris County",492276,"","Morris County New Jersey",488690,500884,-3586,-0.728453144171156,0.728453144171156,8608,1.748612566934,1.748612566934
"34","029","G3400290","2010","1","2","New Jersey","Ocean County",576567,"","Ocean County New Jersey",576634,567189,67,0.0116205055093337,0.0116205055093337,-9378,-1.62652389054524,1.62652389054524
"34","031","G3400310","2010","1","2","New Jersey","Passaic County",501226,"","Passaic County New Jersey",492798,496797,-8428,-1.681477018351,1.681477018351,-4429,-0.883633331072211,0.883633331072211
"34","033","G3400330","2010","1","2","New Jersey","Salem County",66083,"","Salem County New Jersey",66368,68372,285,0.43127581980237,0.43127581980237,2289,3.46382579483377,3.46382579483377
"34","035","G3400350","2010","1","2","New Jersey","Somerset County",323444,"","Somerset County New Jersey",328167,325907,4723,1.46022186220799,1.46022186220799,2463,0.761491942963851,0.761491942963851
"34","037","G3400370","2010","1","2","New Jersey","Sussex County",149265,"","Sussex County New Jersey",150931,155560,1666,1.11613573175225,1.11613573175225,6295,4.21733159146484,4.21733159146484
"34","039","G3400390","2010","1","2","New Jersey","Union County",536499,"","Union County New Jersey",528733,535598,-7766,-1.44753298701396,1.44753298701396,-901,-0.167940667177385,0.167940667177385
"34","041","G3400410","2010","1","2","New Jersey","Warren County",108692,"","Warren County New Jersey",109639,113670,947,0.871269274647628,0.871269274647628,4978,4.57991388510654,4.57991388510654
"35","001","G3500010","2010","4","8","New Mexico","Bernalillo County",662564,"","Bernalillo County New Mexico",646604,659147,-15960,-2.40882390229472,2.40882390229472,-3417,-0.515723764043926,0.515723764043926
"35","003","G3500030","2010","4","8","New Mexico","Catron County",3725,"","Catron County New Mexico",3465,3752,-260,-6.97986577181208,6.97986577181208,27,0.724832214765101,0.724832214765101
"35","005","G3500050","2010","4","8","New Mexico","Chaves County",65645,"","Chaves County New Mexico",63881,63553,-1764,-2.68718104958489,2.68718104958489,-2092,-3.18683829689999,3.18683829689999
"35","006","G3500060","2010","4","8","New Mexico","Cibola County",27213,"","Cibola County New Mexico",27084,27115,-129,-0.47403814353434,0.47403814353434,-98,-0.36012200051446,0.36012200051446
"35","007","G3500070","2010","4","8","New Mexico","Colfax County",13750,"","Colfax County New Mexico",12701,15067,-1049,-7.62909090909091,7.62909090909091,1317,9.57818181818182,9.57818181818182
"35","009","G3500090","2010","4","8","New Mexico","Curry County",48376,"","Curry County New Mexico",45769,49356,-2607,-5.38903588556309,5.38903588556309,980,2.02579791632214,2.02579791632214
"35","011","G3500110","2010","4","8","New Mexico","De Baca County",2022,"","De Baca County New Mexico",1854,2576,-168,-8.30860534124629,8.30860534124629,554,27.3986152324431,27.3986152324431
"35","013","G3500130","2010","4","8","New Mexico","Dona Ana County",209233,"","Dona Ana County New Mexico",210309,213199,1076,0.51425922297152,0.51425922297152,3966,1.89549449656603,1.89549449656603
"35","015","G3500150","2010","4","8","New Mexico","Eddy County",53829,"","Eddy County New Mexico",52933,52511,-896,-1.66453027178658,1.66453027178658,-1318,-2.44849430604321,2.44849430604321
"35","017","G3500170","2010","4","8","New Mexico","Grant County",29514,"","Grant County New Mexico",29646,31575,132,0.447245375076235,0.447245375076235,2061,6.98312665175849,6.98312665175849
"35","019","G3500190","2010","4","8","New Mexico","Guadalupe County",4687,"","Guadalupe County New Mexico",4230,4775,-457,-9.7503733731598,9.7503733731598,88,1.87753360358438,1.87753360358438
"35","021","G3500210","2010","4","8","New Mexico","Harding County",695,"","Harding County New Mexico",671,1046,-24,-3.45323741007194,3.45323741007194,351,50.5035971223022,50.5035971223022
"35","023","G3500230","2010","4","8","New Mexico","Hidalgo County",4894,"","Hidalgo County New Mexico",4914,6011,20,0.408663669799755,0.408663669799755,1117,22.8238659583163,22.8238659583163
"35","025","G3500250","2010","4","8","New Mexico","Lea County",64727,"","Lea County New Mexico",60308,59104,-4419,-6.82713550759343,6.82713550759343,-5623,-8.68725570472909,8.68725570472909
"35","027","G3500270","2010","4","8","New Mexico","Lincoln County",20497,"","Lincoln County New Mexico",20998,21303,501,2.4442601356296,2.4442601356296,806,3.93228277308874,3.93228277308874
"35","028","G3500280","2010","4","8","New Mexico","Los Alamos County",17950,"","Los Alamos County New Mexico",18341,19805,391,2.17827298050139,2.17827298050139,1855,10.3342618384401,10.3342618384401
"35","029","G3500290","2010","4","8","New Mexico","Luna County",25095,"","Luna County New Mexico",27146,26320,2051,8.17294281729428,8.17294281729428,1225,4.88145048814505,4.88145048814505
"35","031","G3500310","2010","4","8","New Mexico","McKinley County",71492,"","McKinley County New Mexico",71574,75184,82,0.114698148044536,0.114698148044536,3692,5.1642141778101,5.1642141778101
"35","033","G3500330","2010","4","8","New Mexico","Mora County",4881,"","Mora County New Mexico",4986,5302,105,2.15119852489244,2.15119852489244,421,8.62528170456874,8.62528170456874
"35","035","G3500350","2010","4","8","New Mexico","Otero County",63797,"","Otero County New Mexico",63821,65566,24,0.0376193237926548,0.0376193237926548,1769,2.7728576578836,2.7728576578836
"35","037","G3500370","2010","4","8","New Mexico","Quay County",9041,"","Quay County New Mexico",8954,10158,-87,-0.962282933303838,0.962282933303838,1117,12.3548280057516,12.3548280057516
"35","039","G3500390","2010","4","8","New Mexico","Rio Arriba County",40246,"","Rio Arriba County New Mexico",41060,41756,814,2.02256124832281,2.02256124832281,1510,3.75192565720817,3.75192565720817
"35","041","G3500410","2010","4","8","New Mexico","Roosevelt County",19846,"","Roosevelt County New Mexico",19324,18769,-522,-2.63025294769727,2.63025294769727,-1077,-5.42678625415701,5.42678625415701
"35","043","G3500430","2010","4","8","New Mexico","Sandoval County",131561,"","Sandoval County New Mexico",127792,131533,-3769,-2.86483076291606,2.86483076291606,-28,-0.0212829029879676,0.0212829029879676
"35","045","G3500450","2010","4","8","New Mexico","San Juan County",130044,"","San Juan County New Mexico",124852,121458,-5192,-3.99249484789763,3.99249484789763,-8586,-6.60238073267509,6.60238073267509
"35","047","G3500470","2010","4","8","New Mexico","San Miguel County",29393,"","San Miguel County New Mexico",28457,30673,-936,-3.1844316674038,3.1844316674038,1280,4.3547783485864,4.3547783485864
"35","049","G3500490","2010","4","8","New Mexico","Santa Fe County",144170,"","Santa Fe County New Mexico",148905,144961,4735,3.28431712561559,3.28431712561559,791,0.548657834500936,0.548657834500936
"35","051","G3500510","2010","4","8","New Mexico","Sierra County",11988,"","Sierra County New Mexico",12941,13635,953,7.94961628294962,7.94961628294962,1647,13.7387387387387,13.7387387387387
"35","053","G3500530","2010","4","8","New Mexico","Socorro County",17866,"","Socorro County New Mexico",18122,18447,256,1.43288928691369,1.43288928691369,581,3.25198701444084,3.25198701444084
"35","055","G3500550","2010","4","8","New Mexico","Taos County",32937,"","Taos County New Mexico",31777,30681,-1160,-3.5218750948781,3.5218750948781,-2256,-6.84943983969396,6.84943983969396
"35","057","G3500570","2010","4","8","New Mexico","Torrance County",16383,"","Torrance County New Mexico",16462,17225,79,0.48220716596472,0.48220716596472,842,5.13947384483916,5.13947384483916
"35","059","G3500590","2010","4","8","New Mexico","Union County",4549,"","Union County New Mexico",3766,4230,-783,-17.2125741921301,17.2125741921301,-319,-7.01253022642339,7.01253022642339
"35","061","G3500610","2010","4","8","New Mexico","Valencia County",76569,"","Valencia County New Mexico",73544,73012,-3025,-3.95068500306913,3.95068500306913,-3557,-4.64548315898079,4.64548315898079
"36","001","G3600010","2010","1","2","New York","Albany County",304204,"","Albany County New York",296121,303851,-8083,-2.65709852598914,2.65709852598914,-353,-0.11604055173502,0.11604055173502
"36","003","G3600030","2010","1","2","New York","Allegany County",48946,"","Allegany County New York",49144,51012,198,0.404527438401504,0.404527438401504,2066,4.2209782208965,4.2209782208965
"36","005","G3600050","2010","1","2","New York","Bronx County",1385108,"","Bronx County New York",1400761,1395461,15653,1.13009238268785,1.13009238268785,10353,0.747450740303283,0.747450740303283
"36","007","G3600070","2010","1","2","New York","Broome County",200600,"","Broome County New York",192230,200801,-8370,-4.17248255234297,4.17248255234297,201,0.100199401794616,0.100199401794616
"36","009","G3600090","2010","1","2","New York","Cattaraugus County",80317,"","Cattaraugus County New York",79219,85746,-1098,-1.36708293387452,1.36708293387452,5429,6.75946561749069,6.75946561749069
"36","011","G3600110","2010","1","2","New York","Cayuga County",80026,"","Cayuga County New York",79184,83202,-842,-1.05215804863419,1.05215804863419,3176,3.96871016919501,3.96871016919501
"36","013","G3600130","2010","1","2","New York","Chautauqua County",134905,"","Chautauqua County New York",132851,141873,-2054,-1.52255290760165,1.52255290760165,6968,5.16511619287647,5.16511619287647
"36","015","G3600150","2010","1","2","New York","Chemung County",88830,"","Chemung County New York",88246,91901,-584,-0.657435551052572,0.657435551052572,3071,3.45716537205899,3.45716537205899
"36","017","G3600170","2010","1","2","New York","Chenango County",50477,"","Chenango County New York",49933,52647,-544,-1.07771856489094,1.07771856489094,2170,4.29898765774511,4.29898765774511
"36","019","G3600190","2010","1","2","New York","Clinton County",82128,"","Clinton County New York",81415,84481,-713,-0.868157023183324,0.868157023183324,2353,2.86503993765829,2.86503993765829
"36","021","G3600210","2010","1","2","New York","Columbia County",63096,"","Columbia County New York",61637,67233,-1459,-2.3123494357804,2.3123494357804,4137,6.55667554203119,6.55667554203119
"36","023","G3600230","2010","1","2","New York","Cortland County",49336,"","Cortland County New York",47789,49544,-1547,-3.13564131668558,3.13564131668558,208,0.421598832495541,0.421598832495541
"36","025","G3600250","2010","1","2","New York","Delaware County",47980,"","Delaware County New York",44906,49321,-3074,-6.40683618174239,6.40683618174239,1341,2.79491454772822,2.79491454772822
"36","027","G3600270","2010","1","2","New York","Dutchess County",297488,"","Dutchess County New York",292365,299341,-5123,-1.72208626902598,1.72208626902598,1853,0.622882267520035,0.622882267520035
"36","029","G3600290","2010","1","2","New York","Erie County",919040,"","Erie County New York",906657,968443,-12383,-1.3473842270195,1.3473842270195,49403,5.37550052228412,5.37550052228412
"36","031","G3600310","2010","1","2","New York","Essex County",39370,"","Essex County New York",37426,41393,-1944,-4.93776987553975,4.93776987553975,2023,5.13843027686055,5.13843027686055
"36","033","G3600330","2010","1","2","New York","Franklin County",51599,"","Franklin County New York",49981,52582,-1618,-3.13571968449001,3.13571968449001,983,1.90507567976124,1.90507567976124
"36","035","G3600350","2010","1","2","New York","Fulton County",55531,"","Fulton County New York",55090,55897,-441,-0.794151014748519,0.794151014748519,366,0.659091318362716,0.659091318362716
"36","037","G3600370","2010","1","2","New York","Genesee County",60079,"","Genesee County New York",57954,61576,-2125,-3.53700960402137,3.53700960402137,1497,2.49171923633882,2.49171923633882
"36","039","G3600390","2010","1","2","New York","Greene County",49221,"","Greene County New York",48563,51742,-658,-1.33682777676195,1.33682777676195,2521,5.12179760671258,5.12179760671258
"36","041","G3600410","2010","1","2","New York","Hamilton County",4836,"","Hamilton County New York",4906,5650,70,1.44747725392887,1.44747725392887,814,16.8320926385443,16.8320926385443
"36","043","G3600430","2010","1","2","New York","Herkimer County",64519,"","Herkimer County New York",62053,65912,-2466,-3.82212991521877,3.82212991521877,1393,2.15905392210047,2.15905392210047
"36","045","G3600450","2010","1","2","New York","Jefferson County",116229,"","Jefferson County New York",117196,120327,967,0.831978249834379,0.831978249834379,4098,3.52579820870867,3.52579820870867
"36","047","G3600470","2010","1","2","New York","Kings County",2504700,"","Kings County New York",2581109,2586053,76409,3.05062482532838,3.05062482532838,81353,3.24801373417974,3.24801373417974
"36","049","G3600490","2010","1","2","New York","Lewis County",27087,"","Lewis County New York",26032,28960,-1055,-3.8948573116255,3.8948573116255,1873,6.91475615608964,6.91475615608964
"36","051","G3600510","2010","1","2","New York","Livingston County",65393,"","Livingston County New York",62759,67706,-2634,-4.02795406236141,4.02795406236141,2313,3.53707583380484,3.53707583380484
"36","053","G3600530","2010","1","2","New York","Madison County",73442,"","Madison County New York",69925,72378,-3517,-4.78881294082405,4.78881294082405,-1064,-1.4487622886087,1.4487622886087
"36","055","G3600550","2010","1","2","New York","Monroe County",744344,"","Monroe County New York",733665,761176,-10679,-1.43468611287254,1.43468611287254,16832,2.26132003482261,2.26132003482261
"36","057","G3600570","2010","1","2","New York","Montgomery County",50219,"","Montgomery County New York",48601,49736,-1618,-3.22188812999064,3.22188812999064,-483,-0.961787371313646,0.961787371313646
"36","059","G3600590","2010","1","2","New York","Nassau County",1339532,"","Nassau County New York",1363061,1335647,23529,1.75650898970685,1.75650898970685,-3885,-0.290026666029628,0.290026666029628
"36","061","G3600610","2010","1","2","New York","New York County",1585873,"","New York County New York",1630494,1652193,44621,2.81365531792268,2.81365531792268,66320,4.18192377321513,4.18192377321513
"36","063","G3600630","2010","1","2","New York","Niagara County",216469,"","Niagara County New York",213767,226568,-2702,-1.2482156798433,1.2482156798433,10099,4.6653331423899,4.6653331423899
"36","065","G3600650","2010","1","2","New York","Oneida County",234878,"","Oneida County New York",229809,238023,-5069,-2.15814167354967,2.15814167354967,3145,1.33899300913666,1.33899300913666
"36","067","G3600670","2010","1","2","New York","Onondaga County",467026,"","Onondaga County New York",455729,474155,-11297,-2.41892314346525,2.41892314346525,7129,1.52646747718542,1.52646747718542
"36","069","G3600690","2010","1","2","New York","Ontario County",107931,"","Ontario County New York",105881,108597,-2050,-1.89936162918902,1.89936162918902,666,0.617060900019457,0.617060900019457
"36","071","G3600710","2010","1","2","New York","Orange County",372813,"","Orange County New York",382517,377023,9704,2.6029135250112,2.6029135250112,4210,1.12925246705453,1.12925246705453
"36","073","G3600730","2010","1","2","New York","Orleans County",42883,"","Orleans County New York",41518,44782,-1365,-3.18307954200965,3.18307954200965,1899,4.42832824196068,4.42832824196068
"36","075","G3600750","2010","1","2","New York","Oswego County",122109,"","Oswego County New York",121254,125856,-855,-0.700194088887797,0.700194088887797,3747,3.06856988428371,3.06856988428371
"36","077","G3600770","2010","1","2","New York","Otsego County",62259,"","Otsego County New York",61631,66505,-628,-1.00868950673798,1.00868950673798,4246,6.81989752485585,6.81989752485585
"36","079","G3600790","2010","1","2","New York","Putnam County",99710,"","Putnam County New York",99360,99837,-350,-0.351017952060977,0.351017952060977,127,0.127369371176412,0.127369371176412
"36","081","G3600810","2010","1","2","New York","Queens County",2230722,"","Queens County New York",2316711,2306553,85989,3.8547609249382,3.8547609249382,75831,3.39939266300328,3.39939266300328
"36","083","G3600830","2010","1","2","New York","Rensselaer County",159429,"","Rensselaer County New York",155559,160090,-3870,-2.4274128295354,2.4274128295354,661,0.414604620238476,0.414604620238476
"36","085","G3600850","2010","1","2","New York","Richmond County",468730,"","Richmond County New York",492714,487799,23984,5.1168049836793,5.1168049836793,19069,4.06822691101487,4.06822691101487
"36","087","G3600870","2010","1","2","New York","Rockland County",311687,"","Rockland County New York",301376,300794,-10311,-3.30812642169869,3.30812642169869,-10893,-3.49485220750304,3.49485220750304
"36","089","G3600890","2010","1","2","New York","St. Lawrence County",111944,"","St. Lawrence County New York",109531,114765,-2413,-2.15554205674266,2.15554205674266,2821,2.5200100050025,2.5200100050025
"36","091","G3600910","2010","1","2","New York","Saratoga County",219607,"","Saratoga County New York",219644,223878,37,0.0168482789710711,0.0168482789710711,4271,1.94483782393093,1.94483782393093
"36","093","G3600930","2010","1","2","New York","Schenectady County",154727,"","Schenectady County New York",152265,150312,-2462,-1.59118964369502,1.59118964369502,-4415,-2.85341278509892,2.85341278509892
"36","095","G3600950","2010","1","2","New York","Schoharie County",32749,"","Schoharie County New York",31384,33007,-1365,-4.16806620049467,4.16806620049467,258,0.787810314818773,0.787810314818773
"36","097","G3600970","2010","1","2","New York","Schuyler County",18343,"","Schuyler County New York",18572,19864,229,1.24843264460557,1.24843264460557,1521,8.29199149539334,8.29199149539334
"36","099","G3600990","2010","1","2","New York","Seneca County",35251,"","Seneca County New York",33673,33698,-1578,-4.4764687526595,4.4764687526595,-1553,-4.40554877875805,4.40554877875805
"36","101","G3601010","2010","1","2","New York","Steuben County",98990,"","Steuben County New York",96192,100725,-2798,-2.82654813617537,2.82654813617537,1735,1.75270229316093,1.75270229316093
"36","103","G3601030","2010","1","2","New York","Suffolk County",1493350,"","Suffolk County New York",1520140,1483472,26790,1.79395319248669,1.79395319248669,-9878,-0.661465831854555,0.661465831854555
"36","105","G3601050","2010","1","2","New York","Sullivan County",77547,"","Sullivan County New York",75362,81526,-2185,-2.8176460727043,2.8176460727043,3979,5.13108179555624,5.13108179555624
"36","107","G3601070","2010","1","2","New York","Tioga County",51125,"","Tioga County New York",49683,53124,-1442,-2.82053789731051,2.82053789731051,1999,3.91002444987775,3.91002444987775
"36","109","G3601090","2010","1","2","New York","Tompkins County",101564,"","Tompkins County New York",102472,102554,908,0.894017565279036,0.894017565279036,990,0.974754834390138,0.974754834390138
"36","111","G3601110","2010","1","2","New York","Ulster County",182493,"","Ulster County New York",180893,188596,-1600,-0.876745957379187,0.876745957379187,6103,3.34423786117824,3.34423786117824
"36","113","G3601130","2010","1","2","New York","Warren County",65707,"","Warren County New York",65696,68919,-11,-0.0167409865006772,0.0167409865006772,3212,4.88836805819776,4.88836805819776
"36","115","G3601150","2010","1","2","New York","Washington County",63216,"","Washington County New York",62572,65546,-644,-1.01872943558593,1.01872943558593,2330,3.68577575297393,3.68577575297393
"36","117","G3601170","2010","1","2","New York","Wayne County",93772,"","Wayne County New York",91168,97743,-2604,-2.77694834278889,2.77694834278889,3971,4.23473958111163,4.23473958111163
"36","119","G3601190","2010","1","2","New York","Westchester County",949113,"","Westchester County New York",960102,955019,10989,1.15781787837697,1.15781787837697,5906,0.622265209727398,0.622265209727398
"36","121","G3601210","2010","1","2","New York","Wyoming County",42155,"","Wyoming County New York",41380,44403,-775,-1.83845332700747,1.83845332700747,2248,5.33270074724232,5.33270074724232
"36","123","G3601230","2010","1","2","New York","Yates County",25348,"","Yates County New York",24374,25572,-974,-3.84251222976172,3.84251222976172,224,0.883698911156699,0.883698911156699
"37","001","G3700010","2010","3","5","North Carolina","Alamance County",151131,"","Alamance County North Carolina",151469,155994,338,0.223647034691757,0.223647034691757,4863,3.2177382535681,3.2177382535681
"37","003","G3700030","2010","3","5","North Carolina","Alexander County",37198,"","Alexander County North Carolina",36953,37619,-245,-0.658637561159202,0.658637561159202,421,1.13178127856336,1.13178127856336
"37","005","G3700050","2010","3","5","North Carolina","Alleghany County",11155,"","Alleghany County North Carolina",11045,12262,-110,-0.986104885701479,0.986104885701479,1107,9.92380098610489,9.92380098610489
"37","007","G3700070","2010","3","5","North Carolina","Anson County",26948,"","Anson County North Carolina",24940,26270,-2008,-7.45138785809708,7.45138785809708,-678,-2.51595665726585,2.51595665726585
"37","009","G3700090","2010","3","5","North Carolina","Ashe County",27281,"","Ashe County North Carolina",25942,29115,-1339,-4.90817785271801,4.90817785271801,1834,6.72262746966753,6.72262746966753
"37","011","G3700110","2010","3","5","North Carolina","Avery County",17797,"","Avery County North Carolina",17774,20001,-23,-0.1292352643704,0.1292352643704,2204,12.384109681407,12.384109681407
"37","013","G3700130","2010","3","5","North Carolina","Beaufort County",47759,"","Beaufort County North Carolina",46584,49011,-1175,-2.46026926861953,2.46026926861953,1252,2.62149542494608,2.62149542494608
"37","015","G3700150","2010","3","5","North Carolina","Bertie County",21282,"","Bertie County North Carolina",19180,20536,-2102,-9.87689126961752,9.87689126961752,-746,-3.50530965134856,3.50530965134856
"37","017","G3700170","2010","3","5","North Carolina","Bladen County",35190,"","Bladen County North Carolina",32487,33918,-2703,-7.68115942028986,7.68115942028986,-1272,-3.61466325660699,3.61466325660699
"37","019","G3700190","2010","3","5","North Carolina","Brunswick County",107431,"","Brunswick County North Carolina",108485,112079,1054,0.981094842270853,0.981094842270853,4648,4.3264979382115,4.3264979382115
"37","021","G3700210","2010","3","5","North Carolina","Buncombe County",238318,"","Buncombe County North Carolina",232789,243860,-5529,-2.3200093992061,2.3200093992061,5542,2.32546429560503,2.32546429560503
"37","023","G3700230","2010","3","5","North Carolina","Burke County",90912,"","Burke County North Carolina",89146,94840,-1766,-1.94253783878916,1.94253783878916,3928,4.32066173882436,4.32066173882436
"37","025","G3700250","2010","3","5","North Carolina","Cabarrus County",178011,"","Cabarrus County North Carolina",173867,176010,-4144,-2.32794602580739,2.32794602580739,-2001,-1.12408783726848,1.12408783726848
"37","027","G3700270","2010","3","5","North Carolina","Caldwell County",83029,"","Caldwell County North Carolina",79673,84457,-3356,-4.04196124245745,4.04196124245745,1428,1.71988100543184,1.71988100543184
"37","029","G3700290","2010","3","5","North Carolina","Camden County",9980,"","Camden County North Carolina",9754,9443,-226,-2.26452905811623,2.26452905811623,-537,-5.38076152304609,5.38076152304609
"37","031","G3700310","2010","3","5","North Carolina","Carteret County",66469,"","Carteret County North Carolina",64836,67400,-1633,-2.45678436564413,2.45678436564413,931,1.40065293595511,1.40065293595511
"37","033","G3700330","2010","3","5","North Carolina","Caswell County",23719,"","Caswell County North Carolina",22815,25219,-904,-3.81129052658207,3.81129052658207,1500,6.32404401534635,6.32404401534635
"37","035","G3700350","2010","3","5","North Carolina","Catawba County",154358,"","Catawba County North Carolina",159060,160709,4702,3.04616540768862,3.04616540768862,6351,4.11446118762876,4.11446118762876
"37","037","G3700370","2010","3","5","North Carolina","Chatham County",63505,"","Chatham County North Carolina",65647,61584,2142,3.37296275883789,3.37296275883789,-1921,-3.02495866467207,3.02495866467207
"37","039","G3700390","2010","3","5","North Carolina","Cherokee County",27444,"","Cherokee County North Carolina",26258,30123,-1186,-4.32152747412914,4.32152747412914,2679,9.76169654569305,9.76169654569305
"37","041","G3700410","2010","3","5","North Carolina","Chowan County",14793,"","Chowan County North Carolina",14992,15978,199,1.3452308524302,1.3452308524302,1185,8.01054552829041,8.01054552829041
"37","043","G3700430","2010","3","5","North Carolina","Clay County",10587,"","Clay County North Carolina",10319,11226,-268,-2.53140644186266,2.53140644186266,639,6.03570416548597,6.03570416548597
"37","045","G3700450","2010","3","5","North Carolina","Cleveland County",98078,"","Cleveland County North Carolina",99127,103613,1049,1.06955688329697,1.06955688329697,5535,5.64346744427904,5.64346744427904
"37","047","G3700470","2010","3","5","North Carolina","Columbus County",58098,"","Columbus County North Carolina",55171,56833,-2927,-5.03803917518675,5.03803917518675,-1265,-2.17735550277118,2.17735550277118
"37","049","G3700490","2010","3","5","North Carolina","Craven County",103505,"","Craven County North Carolina",98997,108841,-4508,-4.3553451524081,4.3553451524081,5336,5.15530650693203,5.15530650693203
"37","051","G3700510","2010","3","5","North Carolina","Cumberland County",319431,"","Cumberland County North Carolina",309619,358452,-9812,-3.07171188770032,3.07171188770032,39021,12.2157836903744,12.2157836903744
"37","053","G3700530","2010","3","5","North Carolina","Currituck County",23547,"","Currituck County North Carolina",24457,24134,910,3.86461120312566,3.86461120312566,587,2.49288656729095,2.49288656729095
"37","055","G3700550","2010","3","5","North Carolina","Dare County",33920,"","Dare County North Carolina",34554,37088,634,1.86910377358491,1.86910377358491,3168,9.33962264150943,9.33962264150943
"37","057","G3700570","2010","3","5","North Carolina","Davidson County",162878,"","Davidson County North Carolina",158807,165765,-4071,-2.4994167413647,2.4994167413647,2887,1.77249229484645,1.77249229484645
"37","059","G3700590","2010","3","5","North Carolina","Davie County",41240,"","Davie County North Carolina",41731,41455,491,1.1905916585839,1.1905916585839,215,0.521338506304559,0.521338506304559
"37","061","G3700610","2010","3","5","North Carolina","Duplin County",58505,"","Duplin County North Carolina",53715,51755,-4790,-8.18733441586189,8.18733441586189,-6750,-11.5374754294505,11.5374754294505
"37","063","G3700630","2010","3","5","North Carolina","Durham County",267587,"","Durham County North Carolina",272282,280473,4695,1.75456954186863,1.75456954186863,12886,4.81563005676658,4.81563005676658
"37","065","G3700650","2010","3","5","North Carolina","Edgecombe County",56552,"","Edgecombe County North Carolina",51794,59041,-4758,-8.41349554392418,8.41349554392418,2489,4.40125901824869,4.40125901824869
"37","067","G3700670","2010","3","5","North Carolina","Forsyth County",350670,"","Forsyth County North Carolina",360808,363231,10138,2.89103715744147,2.89103715744147,12561,3.58200017110104,3.58200017110104
"37","069","G3700690","2010","3","5","North Carolina","Franklin County",60619,"","Franklin County North Carolina",60878,57361,259,0.427258780250417,0.427258780250417,-3258,-5.3745525330342,5.3745525330342
"37","071","G3700710","2010","3","5","North Carolina","Gaston County",206086,"","Gaston County North Carolina",208696,216327,2610,1.26646157429423,1.26646157429423,10241,4.96928466756597,4.96928466756597
"37","073","G3700730","2010","3","5","North Carolina","Gates County",12197,"","Gates County North Carolina",11780,11405,-417,-3.418873493482,3.418873493482,-792,-6.49340001639747,6.49340001639747
"37","075","G3700750","2010","3","5","North Carolina","Graham County",8861,"","Graham County North Carolina",7910,8941,-951,-10.7324229770906,10.7324229770906,80,0.902832637399842,0.902832637399842
"37","077","G3700770","2010","3","5","North Carolina","Granville County",59916,"","Granville County North Carolina",58450,60948,-1466,-2.44675879564724,2.44675879564724,1032,1.7224113759263,1.7224113759263
"37","079","G3700790","2010","3","5","North Carolina","Greene County",21362,"","Greene County North Carolina",20605,19657,-757,-3.54367568579721,3.54367568579721,-1705,-7.98146240988672,7.98146240988672
"37","081","G3700810","2010","3","5","North Carolina","Guilford County",488406,"","Guilford County North Carolina",482656,505566,-5750,-1.17729921417837,1.17729921417837,17160,3.51347035048709,3.51347035048709
"37","083","G3700830","2010","3","5","North Carolina","Halifax County",54691,"","Halifax County North Carolina",54270,59667,-421,-0.769779305553016,0.769779305553016,4976,9.098389131667,9.098389131667
"37","085","G3700850","2010","3","5","North Carolina","Harnett County",114678,"","Harnett County North Carolina",118408,112153,3730,3.25258550027032,3.25258550027032,-2525,-2.20181726224734,2.20181726224734
"37","087","G3700870","2010","3","5","North Carolina","Haywood County",59036,"","Haywood County North Carolina",56761,61657,-2275,-3.85358086591232,3.85358086591232,2621,4.43966393387086,4.43966393387086
"37","089","G3700890","2010","3","5","North Carolina","Henderson County",106740,"","Henderson County North Carolina",104496,106351,-2244,-2.10230466554244,2.10230466554244,-389,-0.364436949597152,0.364436949597152
"37","091","G3700910","2010","3","5","North Carolina","Hertford County",24669,"","Hertford County North Carolina",22782,23497,-1887,-7.64927641979813,7.64927641979813,-1172,-4.75090194170822,4.75090194170822
"37","093","G3700930","2010","3","5","North Carolina","Hoke County",46952,"","Hoke County North Carolina",46236,46259,-716,-1.52496166297495,1.52496166297495,-693,-1.47597546430397,1.47597546430397
"37","095","G3700950","2010","3","5","North Carolina","Hyde County",5810,"","Hyde County North Carolina",5212,6226,-598,-10.2925989672978,10.2925989672978,416,7.16006884681583,7.16006884681583
"37","097","G3700970","2010","3","5","North Carolina","Iredell County",159437,"","Iredell County North Carolina",158942,168423,-495,-0.310467457365605,0.310467457365605,8986,5.63608196340874,5.63608196340874
"37","099","G3700990","2010","3","5","North Carolina","Jackson County",40271,"","Jackson County North Carolina",37503,42185,-2768,-6.87343249484741,6.87343249484741,1914,4.75279978148047,4.75279978148047
"37","101","G3701010","2010","3","5","North Carolina","Johnston County",168878,"","Johnston County North Carolina",170862,158908,1984,1.17481258660098,1.17481258660098,-9970,-5.90367010504625,5.90367010504625
"37","103","G3701030","2010","3","5","North Carolina","Jones County",10153,"","Jones County North Carolina",10004,10789,-149,-1.46754653796907,1.46754653796907,636,6.26415837683443,6.26415837683443
"37","105","G3701050","2010","3","5","North Carolina","Lee County",57866,"","Lee County North Carolina",60608,58797,2742,4.73853385407666,4.73853385407666,931,1.60888950333529,1.60888950333529
"37","107","G3701070","2010","3","5","North Carolina","Lenoir County",59495,"","Lenoir County North Carolina",56412,61731,-3083,-5.18194806286242,5.18194806286242,2236,3.75829901672409,3.75829901672409
"37","109","G3701090","2010","3","5","North Carolina","Lincoln County",78265,"","Lincoln County North Carolina",76526,79380,-1739,-2.22193828659043,2.22193828659043,1115,1.42464703251773,1.42464703251773
"37","111","G3701110","2010","3","5","North Carolina","McDowell County",44996,"","McDowell County North Carolina",44106,46303,-890,-1.97795359587519,1.97795359587519,1307,2.90470264023469,2.90470264023469
"37","113","G3701130","2010","3","5","North Carolina","Macon County",33922,"","Macon County North Carolina",33316,34173,-606,-1.78645127056188,1.78645127056188,251,0.7399327869819,0.7399327869819
"37","115","G3701150","2010","3","5","North Carolina","Madison County",20764,"","Madison County North Carolina",20463,22228,-301,-1.44962434983625,1.44962434983625,1464,7.05066461182816,7.05066461182816
"37","117","G3701170","2010","3","5","North Carolina","Martin County",24505,"","Martin County North Carolina",23362,26219,-1143,-4.66435421342583,4.66435421342583,1714,6.99449092022036,6.99449092022036
"37","119","G3701190","2010","3","5","North Carolina","Mecklenburg County",919628,"","Mecklenburg County North Carolina",924762,984694,5134,0.5582692132036,0.5582692132036,65066,7.07525216718064,7.07525216718064
"37","121","G3701210","2010","3","5","North Carolina","Mitchell County",15579,"","Mitchell County North Carolina",15498,16757,-81,-0.519930675909879,0.519930675909879,1178,7.56146094101033,7.56146094101033
"37","123","G3701230","2010","3","5","North Carolina","Montgomery County",27798,"","Montgomery County North Carolina",27794,28395,-4,-0.0143895244262177,0.0143895244262177,597,2.14763652061299,2.14763652061299
"37","125","G3701250","2010","3","5","North Carolina","Moore County",88247,"","Moore County North Carolina",88035,89582,-212,-0.240234795517128,0.240234795517128,1335,1.51279930195927,1.51279930195927
"37","127","G3701270","2010","3","5","North Carolina","Nash County",95840,"","Nash County North Carolina",95104,98713,-736,-0.767946577629382,0.767946577629382,2873,2.99770450751252,2.99770450751252
"37","129","G3701290","2010","3","5","North Carolina","New Hanover County",202667,"","New Hanover County North Carolina",196727,202817,-5940,-2.93091623204567,2.93091623204567,150,0.0740130361627695,0.0740130361627695
"37","131","G3701310","2010","3","5","North Carolina","Northampton County",22099,"","Northampton County North Carolina",19923,23106,-2176,-9.84659939363772,9.84659939363772,1007,4.55676727453731,4.55676727453731
"37","133","G3701330","2010","3","5","North Carolina","Onslow County",177772,"","Onslow County North Carolina",168973,187483,-8799,-4.94959836194676,4.94959836194676,9711,5.46261503498864,5.46261503498864
"37","135","G3701350","2010","3","5","North Carolina","Orange County",133801,"","Orange County North Carolina",130450,136178,-3351,-2.50446558695376,2.50446558695376,2377,1.77651886009821,1.77651886009821
"37","137","G3701370","2010","3","5","North Carolina","Pamlico County",13144,"","Pamlico County North Carolina",12302,14288,-842,-6.40596469872185,6.40596469872185,1144,8.70359099208764,8.70359099208764
"37","139","G3701390","2010","3","5","North Carolina","Pasquotank County",40661,"","Pasquotank County North Carolina",41643,40345,982,2.4150906273825,2.4150906273825,-316,-0.777157472762598,0.777157472762598
"37","141","G3701410","2010","3","5","North Carolina","Pender County",52217,"","Pender County North Carolina",53111,51351,894,1.71208610222724,1.71208610222724,-866,-1.6584637187123,1.6584637187123
"37","143","G3701430","2010","3","5","North Carolina","Perquimans County",13453,"","Perquimans County North Carolina",12794,13064,-659,-4.8985356426076,4.8985356426076,-389,-2.89154835352709,2.89154835352709
"37","145","G3701450","2010","3","5","North Carolina","Person County",39464,"","Person County North Carolina",37566,39719,-1898,-4.80944658422866,4.80944658422866,255,0.64615852422461,0.64615852422461
"37","147","G3701470","2010","3","5","North Carolina","Pitt County",168148,"","Pitt County North Carolina",160555,173393,-7593,-4.51566477151081,4.51566477151081,5245,3.11927587601399,3.11927587601399
"37","149","G3701490","2010","3","5","North Carolina","Polk County",20510,"","Polk County North Carolina",19067,21048,-1443,-7.03559239395417,7.03559239395417,538,2.62311067771819,2.62311067771819
"37","151","G3701510","2010","3","5","North Carolina","Randolph County",141752,"","Randolph County North Carolina",142582,145614,830,0.585529657429878,0.585529657429878,3862,2.72447655059541,2.72447655059541
"37","153","G3701530","2010","3","5","North Carolina","Richmond County",46639,"","Richmond County North Carolina",45976,52435,-663,-1.42155706597483,1.42155706597483,5796,12.4273676536804,12.4273676536804
"37","155","G3701550","2010","3","5","North Carolina","Robeson County",134168,"","Robeson County North Carolina",130372,130263,-3796,-2.82928865303202,2.82928865303202,-3905,-2.91053008168863,2.91053008168863
"37","157","G3701570","2010","3","5","North Carolina","Rockingham County",93643,"","Rockingham County North Carolina",92289,98990,-1354,-1.44591693986737,1.44591693986737,5347,5.70998366135216,5.70998366135216
"37","159","G3701590","2010","3","5","North Carolina","Rowan County",138428,"","Rowan County North Carolina",141040,146324,2612,1.88690149391742,1.88690149391742,7896,5.70404831392493,5.70404831392493
"37","161","G3701610","2010","3","5","North Carolina","Rutherford County",67810,"","Rutherford County North Carolina",63337,68973,-4473,-6.59637221648724,6.59637221648724,1163,1.71508627046158,1.71508627046158
"37","163","G3701630","2010","3","5","North Carolina","Sampson County",63431,"","Sampson County North Carolina",64127,63390,696,1.09725528527061,1.09725528527061,-41,-0.0646371647932399,0.0646371647932399
"37","165","G3701650","2010","3","5","North Carolina","Scotland County",36157,"","Scotland County North Carolina",36022,37633,-135,-0.373371684597727,0.373371684597727,1476,4.08219708493514,4.08219708493514
"37","167","G3701670","2010","3","5","North Carolina","Stanly County",60585,"","Stanly County North Carolina",59817,65574,-768,-1.26764050507551,1.26764050507551,4989,8.23471156226789,8.23471156226789
"37","169","G3701690","2010","3","5","North Carolina","Stokes County",47401,"","Stokes County North Carolina",45850,48266,-1551,-3.27208286745005,3.27208286745005,865,1.82485601569587,1.82485601569587
"37","171","G3701710","2010","3","5","North Carolina","Surry County",73673,"","Surry County North Carolina",72474,75338,-1199,-1.62746189241649,1.62746189241649,1665,2.25998669797619,2.25998669797619
"37","173","G3701730","2010","3","5","North Carolina","Swain County",13981,"","Swain County North Carolina",13448,15208,-533,-3.81231671554252,3.81231671554252,1227,8.77619626636149,8.77619626636149
"37","175","G3701750","2010","3","5","North Carolina","Transylvania County",33090,"","Transylvania County North Carolina",30253,33230,-2837,-8.57358718646117,8.57358718646117,140,0.423088546388637,0.423088546388637
"37","177","G3701770","2010","3","5","North Carolina","Tyrrell County",4407,"","Tyrrell County North Carolina",4076,4435,-331,-7.51077830723848,7.51077830723848,28,0.635352847742228,0.635352847742228
"37","179","G3701790","2010","3","5","North Carolina","Union County",201292,"","Union County North Carolina",201080,191750,-212,-0.105319635156887,0.105319635156887,-9542,-4.74037716352364,4.74037716352364
"37","181","G3701810","2010","3","5","North Carolina","Vance County",45422,"","Vance County North Carolina",43082,45266,-2340,-5.15168860904408,5.15168860904408,-156,-0.343445907269605,0.343445907269605
"37","183","G3701830","2010","3","5","North Carolina","Wake County",900993,"","Wake County North Carolina",914068,881755,13075,1.45117664621146,1.45117664621146,-19238,-2.13519971853277,2.13519971853277
"37","185","G3701850","2010","3","5","North Carolina","Warren County",20972,"","Warren County North Carolina",19229,21568,-1743,-8.31108144192256,8.31108144192256,596,2.84188441731833,2.84188441731833
"37","187","G3701870","2010","3","5","North Carolina","Washington County",13228,"","Washington County North Carolina",12757,13992,-471,-3.56062896885395,3.56062896885395,764,5.77562745690959,5.77562745690959
"37","189","G3701890","2010","3","5","North Carolina","Watauga County",51079,"","Watauga County North Carolina",45109,51549,-5970,-11.687777756025,11.687777756025,470,0.920143307425752,0.920143307425752
"37","191","G3701910","2010","3","5","North Carolina","Wayne County",122623,"","Wayne County North Carolina",114194,123808,-8429,-6.87391435538194,6.87391435538194,1185,0.966376617763389,0.966376617763389
"37","193","G3701930","2010","3","5","North Carolina","Wilkes County",69340,"","Wilkes County North Carolina",66258,69887,-3082,-4.44476492644938,4.44476492644938,547,0.788866455148543,0.788866455148543
"37","195","G3701950","2010","3","5","North Carolina","Wilson County",81234,"","Wilson County North Carolina",78696,83365,-2538,-3.12430755594948,3.12430755594948,2131,2.62328581628382,2.62328581628382
"37","197","G3701970","2010","3","5","North Carolina","Yadkin County",38406,"","Yadkin County North Carolina",37750,39192,-656,-1.70806644795084,1.70806644795084,786,2.04655522574598,2.04655522574598
"37","199","G3701990","2010","3","5","North Carolina","Yancey County",17818,"","Yancey County North Carolina",18410,19567,592,3.32248288247839,3.32248288247839,1749,9.81591648894376,9.81591648894376
"38","001","G3800010","2010","2","4","North Dakota","Adams County",2343,"","Adams County North Dakota",2244,2611,-99,-4.22535211267606,4.22535211267606,268,11.4383269312847,11.4383269312847
"38","003","G3800030","2010","2","4","North Dakota","Barnes County",11066,"","Barnes County North Dakota",10704,12296,-362,-3.27128140249413,3.27128140249413,1230,11.1151274173143,11.1151274173143
"38","005","G3800050","2010","2","4","North Dakota","Benson County",6660,"","Benson County North Dakota",6937,7130,277,4.15915915915916,4.15915915915916,470,7.05705705705706,7.05705705705706
"38","007","G3800070","2010","2","4","North Dakota","Billings County",783,"","Billings County North Dakota",822,895,39,4.98084291187739,4.98084291187739,112,14.3039591315453,14.3039591315453
"38","009","G3800090","2010","2","4","North Dakota","Bottineau County",6429,"","Bottineau County North Dakota",6379,7380,-50,-0.777725929382486,0.777725929382486,951,14.7923471768549,14.7923471768549
"38","011","G3800110","2010","2","4","North Dakota","Bowman County",3151,"","Bowman County North Dakota",2994,3261,-157,-4.9825452237385,4.9825452237385,110,3.49095525230086,3.49095525230086
"38","013","G3800130","2010","2","4","North Dakota","Burke County",1968,"","Burke County North Dakota",1845,2268,-123,-6.25,6.25,300,15.2439024390244,15.2439024390244
"38","015","G3800150","2010","2","4","North Dakota","Burleigh County",81308,"","Burleigh County North Dakota",81125,82855,-183,-0.225070103802824,0.225070103802824,1547,1.90264180646431,1.90264180646431
"38","017","G3800170","2010","2","4","North Dakota","Cass County",149778,"","Cass County North Dakota",144804,153885,-4974,-3.32091495413212,3.32091495413212,4107,2.74205824620438,2.74205824620438
"38","019","G3800190","2010","2","4","North Dakota","Cavalier County",3993,"","Cavalier County North Dakota",3711,4887,-282,-7.06235912847483,7.06235912847483,894,22.389181066867,22.389181066867
"38","021","G3800210","2010","2","4","North Dakota","Dickey County",5289,"","Dickey County North Dakota",5265,5837,-24,-0.453771979580261,0.453771979580261,548,10.3611268670826,10.3611268670826
"38","023","G3800230","2010","2","4","North Dakota","Divide County",2071,"","Divide County North Dakota",2040,2283,-31,-1.49686141960406,1.49686141960406,212,10.2366006760019,10.2366006760019
"38","025","G3800250","2010","2","4","North Dakota","Dunn County",3536,"","Dunn County North Dakota",3357,3646,-179,-5.06221719457014,5.06221719457014,110,3.11085972850679,3.11085972850679
"38","027","G3800270","2010","2","4","North Dakota","Eddy County",2385,"","Eddy County North Dakota",2287,2789,-98,-4.10901467505241,4.10901467505241,404,16.9392033542977,16.9392033542977
"38","029","G3800290","2010","2","4","North Dakota","Emmons County",3550,"","Emmons County North Dakota",3370,4341,-180,-5.07042253521127,5.07042253521127,791,22.2816901408451,22.2816901408451
"38","031","G3800310","2010","2","4","North Dakota","Foster County",3343,"","Foster County North Dakota",3286,3774,-57,-1.70505533951541,1.70505533951541,431,12.8926114268621,12.8926114268621
"38","033","G3800330","2010","2","4","North Dakota","Golden Valley County",1680,"","Golden Valley County North Dakota",1666,1913,-14,-0.833333333333333,0.833333333333333,233,13.8690476190476,13.8690476190476
"38","035","G3800350","2010","2","4","North Dakota","Grand Forks County",66861,"","Grand Forks County North Dakota",66195,72561,-666,-0.996096379055055,0.996096379055055,5700,8.52514919011083,8.52514919011083
"38","037","G3800370","2010","2","4","North Dakota","Grant County",2394,"","Grant County North Dakota",2312,2894,-82,-3.42522974101921,3.42522974101921,500,20.8855472013367,20.8855472013367
"38","039","G3800390","2010","2","4","North Dakota","Griggs County",2420,"","Griggs County North Dakota",2335,2779,-85,-3.51239669421488,3.51239669421488,359,14.8347107438017,14.8347107438017
"38","041","G3800410","2010","2","4","North Dakota","Hettinger County",2477,"","Hettinger County North Dakota",2357,2734,-120,-4.84457004440856,4.84457004440856,257,10.3754541784417,10.3754541784417
"38","043","G3800430","2010","2","4","North Dakota","Kidder County",2435,"","Kidder County North Dakota",2249,2842,-186,-7.63860369609856,7.63860369609856,407,16.7145790554415,16.7145790554415
"38","045","G3800450","2010","2","4","North Dakota","LaMoure County",4139,"","LaMoure County North Dakota",3839,4806,-300,-7.24812756704518,7.24812756704518,667,16.1150036240638,16.1150036240638
"38","047","G3800470","2010","2","4","North Dakota","Logan County",1990,"","Logan County North Dakota",1872,2344,-118,-5.92964824120603,5.92964824120603,354,17.7889447236181,17.7889447236181
"38","049","G3800490","2010","2","4","North Dakota","McHenry County",5395,"","McHenry County North Dakota",5169,6126,-226,-4.18906394810009,4.18906394810009,731,13.5495829471733,13.5495829471733
"38","051","G3800510","2010","2","4","North Dakota","McIntosh County",2809,"","McIntosh County North Dakota",2504,3406,-305,-10.8579565681737,10.8579565681737,597,21.2531149875401,21.2531149875401
"38","053","G3800530","2010","2","4","North Dakota","McKenzie County",6360,"","McKenzie County North Dakota",5986,5962,-374,-5.88050314465409,5.88050314465409,-398,-6.25786163522013,6.25786163522013
"38","055","G3800550","2010","2","4","North Dakota","McLean County",8962,"","McLean County North Dakota",8436,9719,-526,-5.86922561928141,5.86922561928141,757,8.44677527337648,8.44677527337648
"38","057","G3800570","2010","2","4","North Dakota","Mercer County",8424,"","Mercer County North Dakota",7883,8864,-541,-6.42212725546059,6.42212725546059,440,5.22317188983856,5.22317188983856
"38","059","G3800590","2010","2","4","North Dakota","Morton County",27471,"","Morton County North Dakota",26858,29056,-613,-2.2314440682902,2.2314440682902,1585,5.76972079647628,5.76972079647628
"38","061","G3800610","2010","2","4","North Dakota","Mountrail County",7673,"","Mountrail County North Dakota",6945,7024,-728,-9.48781441417959,9.48781441417959,-649,-8.45823015769582,8.45823015769582
"38","063","G3800630","2010","2","4","North Dakota","Nelson County",3126,"","Nelson County North Dakota",3090,3713,-36,-1.15163147792706,1.15163147792706,587,18.7779910428663,18.7779910428663
"38","065","G3800650","2010","2","4","North Dakota","Oliver County",1846,"","Oliver County North Dakota",1632,2052,-214,-11.5926327193933,11.5926327193933,206,11.1592632719393,11.1592632719393
"38","067","G3800670","2010","2","4","North Dakota","Pembina County",7413,"","Pembina County North Dakota",7432,8618,19,0.256306488601106,0.256306488601106,1205,16.2552273033859,16.2552273033859
"38","069","G3800690","2010","2","4","North Dakota","Pierce County",4357,"","Pierce County North Dakota",4000,4686,-357,-8.19371126922194,8.19371126922194,329,7.5510672481065,7.5510672481065
"38","071","G3800710","2010","2","4","North Dakota","Ramsey County",11451,"","Ramsey County North Dakota",11319,12243,-132,-1.15273775216138,1.15273775216138,792,6.9164265129683,6.9164265129683
"38","073","G3800730","2010","2","4","North Dakota","Ransom County",5457,"","Ransom County North Dakota",5460,6208,3,0.0549752611324904,0.0549752611324904,751,13.7621403701668,13.7621403701668
"38","075","G3800750","2010","2","4","North Dakota","Renville County",2470,"","Renville County North Dakota",2244,2662,-226,-9.1497975708502,9.1497975708502,192,7.77327935222672,7.77327935222672
"38","077","G3800770","2010","2","4","North Dakota","Richland County",16321,"","Richland County North Dakota",16186,18484,-135,-0.827155198823601,0.827155198823601,2163,13.2528644078181,13.2528644078181
"38","079","G3800790","2010","2","4","North Dakota","Rolette County",13937,"","Rolette County North Dakota",13861,13772,-76,-0.545311042548612,0.545311042548612,-165,-1.18389897395422,1.18389897395422
"38","081","G3800810","2010","2","4","North Dakota","Sargent County",3829,"","Sargent County North Dakota",3846,4546,17,0.443980151475581,0.443980151475581,717,18.7255158004701,18.7255158004701
"38","083","G3800830","2010","2","4","North Dakota","Sheridan County",1321,"","Sheridan County North Dakota",1198,1737,-123,-9.3111279333838,9.3111279333838,416,31.4912944738834,31.4912944738834
"38","085","G3800850","2010","2","4","North Dakota","Sioux County",4153,"","Sioux County North Dakota",4208,4203,55,1.32434384782085,1.32434384782085,50,1.20394895256441,1.20394895256441
"38","087","G3800870","2010","2","4","North Dakota","Slope County",727,"","Slope County North Dakota",644,784,-83,-11.4167812929849,11.4167812929849,57,7.8404401650619,7.8404401650619
"38","089","G3800890","2010","2","4","North Dakota","Stark County",24199,"","Stark County North Dakota",23102,24392,-1097,-4.53324517542047,4.53324517542047,193,0.797553617918096,0.797553617918096
"38","091","G3800910","2010","2","4","North Dakota","Steele County",1975,"","Steele County North Dakota",1778,2325,-197,-9.9746835443038,9.9746835443038,350,17.7215189873418,17.7215189873418
"38","093","G3800930","2010","2","4","North Dakota","Stutsman County",21100,"","Stutsman County North Dakota",20513,22481,-587,-2.78199052132701,2.78199052132701,1381,6.54502369668246,6.54502369668246
"38","095","G3800950","2010","2","4","North Dakota","Towner County",2246,"","Towner County North Dakota",2235,2909,-11,-0.489759572573464,0.489759572573464,663,29.5191451469279,29.5191451469279
"38","097","G3800970","2010","2","4","North Dakota","Traill County",8121,"","Traill County North Dakota",7819,8632,-302,-3.71875384804827,3.71875384804827,511,6.29232853096909,6.29232853096909
"38","099","G3800990","2010","2","4","North Dakota","Walsh County",11119,"","Walsh County North Dakota",10662,12358,-457,-4.11008184189226,4.11008184189226,1239,11.1430884072309,11.1430884072309
"38","101","G3801010","2010","2","4","North Dakota","Ward County",61675,"","Ward County North Dakota",57725,62779,-3950,-6.40453992703689,6.40453992703689,1104,1.79002837454398,1.79002837454398
"38","103","G3801030","2010","2","4","North Dakota","Wells County",4207,"","Wells County North Dakota",4073,5134,-134,-3.18516757784645,3.18516757784645,927,22.0347040646541,22.0347040646541
"38","105","G3801050","2010","2","4","North Dakota","Williams County",22398,"","Williams County North Dakota",20984,20916,-1414,-6.31306366639879,6.31306366639879,-1482,-6.61666220198232,6.61666220198232
"39","001","G3900010","2010","2","3","Ohio","Adams County",28550,"","Adams County Ohio",27928,27756,-622,-2.17863397548161,2.17863397548161,-794,-2.78108581436077,2.78108581436077
"39","003","G3900030","2010","2","3","Ohio","Allen County",106331,"","Allen County Ohio",103959,111345,-2372,-2.23076995419962,2.23076995419962,5014,4.71546397569853,4.71546397569853
"39","005","G3900050","2010","2","3","Ohio","Ashland County",53139,"","Ashland County Ohio",54973,55735,1834,3.45132576826813,3.45132576826813,2596,4.88530081484409,4.88530081484409
"39","007","G3900070","2010","2","3","Ohio","Ashtabula County",101497,"","Ashtabula County Ohio",100386,107201,-1111,-1.09461363390051,1.09461363390051,5704,5.61987053804546,5.61987053804546
"39","009","G3900090","2010","2","3","Ohio","Athens County",64757,"","Athens County Ohio",63190,63812,-1567,-2.41981561838875,2.41981561838875,-945,-1.45930169711383,1.45930169711383
"39","011","G3900110","2010","2","3","Ohio","Auglaize County",45949,"","Auglaize County Ohio",46227,49189,278,0.605018607586672,0.605018607586672,3240,7.05129600208927,7.05129600208927
"39","013","G3900130","2010","2","3","Ohio","Belmont County",70400,"","Belmont County Ohio",67800,70525,-2600,-3.69318181818182,3.69318181818182,125,0.177556818181818,0.177556818181818
"39","015","G3900150","2010","2","3","Ohio","Brown County",44846,"","Brown County Ohio",43947,49595,-899,-2.00463809481336,2.00463809481336,4749,10.589573206083,10.589573206083
"39","017","G3900170","2010","2","3","Ohio","Butler County",368130,"","Butler County Ohio",362865,370734,-5265,-1.43020128758862,1.43020128758862,2604,0.707358813462636,0.707358813462636
"39","019","G3900190","2010","2","3","Ohio","Carroll County",28836,"","Carroll County Ohio",28457,28869,-379,-1.31432931058399,1.31432931058399,33,0.114440282979609,0.114440282979609
"39","021","G3900210","2010","2","3","Ohio","Champaign County",40097,"","Champaign County Ohio",39430,41433,-667,-1.6634660947203,1.6634660947203,1336,3.3319200937726,3.3319200937726
"39","023","G3900230","2010","2","3","Ohio","Clark County",138333,"","Clark County Ohio",138938,147710,605,0.437350451446871,0.437350451446871,9377,6.77857055077241,6.77857055077241
"39","025","G3900250","2010","2","3","Ohio","Clermont County",197363,"","Clermont County Ohio",195523,200908,-1840,-0.932292273627782,0.932292273627782,3545,1.79618266848396,1.79618266848396
"39","027","G3900270","2010","2","3","Ohio","Clinton County",42040,"","Clinton County Ohio",42569,44268,529,1.25832540437678,1.25832540437678,2228,5.29971455756422,5.29971455756422
"39","029","G3900290","2010","2","3","Ohio","Columbiana County",107841,"","Columbiana County Ohio",107615,113478,-226,-0.209567789616194,0.209567789616194,5637,5.2271399560464,5.2271399560464
"39","031","G3900310","2010","2","3","Ohio","Coshocton County",36901,"","Coshocton County Ohio",35700,36647,-1201,-3.25465434541069,3.25465434541069,-254,-0.688328229587274,0.688328229587274
"39","033","G3900330","2010","2","3","Ohio","Crawford County",43784,"","Crawford County Ohio",43079,48212,-705,-1.61017723369267,1.61017723369267,4428,10.1132833911931,10.1132833911931
"39","035","G3900350","2010","2","3","Ohio","Cuyahoga County",1280122,"","Cuyahoga County Ohio",1271305,1399994,-8817,-0.68876247732638,0.68876247732638,119872,9.36410748350548,9.36410748350548
"39","037","G3900370","2010","2","3","Ohio","Darke County",52959,"","Darke County Ohio",51871,55272,-1088,-2.05441945656074,2.05441945656074,2313,4.36752959836855,4.36752959836855
"39","039","G3900390","2010","2","3","Ohio","Defiance County",39037,"","Defiance County Ohio",38220,41867,-817,-2.09288623613495,2.09288623613495,2830,7.24953249481261,7.24953249481261
"39","041","G3900410","2010","2","3","Ohio","Delaware County",174214,"","Delaware County Ohio",171514,165198,-2700,-1.54981803988198,1.54981803988198,-9016,-5.17524423984295,5.17524423984295
"39","043","G3900430","2010","2","3","Ohio","Erie County",77079,"","Erie County Ohio",76880,83339,-199,-0.258176675877995,0.258176675877995,6260,8.12153764319724,8.12153764319724
"39","045","G3900450","2010","2","3","Ohio","Fairfield County",146156,"","Fairfield County Ohio",144248,144865,-1908,-1.30545444593448,1.30545444593448,-1291,-0.883302772380196,0.883302772380196
"39","047","G3900470","2010","2","3","Ohio","Fayette County",29030,"","Fayette County Ohio",28261,30543,-769,-2.64898380985188,2.64898380985188,1513,5.21184981054082,5.21184981054082
"39","049","G3900490","2010","2","3","Ohio","Franklin County",1163414,"","Franklin County Ohio",1157371,1198012,-6043,-0.519419570333518,0.519419570333518,34598,2.97383390607299,2.97383390607299
"39","051","G3900510","2010","2","3","Ohio","Fulton County",42698,"","Fulton County Ohio",42255,44988,-443,-1.03751932174809,1.03751932174809,2290,5.36324886411542,5.36324886411542
"39","053","G3900530","2010","2","3","Ohio","Gallia County",30934,"","Gallia County Ohio",30818,30678,-116,-0.374991918277623,0.374991918277623,-256,-0.827568371371307,0.827568371371307
"39","055","G3900550","2010","2","3","Ohio","Geauga County",93389,"","Geauga County Ohio",98948,98950,5559,5.9525211748707,5.9525211748707,5561,5.95466275471415,5.95466275471415
"39","057","G3900570","2010","2","3","Ohio","Greene County",161573,"","Greene County Ohio",159356,174661,-2217,-1.37213519585574,1.37213519585574,13088,8.10036330327468,8.10036330327468
"39","059","G3900590","2010","2","3","Ohio","Guernsey County",40087,"","Guernsey County Ohio",39956,42595,-131,-0.326789233417317,0.326789233417317,2508,6.25639234664605,6.25639234664605
"39","061","G3900610","2010","2","3","Ohio","Hamilton County",802374,"","Hamilton County Ohio",855391,870281,53017,6.60751719273057,6.60751719273057,67907,8.46326027513354,8.46326027513354
"39","063","G3900630","2010","2","3","Ohio","Hancock County",74782,"","Hancock County Ohio",74392,83417,-390,-0.521515872803616,0.521515872803616,8635,11.5468963119467,11.5468963119467
"39","065","G3900650","2010","2","3","Ohio","Hardin County",32058,"","Hardin County Ohio",31660,32614,-398,-1.24149978164577,1.24149978164577,556,1.73435647888203,1.73435647888203
"39","067","G3900670","2010","2","3","Ohio","Harrison County",15864,"","Harrison County Ohio",15275,15932,-589,-3.71280887544125,3.71280887544125,68,0.428643469490671,0.428643469490671
"39","069","G3900690","2010","2","3","Ohio","Henry County",28215,"","Henry County Ohio",28576,31022,361,1.27946127946128,1.27946127946128,2807,9.94860889597732,9.94860889597732
"39","071","G3900710","2010","2","3","Ohio","Highland County",43589,"","Highland County Ohio",42011,42896,-1578,-3.6201794030604,3.6201794030604,-693,-1.58985065039345,1.58985065039345
"39","073","G3900730","2010","2","3","Ohio","Hocking County",29380,"","Hocking County Ohio",28840,29308,-540,-1.83798502382573,1.83798502382573,-72,-0.245064669843431,0.245064669843431
"39","075","G3900750","2010","2","3","Ohio","Holmes County",42366,"","Holmes County Ohio",41731,40142,-635,-1.49884341217014,1.49884341217014,-2224,-5.24949251758486,5.24949251758486
"39","077","G3900770","2010","2","3","Ohio","Huron County",59626,"","Huron County Ohio",59695,63060,69,0.115721329621306,0.115721329621306,3434,5.75923254955892,5.75923254955892
"39","079","G3900790","2010","2","3","Ohio","Jackson County",33225,"","Jackson County Ohio",33503,34692,278,0.836719337848006,0.836719337848006,1467,4.41534988713318,4.41534988713318
"39","081","G3900810","2010","2","3","Ohio","Jefferson County",69709,"","Jefferson County Ohio",67745,74090,-1964,-2.81742673112511,2.81742673112511,4381,6.2846978152032,6.2846978152032
"39","083","G3900830","2010","2","3","Ohio","Knox County",60921,"","Knox County Ohio",59785,60836,-1136,-1.86471003430673,1.86471003430673,-85,-0.13952495855288,0.13952495855288
"39","085","G3900850","2010","2","3","Ohio","Lake County",230041,"","Lake County Ohio",235562,242146,5521,2.40000695528188,2.40000695528188,12105,5.26210545076747,5.26210545076747
"39","087","G3900870","2010","2","3","Ohio","Lawrence County",62450,"","Lawrence County Ohio",62580,62658,130,0.208166533226581,0.208166533226581,208,0.33306645316253,0.33306645316253
"39","089","G3900890","2010","2","3","Ohio","Licking County",166492,"","Licking County Ohio",158870,164673,-7622,-4.57799774163323,4.57799774163323,-1819,-1.09254498714653,1.09254498714653
"39","091","G3900910","2010","2","3","Ohio","Logan County",45858,"","Logan County Ohio",46413,49618,555,1.21025775219155,1.21025775219155,3760,8.19922369052292,8.19922369052292
"39","093","G3900930","2010","2","3","Ohio","Lorain County",301356,"","Lorain County Ohio",304959,317662,3603,1.19559590650261,1.19559590650261,16306,5.41087617303123,5.41087617303123
"39","095","G3900950","2010","2","3","Ohio","Lucas County",441815,"","Lucas County Ohio",462132,473784,20317,4.59853105938006,4.59853105938006,31969,7.23583400291977,7.23583400291977
"39","097","G3900970","2010","2","3","Ohio","Madison County",43435,"","Madison County Ohio",42577,43301,-858,-1.97536548866122,1.97536548866122,-134,-0.308506964429607,0.308506964429607
"39","099","G3900990","2010","2","3","Ohio","Mahoning County",238823,"","Mahoning County Ohio",235035,262598,-3788,-1.58611189039582,1.58611189039582,23775,9.95507132897585,9.95507132897585
"39","101","G3901010","2010","2","3","Ohio","Marion County",66501,"","Marion County Ohio",65454,70130,-1047,-1.5744124148509,1.5744124148509,3629,5.45706079607825,5.45706079607825
"39","103","G3901030","2010","2","3","Ohio","Medina County",172332,"","Medina County Ohio",174061,180921,1729,1.00329596360513,1.00329596360513,8589,4.9839844022004,4.9839844022004
"39","105","G3901050","2010","2","3","Ohio","Meigs County",23770,"","Meigs County Ohio",22762,23141,-1008,-4.2406394615061,4.2406394615061,-629,-2.64619267984855,2.64619267984855
"39","107","G3901070","2010","2","3","Ohio","Mercer County",40814,"","Mercer County Ohio",40539,43491,-275,-0.673788405939139,0.673788405939139,2677,6.55902386436027,6.55902386436027
"39","109","G3901090","2010","2","3","Ohio","Miami County",102506,"","Miami County Ohio",101051,103270,-1455,-1.41942910658888,1.41942910658888,764,0.745322225040486,0.745322225040486
"39","111","G3901110","2010","2","3","Ohio","Monroe County",14642,"","Monroe County Ohio",13926,15170,-716,-4.89004234394208,4.89004234394208,528,3.60606474525338,3.60606474525338
"39","113","G3901130","2010","2","3","Ohio","Montgomery County",535153,"","Montgomery County Ohio",532270,573243,-2883,-0.538724439552801,0.538724439552801,38090,7.11759067033166,7.11759067033166
"39","115","G3901150","2010","2","3","Ohio","Morgan County",15054,"","Morgan County Ohio",14239,15661,-815,-5.41384349674505,5.41384349674505,607,4.03215092334263,4.03215092334263
"39","117","G3901170","2010","2","3","Ohio","Morrow County",34827,"","Morrow County Ohio",34502,34742,-325,-0.933184023889511,0.933184023889511,-85,-0.244063513940334,0.244063513940334
"39","119","G3901190","2010","2","3","Ohio","Muskingum County",86074,"","Muskingum County Ohio",85112,85545,-962,-1.11764295838465,1.11764295838465,-529,-0.614587448009852,0.614587448009852
"39","121","G3901210","2010","2","3","Ohio","Noble County",14645,"","Noble County Ohio",14282,14622,-363,-2.47866165926938,2.47866165926938,-23,-0.157050187777398,0.157050187777398
"39","123","G3901230","2010","2","3","Ohio","Ottawa County",41428,"","Ottawa County Ohio",40726,44132,-702,-1.69450613111905,1.69450613111905,2704,6.52698657912523,6.52698657912523
"39","125","G3901250","2010","2","3","Ohio","Paulding County",19614,"","Paulding County Ohio",18878,21144,-736,-3.75242173957377,3.75242173957377,1530,7.80055062710309,7.80055062710309
"39","127","G3901270","2010","2","3","Ohio","Perry County",36058,"","Perry County Ohio",35212,35525,-846,-2.34621997892285,2.34621997892285,-533,-1.47817405291475,1.47817405291475
"39","129","G3901290","2010","2","3","Ohio","Pickaway County",55698,"","Pickaway County Ohio",54757,56433,-941,-1.68946820352616,1.68946820352616,735,1.31961650328558,1.31961650328558
"39","131","G3901310","2010","2","3","Ohio","Pike County",28709,"","Pike County Ohio",27656,29937,-1053,-3.66783935351284,3.66783935351284,1228,4.27740429830367,4.27740429830367
"39","133","G3901330","2010","2","3","Ohio","Portage County",161419,"","Portage County Ohio",157250,166624,-4169,-2.58271950637781,2.58271950637781,5205,3.22452747198285,3.22452747198285
"39","135","G3901350","2010","2","3","Ohio","Preble County",42270,"","Preble County Ohio",41051,44478,-1219,-2.88384196829903,2.88384196829903,2208,5.2235628105039,5.2235628105039
"39","137","G3901370","2010","2","3","Ohio","Putnam County",34499,"","Putnam County Ohio",34275,36941,-224,-0.649294182440071,0.649294182440071,2442,7.07846604249398,7.07846604249398
"39","139","G3901390","2010","2","3","Ohio","Richland County",124475,"","Richland County Ohio",123516,133374,-959,-0.77043583048805,0.77043583048805,8899,7.14922675235991,7.14922675235991
"39","141","G3901410","2010","2","3","Ohio","Ross County",78064,"","Ross County Ohio",76251,75524,-1813,-2.32245337159254,2.32245337159254,-2540,-3.25374052059848,3.25374052059848
"39","143","G3901430","2010","2","3","Ohio","Sandusky County",60944,"","Sandusky County Ohio",59881,63842,-1063,-1.7442242058283,1.7442242058283,2898,4.75518508794959,4.75518508794959
"39","145","G3901450","2010","2","3","Ohio","Scioto County",79499,"","Scioto County Ohio",76420,80766,-3079,-3.87300469188292,3.87300469188292,1267,1.59373073875143,1.59373073875143
"39","147","G3901470","2010","2","3","Ohio","Seneca County",56745,"","Seneca County Ohio",56040,60335,-705,-1.24240021147238,1.24240021147238,3590,6.32654859458983,6.32654859458983
"39","149","G3901490","2010","2","3","Ohio","Shelby County",49423,"","Shelby County Ohio",49209,52458,-214,-0.43299678287437,0.43299678287437,3035,6.14086558889586,6.14086558889586
"39","151","G3901510","2010","2","3","Ohio","Stark County",375586,"","Stark County Ohio",378050,397262,2464,0.656041492494395,0.656041492494395,21676,5.77124812958949,5.77124812958949
"39","153","G3901530","2010","2","3","Ohio","Summit County",541781,"","Summit County Ohio",541569,573251,-212,-0.0391302020558122,0.0391302020558122,31470,5.80862008819062,5.80862008819062
"39","155","G3901550","2010","2","3","Ohio","Trumbull County",210312,"","Trumbull County Ohio",208487,229765,-1825,-0.867758378028833,0.867758378028833,19453,9.24959108372323,9.24959108372323
"39","157","G3901570","2010","2","3","Ohio","Tuscarawas County",92582,"","Tuscarawas County Ohio",91073,93051,-1509,-1.62990646129917,1.62990646129917,469,0.506577952517768,0.506577952517768
"39","159","G3901590","2010","2","3","Ohio","Union County",52300,"","Union County Ohio",49076,51273,-3224,-6.16443594646272,6.16443594646272,-1027,-1.96367112810707,1.96367112810707
"39","161","G3901610","2010","2","3","Ohio","Van Wert County",28744,"","Van Wert County Ohio",28381,30623,-363,-1.26287225160033,1.26287225160033,1879,6.53701642081826,6.53701642081826
"39","163","G3901630","2010","2","3","Ohio","Vinton County",13435,"","Vinton County Ohio",13236,12927,-199,-1.4812058057313,1.4812058057313,-508,-3.78116858950502,3.78116858950502
"39","165","G3901650","2010","2","3","Ohio","Warren County",212693,"","Warren County Ohio",212830,211522,137,0.0644120869045996,0.0644120869045996,-1171,-0.550558786607928,0.550558786607928
"39","167","G3901670","2010","2","3","Ohio","Washington County",61778,"","Washington County Ohio",60777,63657,-1001,-1.62031791252549,1.62031791252549,1879,3.04153582181359,3.04153582181359
"39","169","G3901690","2010","2","3","Ohio","Wayne County",114520,"","Wayne County Ohio",114217,121553,-303,-0.2645826056584,0.2645826056584,7033,6.14128536500175,6.14128536500175
"39","171","G3901710","2010","2","3","Ohio","Williams County",37642,"","Williams County Ohio",37467,41352,-175,-0.464906221773551,0.464906221773551,3710,9.85601190159928,9.85601190159928
"39","173","G3901730","2010","2","3","Ohio","Wood County",125488,"","Wood County Ohio",125125,134274,-363,-0.289270687237027,0.289270687237027,8786,7.00146627565982,7.00146627565982
"39","175","G3901750","2010","2","3","Ohio","Wyandot County",22615,"","Wyandot County Ohio",22316,23872,-299,-1.32213132876409,1.32213132876409,1257,5.55825779349989,5.55825779349989
"40","001","G4000010","2010","3","7","Oklahoma","Adair County",22683,"","Adair County Oklahoma",22085,22198,-598,-2.63633558171318,2.63633558171318,-485,-2.13816514570383,2.13816514570383
"40","003","G4000030","2010","3","7","Oklahoma","Alfalfa County",5642,"","Alfalfa County Oklahoma",5601,6174,-41,-0.726692662176533,0.726692662176533,532,9.42928039702233,9.42928039702233
"40","005","G4000050","2010","3","7","Oklahoma","Atoka County",14182,"","Atoka County Oklahoma",14618,14564,436,3.07431956000564,3.07431956000564,382,2.69355521083063,2.69355521083063
"40","007","G4000070","2010","3","7","Oklahoma","Beaver County",5636,"","Beaver County Oklahoma",5283,6045,-353,-6.26330731014904,6.26330731014904,409,7.2569198012775,7.2569198012775
"40","009","G4000090","2010","3","7","Oklahoma","Beckham County",22119,"","Beckham County Oklahoma",20826,20868,-1293,-5.84565305845653,5.84565305845653,-1251,-5.65577105655771,5.65577105655771
"40","011","G4000110","2010","3","7","Oklahoma","Blaine County",11943,"","Blaine County Oklahoma",12539,12216,596,4.99037092857741,4.99037092857741,273,2.28585782466717,2.28585782466717
"40","013","G4000130","2010","3","7","Oklahoma","Bryan County",42416,"","Bryan County Oklahoma",41211,40387,-1205,-2.84090909090909,2.84090909090909,-2029,-4.78357223689174,4.78357223689174
"40","015","G4000150","2010","3","7","Oklahoma","Caddo County",29600,"","Caddo County Oklahoma",30563,31457,963,3.25337837837838,3.25337837837838,1857,6.27364864864865,6.27364864864865
"40","017","G4000170","2010","3","7","Oklahoma","Canadian County",115541,"","Canadian County Oklahoma",111626,108612,-3915,-3.38840757826226,3.38840757826226,-6929,-5.99700539202534,5.99700539202534
"40","019","G4000190","2010","3","7","Oklahoma","Carter County",47557,"","Carter County Oklahoma",48523,48817,966,2.03124671446895,2.03124671446895,1260,2.64945223626385,2.64945223626385
"40","021","G4000210","2010","3","7","Oklahoma","Cherokee County",46987,"","Cherokee County Oklahoma",46376,46775,-611,-1.30035967395237,1.30035967395237,-212,-0.451188626641411,0.451188626641411
"40","023","G4000230","2010","3","7","Oklahoma","Choctaw County",15205,"","Choctaw County Oklahoma",14916,16081,-289,-1.90069056231503,1.90069056231503,876,5.76126274251891,5.76126274251891
"40","025","G4000250","2010","3","7","Oklahoma","Cimarron County",2475,"","Cimarron County Oklahoma",2616,3189,141,5.6969696969697,5.6969696969697,714,28.8484848484849,28.8484848484849
"40","027","G4000270","2010","3","7","Oklahoma","Cleveland County",255755,"","Cleveland County Oklahoma",247328,250033,-8427,-3.294950245352,3.294950245352,-5722,-2.2372974135403,2.2372974135403
"40","029","G4000290","2010","3","7","Oklahoma","Coal County",5925,"","Coal County Oklahoma",5838,6264,-87,-1.46835443037975,1.46835443037975,339,5.72151898734177,5.72151898734177
"40","031","G4000310","2010","3","7","Oklahoma","Comanche County",124098,"","Comanche County Oklahoma",114526,123265,-9572,-7.71325887604957,7.71325887604957,-833,-0.671243694499508,0.671243694499508
"40","033","G4000330","2010","3","7","Oklahoma","Cotton County",6193,"","Cotton County Oklahoma",6285,6781,92,1.48554819958017,1.48554819958017,588,9.49459066688196,9.49459066688196
"40","035","G4000350","2010","3","7","Oklahoma","Craig County",15029,"","Craig County Oklahoma",15320,15372,291,1.93625657063012,1.93625657063012,343,2.28225430833721,2.28225430833721
"40","037","G4000370","2010","3","7","Oklahoma","Creek County",69967,"","Creek County Oklahoma",70784,72830,817,1.16769334114654,1.16769334114654,2863,4.0919290522675,4.0919290522675
"40","039","G4000390","2010","3","7","Oklahoma","Custer County",27469,"","Custer County Oklahoma",26834,27430,-635,-2.31169682187193,2.31169682187193,-39,-0.141978230004733,0.141978230004733
"40","041","G4000410","2010","3","7","Oklahoma","Delaware County",41487,"","Delaware County Oklahoma",40695,40583,-792,-1.90903174488394,1.90903174488394,-904,-2.17899583001904,2.17899583001904
"40","043","G4000430","2010","3","7","Oklahoma","Dewey County",4810,"","Dewey County Oklahoma",4392,4902,-418,-8.69022869022869,8.69022869022869,92,1.91268191268191,1.91268191268191
"40","045","G4000450","2010","3","7","Oklahoma","Ellis County",4151,"","Ellis County Oklahoma",3937,4141,-214,-5.1553842447603,5.1553842447603,-10,-0.24090580582992,0.24090580582992
"40","047","G4000470","2010","3","7","Oklahoma","Garfield County",60580,"","Garfield County Oklahoma",59427,59930,-1153,-1.90326840541433,1.90326840541433,-650,-1.07296137339056,1.07296137339056
"40","049","G4000490","2010","3","7","Oklahoma","Garvin County",27576,"","Garvin County Oklahoma",27076,27989,-500,-1.81317087322309,1.81317087322309,413,1.49767914128227,1.49767914128227
"40","051","G4000510","2010","3","7","Oklahoma","Grady County",52431,"","Grady County Oklahoma",51830,48704,-601,-1.14626842898285,1.14626842898285,-3727,-7.1083900745742,7.1083900745742
"40","053","G4000530","2010","3","7","Oklahoma","Grant County",4527,"","Grant County Oklahoma",4332,5238,-195,-4.30748840291584,4.30748840291584,711,15.7057654075547,15.7057654075547
"40","055","G4000550","2010","3","7","Oklahoma","Greer County",6239,"","Greer County Oklahoma",5766,6189,-473,-7.58134316396858,7.58134316396858,-50,-0.801410482449111,0.801410482449111
"40","057","G4000570","2010","3","7","Oklahoma","Harmon County",2922,"","Harmon County Oklahoma",2894,3379,-28,-0.958247775496235,0.958247775496235,457,15.6399726214921,15.6399726214921
"40","059","G4000590","2010","3","7","Oklahoma","Harper County",3685,"","Harper County Oklahoma",3347,3598,-338,-9.17232021709634,9.17232021709634,-87,-2.36092265943012,2.36092265943012
"40","061","G4000610","2010","3","7","Oklahoma","Haskell County",12769,"","Haskell County Oklahoma",12318,12476,-451,-3.53199154201582,3.53199154201582,-293,-2.29461978228522,2.29461978228522
"40","063","G4000630","2010","3","7","Oklahoma","Hughes County",14003,"","Hughes County Oklahoma",14368,14702,365,2.60658430336356,2.60658430336356,699,4.99178747411269,4.99178747411269
"40","065","G4000650","2010","3","7","Oklahoma","Jackson County",26446,"","Jackson County Oklahoma",25336,29057,-1110,-4.19723209559102,4.19723209559102,2611,9.87294865007941,9.87294865007941
"40","067","G4000670","2010","3","7","Oklahoma","Jefferson County",6472,"","Jefferson County Oklahoma",6257,6996,-215,-3.32200247218789,3.32200247218789,524,8.09641532756489,8.09641532756489
"40","069","G4000690","2010","3","7","Oklahoma","Johnston County",10957,"","Johnston County Oklahoma",10505,11165,-452,-4.12521675641143,4.12521675641143,208,1.8983298348088,1.8983298348088
"40","071","G4000710","2010","3","7","Oklahoma","Kay County",46562,"","Kay County Oklahoma",45995,48602,-567,-1.21773119711353,1.21773119711353,2040,4.38125510072591,4.38125510072591
"40","073","G4000730","2010","3","7","Oklahoma","Kingfisher County",15034,"","Kingfisher County Oklahoma",14471,14673,-563,-3.74484501795929,3.74484501795929,-361,-2.40122389251031,2.40122389251031
"40","075","G4000750","2010","3","7","Oklahoma","Kiowa County",9446,"","Kiowa County Oklahoma",9103,10325,-343,-3.63116663137836,3.63116663137836,879,9.30552614863434,9.30552614863434
"40","077","G4000770","2010","3","7","Oklahoma","Latimer County",11154,"","Latimer County Oklahoma",10549,11159,-605,-5.42406311637081,5.42406311637081,5,0.044826967903891,0.044826967903891
"40","079","G4000790","2010","3","7","Oklahoma","Le Flore County",50384,"","Le Flore County Oklahoma",50489,51101,105,0.208399491902191,0.208399491902191,717,1.42307081613211,1.42307081613211
"40","081","G4000810","2010","3","7","Oklahoma","Lincoln County",34273,"","Lincoln County Oklahoma",32284,33823,-1989,-5.80340209494354,5.80340209494354,-450,-1.31298689930849,1.31298689930849
"40","083","G4000830","2010","3","7","Oklahoma","Logan County",41848,"","Logan County Oklahoma",39829,35947,-2019,-4.82460332632384,4.82460332632384,-5901,-14.1010323073982,14.1010323073982
"40","085","G4000850","2010","3","7","Oklahoma","Love County",9423,"","Love County Oklahoma",9159,9326,-264,-2.80165552371856,2.80165552371856,-97,-1.02939615833599,1.02939615833599
"40","087","G4000870","2010","3","7","Oklahoma","McClain County",34506,"","McClain County Oklahoma",33704,32718,-802,-2.32423346664348,2.32423346664348,-1788,-5.18170752912537,5.18170752912537
"40","089","G4000890","2010","3","7","Oklahoma","McCurtain County",33151,"","McCurtain County Oklahoma",33630,36095,479,1.44490362281681,1.44490362281681,2944,8.88057675484903,8.88057675484903
"40","091","G4000910","2010","3","7","Oklahoma","McIntosh County",20252,"","McIntosh County Oklahoma",19807,20872,-445,-2.19731384554612,2.19731384554612,620,3.06142603199684,3.06142603199684
"40","093","G4000930","2010","3","7","Oklahoma","Major County",7527,"","Major County Oklahoma",7135,7807,-392,-5.20791816128604,5.20791816128604,280,3.71994154377574,3.71994154377574
"40","095","G4000950","2010","3","7","Oklahoma","Marshall County",15840,"","Marshall County Oklahoma",15263,13957,-577,-3.64267676767677,3.64267676767677,-1883,-11.8876262626263,11.8876262626263
"40","097","G4000970","2010","3","7","Oklahoma","Mayes County",41259,"","Mayes County Oklahoma",40108,40720,-1151,-2.78969436971328,2.78969436971328,-539,-1.30638163794566,1.30638163794566
"40","099","G4000990","2010","3","7","Oklahoma","Murray County",13488,"","Murray County Oklahoma",13039,13252,-449,-3.32888493475682,3.32888493475682,-236,-1.7497034400949,1.7497034400949
"40","101","G4001010","2010","3","7","Oklahoma","Muskogee County",70990,"","Muskogee County Oklahoma",71919,73247,929,1.30863501901676,1.30863501901676,2257,3.17932103113115,3.17932103113115
"40","103","G4001030","2010","3","7","Oklahoma","Noble County",11561,"","Noble County Oklahoma",10875,11750,-686,-5.93374275581697,5.93374275581697,189,1.63480667762304,1.63480667762304
"40","105","G4001050","2010","3","7","Oklahoma","Nowata County",10536,"","Nowata County Oklahoma",10470,11009,-66,-0.626423690205011,0.626423690205011,473,4.48936977980258,4.48936977980258
"40","107","G4001070","2010","3","7","Oklahoma","Okfuskee County",12191,"","Okfuskee County Oklahoma",11126,12414,-1065,-8.73595275203019,8.73595275203019,223,1.82921827577721,1.82921827577721
"40","109","G4001090","2010","3","7","Oklahoma","Oklahoma County",718633,"","Oklahoma County Oklahoma",724512,728073,5879,0.818080995445519,0.818080995445519,9440,1.31360513641873,1.31360513641873
"40","111","G4001110","2010","3","7","Oklahoma","Okmulgee County",40069,"","Okmulgee County Oklahoma",39689,41003,-380,-0.948364071975842,0.948364071975842,934,2.33097906111957,2.33097906111957
"40","113","G4001130","2010","3","7","Oklahoma","Osage County",47472,"","Osage County Oklahoma",44889,48668,-2583,-5.44110212335693,5.44110212335693,1196,2.51937984496124,2.51937984496124
"40","115","G4001150","2010","3","7","Oklahoma","Ottawa County",31848,"","Ottawa County Oklahoma",31634,34379,-214,-0.671941723185129,0.671941723185129,2531,7.9471238382316,7.9471238382316
"40","117","G4001170","2010","3","7","Oklahoma","Pawnee County",16577,"","Pawnee County Oklahoma",16412,17411,-165,-0.99535500995355,0.99535500995355,834,5.03106714121976,5.03106714121976
"40","119","G4001190","2010","3","7","Oklahoma","Payne County",77350,"","Payne County Oklahoma",79882,78030,2532,3.27343244990304,3.27343244990304,680,0.879120879120879,0.879120879120879
"40","121","G4001210","2010","3","7","Oklahoma","Pittsburg County",45837,"","Pittsburg County Oklahoma",45019,46546,-818,-1.7845845059668,1.7845845059668,709,1.54678534808124,1.54678534808124
"40","123","G4001230","2010","3","7","Oklahoma","Pontotoc County",37492,"","Pontotoc County Oklahoma",37745,36608,253,0.674810626266937,0.674810626266937,-884,-2.35783633841886,2.35783633841886
"40","125","G4001250","2010","3","7","Oklahoma","Pottawatomie County",69442,"","Pottawatomie County Oklahoma",70352,70267,910,1.3104461277037,1.3104461277037,825,1.18804181907203,1.18804181907203
"40","127","G4001270","2010","3","7","Oklahoma","Pushmataha County",11572,"","Pushmataha County Oklahoma",11763,12200,191,1.65053577601106,1.65053577601106,628,5.42689249913585,5.42689249913585
"40","129","G4001290","2010","3","7","Oklahoma","Roger Mills County",3647,"","Roger Mills County Oklahoma",3389,3538,-258,-7.07430765012339,7.07430765012339,-109,-2.98875788319166,2.98875788319166
"40","131","G4001310","2010","3","7","Oklahoma","Rogers County",86905,"","Rogers County Oklahoma",85883,84116,-1022,-1.17599677809102,1.17599677809102,-2789,-3.20925148150279,3.20925148150279
"40","133","G4001330","2010","3","7","Oklahoma","Seminole County",25482,"","Seminole County Oklahoma",24186,26106,-1296,-5.08594301860137,5.08594301860137,624,2.44878737932658,2.44878737932658
"40","135","G4001350","2010","3","7","Oklahoma","Sequoyah County",42391,"","Sequoyah County Oklahoma",41612,42359,-779,-1.83765421905593,1.83765421905593,-32,-0.0754877214503079,0.0754877214503079
"40","137","G4001370","2010","3","7","Oklahoma","Stephens County",45048,"","Stephens County Oklahoma",43672,44618,-1376,-3.0545196235127,3.0545196235127,-430,-0.954537382347718,0.954537382347718
"40","139","G4001390","2010","3","7","Oklahoma","Texas County",20640,"","Texas County Oklahoma",21986,21112,1346,6.52131782945736,6.52131782945736,472,2.28682170542636,2.28682170542636
"40","141","G4001410","2010","3","7","Oklahoma","Tillman County",7992,"","Tillman County Oklahoma",7767,9255,-225,-2.81531531531532,2.81531531531532,1263,15.8033033033033,15.8033033033033
"40","143","G4001430","2010","3","7","Oklahoma","Tulsa County",603403,"","Tulsa County Oklahoma",608811,619870,5408,0.896250101507616,0.896250101507616,16467,2.72902189747151,2.72902189747151
"40","145","G4001450","2010","3","7","Oklahoma","Wagoner County",73085,"","Wagoner County Oklahoma",70969,75559,-2116,-2.89525894506397,2.89525894506397,2474,3.38509954162961,3.38509954162961
"40","147","G4001470","2010","3","7","Oklahoma","Washington County",50976,"","Washington County Oklahoma",50910,51422,-66,-0.129472693032015,0.129472693032015,446,0.874921531701193,0.874921531701193
"40","149","G4001490","2010","3","7","Oklahoma","Washita County",11629,"","Washita County Oklahoma",11715,11751,86,0.739530484134491,0.739530484134491,122,1.04910138446986,1.04910138446986
"40","151","G4001510","2010","3","7","Oklahoma","Woods County",8878,"","Woods County Oklahoma",8689,9169,-189,-2.12885785086731,2.12885785086731,291,3.2777652624465,3.2777652624465
"40","153","G4001530","2010","3","7","Oklahoma","Woodward County",20081,"","Woodward County Oklahoma",19593,18981,-488,-2.43015786066431,2.43015786066431,-1100,-5.47781484985807,5.47781484985807
"41","001","G4100010","2010","4","9","Oregon","Baker County",16134,"","Baker County Oregon",15997,17649,-137,-0.849138465352671,0.849138465352671,1515,9.39010784678319,9.39010784678319
"41","003","G4100030","2010","4","9","Oregon","Benton County",85579,"","Benton County Oregon",82796,87107,-2783,-3.25196601970109,3.25196601970109,1528,1.78548475677444,1.78548475677444
"41","005","G4100050","2010","4","9","Oregon","Clackamas County",375992,"","Clackamas County Oregon",387666,381535,11674,3.10485329475095,3.10485329475095,5543,1.47423349432967,1.47423349432967
"41","007","G4100070","2010","4","9","Oregon","Clatsop County",37039,"","Clatsop County Oregon",37255,38506,216,0.583169092038122,0.583169092038122,1467,3.96069008342558,3.96069008342558
"41","009","G4100090","2010","4","9","Oregon","Columbia County",49351,"","Columbia County Oregon",49535,49475,184,0.372839456140706,0.372839456140706,124,0.251261372616563,0.251261372616563
"41","011","G4100110","2010","4","9","Oregon","Coos County",63043,"","Coos County Oregon",62643,64845,-400,-0.634487571974684,0.634487571974684,1802,2.85836651174595,2.85836651174595
"41","013","G4100130","2010","4","9","Oregon","Crook County",20978,"","Crook County Oregon",22268,24002,1290,6.14929926589761,6.14929926589761,3024,14.4151015349414,14.4151015349414
"41","015","G4100150","2010","4","9","Oregon","Curry County",22364,"","Curry County Oregon",21096,23053,-1268,-5.66982650688607,5.66982650688607,689,3.08084421391522,3.08084421391522
"41","017","G4100170","2010","4","9","Oregon","Deschutes County",157733,"","Deschutes County Oregon",159048,166383,1315,0.833687307031503,0.833687307031503,8650,5.48395072686121,5.48395072686121
"41","019","G4100190","2010","4","9","Oregon","Douglas County",107667,"","Douglas County Oregon",103008,108611,-4659,-4.32723118504277,4.32723118504277,944,0.876777471277179,0.876777471277179
"41","021","G4100210","2010","4","9","Oregon","Gilliam County",1871,"","Gilliam County Oregon",1638,1978,-233,-12.4532335649385,12.4532335649385,107,5.71886691608765,5.71886691608765
"41","023","G4100230","2010","4","9","Oregon","Grant County",7445,"","Grant County Oregon",6862,8519,-583,-7.83075889858966,7.83075889858966,1074,14.4257891202149,14.4257891202149
"41","025","G4100250","2010","4","9","Oregon","Harney County",7422,"","Harney County Oregon",6630,7890,-792,-10.6709781729992,10.6709781729992,468,6.3055780113177,6.3055780113177
"41","027","G4100270","2010","4","9","Oregon","Hood River County",22346,"","Hood River County Oregon",22237,23488,-109,-0.487783048420299,0.487783048420299,1142,5.11053432381634,5.11053432381634
"41","029","G4100290","2010","4","9","Oregon","Jackson County",203206,"","Jackson County Oregon",202050,212875,-1156,-0.568880840132673,0.568880840132673,9669,4.75822564294361,4.75822564294361
"41","031","G4100310","2010","4","9","Oregon","Jefferson County",21720,"","Jefferson County Oregon",19859,22550,-1861,-8.56813996316759,8.56813996316759,830,3.82136279926335,3.82136279926335
"41","033","G4100330","2010","4","9","Oregon","Josephine County",82713,"","Josephine County Oregon",81291,85547,-1422,-1.71919770773639,1.71919770773639,2834,3.42630541752808,3.42630541752808
"41","035","G4100350","2010","4","9","Oregon","Klamath County",66380,"","Klamath County Oregon",66133,70069,-247,-0.372100030129557,0.372100030129557,3689,5.55739680626695,5.55739680626695
"41","037","G4100370","2010","4","9","Oregon","Lake County",7895,"","Lake County Oregon",6977,7950,-918,-11.6276124129196,11.6276124129196,55,0.696643445218493,0.696643445218493
"41","039","G4100390","2010","4","9","Oregon","Lane County",351715,"","Lane County Oregon",351062,351941,-653,-0.185661686308517,0.185661686308517,226,0.0642565713717072,0.0642565713717072
"41","041","G4100410","2010","4","9","Oregon","Lincoln County",46034,"","Lincoln County Oregon",46300,49059,266,0.577833775035843,0.577833775035843,3025,6.571229960464,6.571229960464
"41","043","G4100430","2010","4","9","Oregon","Linn County",116672,"","Linn County Oregon",117127,116766,455,0.389982172243555,0.389982172243555,94,0.0805677454744926,0.0805677454744926
"41","045","G4100450","2010","4","9","Oregon","Malheur County",31313,"","Malheur County Oregon",30738,32499,-575,-1.83629802318526,1.83629802318526,1186,3.78756427043081,3.78756427043081
"41","047","G4100470","2010","4","9","Oregon","Marion County",315335,"","Marion County Oregon",319526,319290,4191,1.32906274279734,1.32906274279734,3955,1.25422170073097,1.25422170073097
"41","049","G4100490","2010","4","9","Oregon","Morrow County",11173,"","Morrow County Oregon",11586,11486,413,3.69641099078135,3.69641099078135,313,2.80139622303768,2.80139622303768
"41","051","G4100510","2010","4","9","Oregon","Multnomah County",735334,"","Multnomah County Oregon",735759,725391,425,0.0577968650980371,0.0577968650980371,-9943,-1.35217465804655,1.35217465804655
"41","053","G4100530","2010","4","9","Oregon","Polk County",75403,"","Polk County Oregon",78558,71295,3155,4.1841836531703,4.1841836531703,-4108,-5.44805909579194,5.44805909579194
"41","055","G4100550","2010","4","9","Oregon","Sherman County",1765,"","Sherman County Oregon",1740,2062,-25,-1.41643059490085,1.41643059490085,297,16.8271954674221,16.8271954674221
"41","057","G4100570","2010","4","9","Oregon","Tillamook County",25250,"","Tillamook County Oregon",24950,27811,-300,-1.18811881188119,1.18811881188119,2561,10.1425742574257,10.1425742574257
"41","059","G4100590","2010","4","9","Oregon","Umatilla County",75889,"","Umatilla County Oregon",74079,75420,-1810,-2.38506239375931,2.38506239375931,-469,-0.618007879929898,0.618007879929898
"41","061","G4100610","2010","4","9","Oregon","Union County",25748,"","Union County Oregon",25424,25287,-324,-1.25835016311947,1.25835016311947,-461,-1.79043032468541,1.79043032468541
"41","063","G4100630","2010","4","9","Oregon","Wallowa County",7008,"","Wallowa County Oregon",6903,7614,-105,-1.49828767123288,1.49828767123288,606,8.6472602739726,8.6472602739726
"41","065","G4100650","2010","4","9","Oregon","Wasco County",25213,"","Wasco County Oregon",24259,24271,-954,-3.78376234482212,3.78376234482212,-942,-3.73616784991869,3.73616784991869
"41","067","G4100670","2010","4","9","Oregon","Washington County",529710,"","Washington County Oregon",543228,520656,13518,2.55196239451775,2.55196239451775,-9054,-1.70923712975024,1.70923712975024
"41","069","G4100690","2010","4","9","Oregon","Wheeler County",1441,"","Wheeler County Oregon",1403,1654,-38,-2.63705759888966,2.63705759888966,213,14.7814018043026,14.7814018043026
"41","071","G4100710","2010","4","9","Oregon","Yamhill County",99193,"","Yamhill County Oregon",99838,103703,645,0.650247497303237,0.650247497303237,4510,4.54669180284899,4.54669180284899
"42","001","G4200010","2010","1","2","Pennsylvania","Adams County",101407,"","Adams County Pennsylvania",102478,102555,1071,1.056140108671,1.056140108671,1148,1.13207175047087,1.13207175047087
"42","003","G4200030","2010","1","2","Pennsylvania","Allegheny County",1223348,"","Allegheny County Pennsylvania",1220259,1301257,-3089,-0.252503784695769,0.252503784695769,77909,6.3685067535975,6.3685067535975
"42","005","G4200050","2010","1","2","Pennsylvania","Armstrong County",68941,"","Armstrong County Pennsylvania",67540,73157,-1401,-2.03217243730146,2.03217243730146,4216,6.1153740154625,6.1153740154625
"42","007","G4200070","2010","1","2","Pennsylvania","Beaver County",170539,"","Beaver County Pennsylvania",171766,185883,1227,0.719483519898674,0.719483519898674,15344,8.99735544362287,8.99735544362287
"42","009","G4200090","2010","1","2","Pennsylvania","Bedford County",49762,"","Bedford County Pennsylvania",49442,52008,-320,-0.643060970218239,0.643060970218239,2246,4.51348418471926,4.51348418471926
"42","011","G4200110","2010","1","2","Pennsylvania","Berks County",411442,"","Berks County Pennsylvania",407434,401950,-4008,-0.974134871986817,0.974134871986817,-9492,-2.30700803515441,2.30700803515441
"42","013","G4200130","2010","1","2","Pennsylvania","Blair County",127089,"","Blair County Pennsylvania",125824,132391,-1265,-0.99536545255687,0.99536545255687,5302,4.17187954897749,4.17187954897749
"42","015","G4200150","2010","1","2","Pennsylvania","Bradford County",62622,"","Bradford County Pennsylvania",61248,64571,-1374,-2.1941170834531,2.1941170834531,1949,3.11232474210341,3.11232474210341
"42","017","G4200170","2010","1","2","Pennsylvania","Bucks County",625249,"","Bucks County Pennsylvania",626049,641121,800,0.127949025108397,0.127949025108397,15872,2.53850865815059,2.53850865815059
"42","019","G4200190","2010","1","2","Pennsylvania","Butler County",183862,"","Butler County Pennsylvania",184983,195835,1121,0.609696402736835,0.609696402736835,11973,6.51194917927576,6.51194917927576
"42","021","G4200210","2010","1","2","Pennsylvania","Cambria County",143679,"","Cambria County Pennsylvania",143470,154157,-209,-0.145463150495201,0.145463150495201,10478,7.2926454109508,7.2926454109508
"42","023","G4200230","2010","1","2","Pennsylvania","Cameron County",5085,"","Cameron County Pennsylvania",5160,5971,75,1.47492625368732,1.47492625368732,886,17.4237954768928,17.4237954768928
"42","025","G4200250","2010","1","2","Pennsylvania","Carbon County",65249,"","Carbon County Pennsylvania",63668,64580,-1581,-2.4230256402397,2.4230256402397,-669,-1.02530306977885,1.02530306977885
"42","027","G4200270","2010","1","2","Pennsylvania","Centre County",153990,"","Centre County Pennsylvania",146525,150956,-7465,-4.84771738424573,4.84771738424573,-3034,-1.97025780894863,1.97025780894863
"42","029","G4200290","2010","1","2","Pennsylvania","Chester County",498886,"","Chester County Pennsylvania",500873,494826,1987,0.398287384292203,0.398287384292203,-4060,-0.813813175755583,0.813813175755583
"42","031","G4200310","2010","1","2","Pennsylvania","Clarion County",39988,"","Clarion County Pennsylvania",39279,43074,-709,-1.77303190957287,1.77303190957287,3086,7.71731519455837,7.71731519455837
"42","033","G4200330","2010","1","2","Pennsylvania","Clearfield County",81642,"","Clearfield County Pennsylvania",82396,86032,754,0.923544254182896,0.923544254182896,4390,5.37713431812058,5.37713431812058
"42","035","G4200350","2010","1","2","Pennsylvania","Clinton County",39238,"","Clinton County Pennsylvania",36865,39490,-2373,-6.04770885366227,6.04770885366227,252,0.642234568530506,0.642234568530506
"42","037","G4200370","2010","1","2","Pennsylvania","Columbia County",67295,"","Columbia County Pennsylvania",65191,67260,-2104,-3.12653243183,3.12653243183,-35,-0.052009807563712,0.052009807563712
"42","039","G4200390","2010","1","2","Pennsylvania","Crawford County",88765,"","Crawford County Pennsylvania",88186,93080,-579,-0.652284120993635,0.652284120993635,4315,4.86115022813046,4.86115022813046
"42","041","G4200410","2010","1","2","Pennsylvania","Cumberland County",235406,"","Cumberland County Pennsylvania",233429,238531,-1977,-0.839825662897292,0.839825662897292,3125,1.32749377670917,1.32749377670917
"42","043","G4200430","2010","1","2","Pennsylvania","Dauphin County",268100,"","Dauphin County Pennsylvania",259233,266238,-8867,-3.30734800447594,3.30734800447594,-1862,-0.694516971279373,0.694516971279373
"42","045","G4200450","2010","1","2","Pennsylvania","Delaware County",558979,"","Delaware County Pennsylvania",559470,561753,491,0.0878387202381485,0.0878387202381485,2774,0.496261934705955,0.496261934705955
"42","047","G4200470","2010","1","2","Pennsylvania","Elk County",31946,"","Elk County Pennsylvania",31752,35763,-194,-0.607274776184812,0.607274776184812,3817,11.9482877355537,11.9482877355537
"42","049","G4200490","2010","1","2","Pennsylvania","Erie County",280566,"","Erie County Pennsylvania",280030,292213,-536,-0.191042392877255,0.191042392877255,11647,4.15125139895782,4.15125139895782
"42","051","G4200510","2010","1","2","Pennsylvania","Fayette County",136606,"","Fayette County Pennsylvania",141672,150644,5066,3.7084754695987,3.7084754695987,14038,10.2762689779365,10.2762689779365
"42","053","G4200530","2010","1","2","Pennsylvania","Forest County",7716,"","Forest County Pennsylvania",6947,5051,-769,-9.96630378434422,9.96630378434422,-2665,-34.5386210471747,34.5386210471747
"42","055","G4200550","2010","1","2","Pennsylvania","Franklin County",149618,"","Franklin County Pennsylvania",146038,148163,-3580,-2.39276022938416,2.39276022938416,-1455,-0.972476573674291,0.972476573674291
"42","057","G4200570","2010","1","2","Pennsylvania","Fulton County",14845,"","Fulton County Pennsylvania",14923,15500,78,0.525429437521051,0.525429437521051,655,4.41226002020882,4.41226002020882
"42","059","G4200590","2010","1","2","Pennsylvania","Greene County",38686,"","Greene County Pennsylvania",39094,42131,408,1.05464509124748,1.05464509124748,3445,8.90503024349894,8.90503024349894
"42","061","G4200610","2010","1","2","Pennsylvania","Huntingdon County",45913,"","Huntingdon County Pennsylvania",45662,48041,-251,-0.546686123755799,0.546686123755799,2128,4.63485287391371,4.63485287391371
"42","063","G4200630","2010","1","2","Pennsylvania","Indiana County",88880,"","Indiana County Pennsylvania",87257,93038,-1623,-1.82605760576058,1.82605760576058,4158,4.67821782178218,4.67821782178218
"42","065","G4200650","2010","1","2","Pennsylvania","Jefferson County",45200,"","Jefferson County Pennsylvania",44818,47906,-382,-0.845132743362832,0.845132743362832,2706,5.98672566371681,5.98672566371681
"42","067","G4200670","2010","1","2","Pennsylvania","Juniata County",24636,"","Juniata County Pennsylvania",22982,24070,-1654,-6.71375223250528,6.71375223250528,-566,-2.29745088488391,2.29745088488391
"42","069","G4200690","2010","1","2","Pennsylvania","Lackawanna County",214437,"","Lackawanna County Pennsylvania",208190,218609,-6247,-2.91320994044871,2.91320994044871,4172,1.94555976813703,1.94555976813703
"42","071","G4200710","2010","1","2","Pennsylvania","Lancaster County",519445,"","Lancaster County Pennsylvania",509989,515376,-9456,-1.82040447015565,1.82040447015565,-4069,-0.783336060603144,0.783336060603144
"42","073","G4200730","2010","1","2","Pennsylvania","Lawrence County",91108,"","Lawrence County Pennsylvania",89599,96711,-1509,-1.6562760679633,1.6562760679633,5603,6.14984414101945,6.14984414101945
"42","075","G4200750","2010","1","2","Pennsylvania","Lebanon County",133568,"","Lebanon County Pennsylvania",130582,132232,-2986,-2.2355654048874,2.2355654048874,-1336,-1.00023957834212,1.00023957834212
"42","077","G4200770","2010","1","2","Pennsylvania","Lehigh County",349497,"","Lehigh County Pennsylvania",343968,337033,-5529,-1.5819878282217,1.5819878282217,-12464,-3.56626809386061,3.56626809386061
"42","079","G4200790","2010","1","2","Pennsylvania","Luzerne County",320918,"","Luzerne County Pennsylvania",311805,327733,-9113,-2.83966620756704,2.83966620756704,6815,2.12359543559414,2.12359543559414
"42","081","G4200810","2010","1","2","Pennsylvania","Lycoming County",116111,"","Lycoming County Pennsylvania",116864,123894,753,0.648517367002265,0.648517367002265,7783,6.70306861537667,6.70306861537667
"42","083","G4200830","2010","1","2","Pennsylvania","McKean County",43450,"","McKean County Pennsylvania",43029,46082,-421,-0.968929804372842,0.968929804372842,2632,6.05753739930955,6.05753739930955
"42","085","G4200850","2010","1","2","Pennsylvania","Mercer County",116638,"","Mercer County Pennsylvania",115985,124993,-653,-0.559851849311545,0.559851849311545,8355,7.16318866921586,7.16318866921586
"42","087","G4200870","2010","1","2","Pennsylvania","Mifflin County",46682,"","Mifflin County Pennsylvania",45987,47825,-695,-1.48879653828028,1.48879653828028,1143,2.44848121331562,2.44848121331562
"42","089","G4200890","2010","1","2","Pennsylvania","Monroe County",169842,"","Monroe County Pennsylvania",166155,163633,-3687,-2.17084113470166,2.17084113470166,-6209,-3.65575063882903,3.65575063882903
"42","091","G4200910","2010","1","2","Pennsylvania","Montgomery County",799874,"","Montgomery County Pennsylvania",788686,796529,-11188,-1.39872029844701,1.39872029844701,-3345,-0.418190865061247,0.418190865061247
"42","093","G4200930","2010","1","2","Pennsylvania","Montour County",18267,"","Montour County Pennsylvania",17810,19339,-457,-2.50177916461378,2.50177916461378,1072,5.86850604915969,5.86850604915969
"42","095","G4200950","2010","1","2","Pennsylvania","Northampton County",297735,"","Northampton County Pennsylvania",299277,296738,1542,0.51791022217744,0.51791022217744,-997,-0.334861537944817,0.334861537944817
"42","097","G4200970","2010","1","2","Pennsylvania","Northumberland County",94528,"","Northumberland County Pennsylvania",91506,96550,-3022,-3.19693635748138,3.19693635748138,2022,2.13904874746107,2.13904874746107
"42","099","G4200990","2010","1","2","Pennsylvania","Perry County",45969,"","Perry County Pennsylvania",45645,46013,-324,-0.704822815375579,0.704822815375579,44,0.0957166786312515,0.0957166786312515
"42","101","G4201010","2010","1","2","Pennsylvania","Philadelphia County",1526006,"","Philadelphia County Pennsylvania",1556373,1515306,30367,1.98996596343658,1.98996596343658,-10700,-0.701176797469997,0.701176797469997
"42","103","G4201030","2010","1","2","Pennsylvania","Pike County",57369,"","Pike County Pennsylvania",59900,54833,2531,4.41179033973052,4.41179033973052,-2536,-4.42050584810612,4.42050584810612
"42","105","G4201050","2010","1","2","Pennsylvania","Potter County",17457,"","Potter County Pennsylvania",16732,18867,-725,-4.15306180901644,4.15306180901644,1410,8.07698917339749,8.07698917339749
"42","107","G4201070","2010","1","2","Pennsylvania","Schuylkill County",148289,"","Schuylkill County Pennsylvania",146828,155616,-1461,-0.985238284700821,0.985238284700821,7327,4.94102731827715,4.94102731827715
"42","109","G4201090","2010","1","2","Pennsylvania","Snyder County",39702,"","Snyder County Pennsylvania",38559,39773,-1143,-2.87894816382046,2.87894816382046,71,0.178832300639766,0.178832300639766
"42","111","G4201110","2010","1","2","Pennsylvania","Somerset County",77742,"","Somerset County Pennsylvania",76938,82722,-804,-1.03419001312032,1.03419001312032,4980,6.40580381261094,6.40580381261094
"42","113","G4201130","2010","1","2","Pennsylvania","Sullivan County",6428,"","Sullivan County Pennsylvania",6075,6890,-353,-5.49159925326696,5.49159925326696,462,7.18730553827007,7.18730553827007
"42","115","G4201150","2010","1","2","Pennsylvania","Susquehanna County",43356,"","Susquehanna County Pennsylvania",40304,44040,-3052,-7.03939477811606,7.03939477811606,684,1.57763631331304,1.57763631331304
"42","117","G4201170","2010","1","2","Pennsylvania","Tioga County",41981,"","Tioga County Pennsylvania",41030,43442,-951,-2.26531049760606,2.26531049760606,1461,3.48014578023392,3.48014578023392
"42","119","G4201190","2010","1","2","Pennsylvania","Union County",44947,"","Union County Pennsylvania",43291,44435,-1656,-3.68433933299219,3.68433933299219,-512,-1.13911940730193,1.13911940730193
"42","121","G4201210","2010","1","2","Pennsylvania","Venango County",54984,"","Venango County Pennsylvania",54010,58548,-974,-1.77142441437509,1.77142441437509,3564,6.48188563945875,6.48188563945875
"42","123","G4201230","2010","1","2","Pennsylvania","Warren County",41815,"","Warren County Pennsylvania",40462,44507,-1353,-3.23568097572641,3.23568097572641,2692,6.43788114313046,6.43788114313046
"42","125","G4201250","2010","1","2","Pennsylvania","Washington County",207820,"","Washington County Pennsylvania",206999,216687,-821,-0.395053411606198,0.395053411606198,8867,4.26667308247522,4.26667308247522
"42","127","G4201270","2010","1","2","Pennsylvania","Wayne County",52822,"","Wayne County Pennsylvania",52126,52032,-696,-1.31763280451327,1.31763280451327,-790,-1.49558895914581,1.49558895914581
"42","129","G4201290","2010","1","2","Pennsylvania","Westmoreland County",365169,"","Westmoreland County Pennsylvania",360852,384010,-4317,-1.18219235477272,1.18219235477272,18841,5.15952887567126,5.15952887567126
"42","131","G4201310","2010","1","2","Pennsylvania","Wyoming County",28276,"","Wyoming County Pennsylvania",27813,29581,-463,-1.63743103692177,1.63743103692177,1305,4.61522138916396,4.61522138916396
"42","133","G4201330","2010","1","2","Pennsylvania","York County",434972,"","York County Pennsylvania",430121,432208,-4851,-1.11524419962664,1.11524419962664,-2764,-0.63544320094167,0.63544320094167
"44","001","G4400010","2010","1","1","Rhode Island","Bristol County",49875,"","Bristol County Rhode Island",50788,51812,913,1.83057644110276,1.83057644110276,1937,3.88370927318296,3.88370927318296
"44","003","G4400030","2010","1","1","Rhode Island","Kent County",166158,"","Kent County Rhode Island",168028,172446,1870,1.12543482709229,1.12543482709229,6288,3.78434983569855,3.78434983569855
"44","005","G4400050","2010","1","1","Rhode Island","Newport County",82888,"","Newport County Rhode Island",80380,88897,-2508,-3.02576971334813,3.02576971334813,6009,7.24954155004343,7.24954155004343
"44","007","G4400070","2010","1","1","Rhode Island","Providence County",626667,"","Providence County Rhode Island",630369,629311,3702,0.590744366625337,0.590744366625337,2644,0.421914669194325,0.421914669194325
"44","009","G4400090","2010","1","1","Rhode Island","Washington County",126979,"","Washington County Rhode Island",127422,134105,443,0.348876585892155,0.348876585892155,7126,5.61195158254514,5.61195158254514
"45","001","G4500010","2010","3","5","South Carolina","Abbeville County",25417,"","Abbeville County South Carolina",24816,26992,-601,-2.36455915332258,2.36455915332258,1575,6.196640044065,6.196640044065
"45","003","G4500030","2010","3","5","South Carolina","Aiken County",160099,"","Aiken County South Carolina",157541,161395,-2558,-1.59776138514294,1.59776138514294,1296,0.809499122418004,0.809499122418004
"45","005","G4500050","2010","3","5","South Carolina","Allendale County",10419,"","Allendale County South Carolina",9928,11371,-491,-4.71254439005663,4.71254439005663,952,9.1371532776658,9.1371532776658
"45","007","G4500070","2010","3","5","South Carolina","Anderson County",187126,"","Anderson County South Carolina",185268,190477,-1858,-0.992913865523765,0.992913865523765,3351,1.79077199320244,1.79077199320244
"45","009","G4500090","2010","3","5","South Carolina","Bamberg County",15987,"","Bamberg County South Carolina",14893,16964,-1094,-6.84305998623882,6.84305998623882,977,6.11121536248202,6.11121536248202
"45","011","G4500110","2010","3","5","South Carolina","Barnwell County",22621,"","Barnwell County South Carolina",22787,23929,166,0.733831395605853,0.733831395605853,1308,5.78223774368949,5.78223774368949
"45","013","G4500130","2010","3","5","South Carolina","Beaufort County",162233,"","Beaufort County South Carolina",155180,169142,-7053,-4.34745088853686,4.34745088853686,6909,4.25868966239914,4.25868966239914
"45","015","G4500150","2010","3","5","South Carolina","Berkeley County",177843,"","Berkeley County South Carolina",175758,181599,-2085,-1.17238238221353,1.17238238221353,3756,2.11197516910983,2.11197516910983
"45","017","G4500170","2010","3","5","South Carolina","Calhoun County",15175,"","Calhoun County South Carolina",14459,16463,-716,-4.71828665568369,4.71828665568369,1288,8.48764415156507,8.48764415156507
"45","019","G4500190","2010","3","5","South Carolina","Charleston County",350209,"","Charleston County South Carolina",357713,385879,7504,2.14272048976468,2.14272048976468,35670,10.1853464645397,10.1853464645397
"45","021","G4500210","2010","3","5","South Carolina","Cherokee County",55342,"","Cherokee County South Carolina",54972,55410,-370,-0.668569983014708,0.668569983014708,68,0.122872321202703,0.122872321202703
"45","023","G4500230","2010","3","5","South Carolina","Chester County",33140,"","Chester County South Carolina",32343,35606,-797,-2.40494870247435,2.40494870247435,2466,7.44115872057936,7.44115872057936
"45","025","G4500250","2010","3","5","South Carolina","Chesterfield County",46734,"","Chesterfield County South Carolina",42930,44945,-3804,-8.13968416998331,8.13968416998331,-1789,-3.82804810202422,3.82804810202422
"45","027","G4500270","2010","3","5","South Carolina","Clarendon County",34971,"","Clarendon County South Carolina",32878,35117,-2093,-5.9849589660004,5.9849589660004,146,0.417488776414744,0.417488776414744
"45","029","G4500290","2010","3","5","South Carolina","Colleton County",38892,"","Colleton County South Carolina",39416,40899,524,1.34732078576571,1.34732078576571,2007,5.16044430731256,5.16044430731256
"45","031","G4500310","2010","3","5","South Carolina","Darlington County",68681,"","Darlington County South Carolina",66511,70482,-2170,-3.15953466024082,3.15953466024082,1801,2.6222681673243,2.6222681673243
"45","033","G4500330","2010","3","5","South Carolina","Dillon County",32062,"","Dillon County South Carolina",31166,31607,-896,-2.79458549061194,2.79458549061194,-455,-1.41912544445138,1.41912544445138
"45","035","G4500350","2010","3","5","South Carolina","Dorchester County",136555,"","Dorchester County South Carolina",133027,128290,-3528,-2.58357438394786,2.58357438394786,-8265,-6.05250631613636,6.05250631613636
"45","037","G4500370","2010","3","5","South Carolina","Edgefield County",26985,"","Edgefield County South Carolina",25651,27058,-1334,-4.94348712247545,4.94348712247545,73,0.270520659625718,0.270520659625718
"45","039","G4500390","2010","3","5","South Carolina","Fairfield County",23956,"","Fairfield County South Carolina",23053,24830,-903,-3.76941058607447,3.76941058607447,874,3.64835531808315,3.64835531808315
"45","041","G4500410","2010","3","5","South Carolina","Florence County",136885,"","Florence County South Carolina",134955,135492,-1930,-1.40994265259159,1.40994265259159,-1393,-1.01764254666326,1.01764254666326
"45","043","G4500430","2010","3","5","South Carolina","Georgetown County",60158,"","Georgetown County South Carolina",60461,66855,303,0.503673659363676,0.503673659363676,6697,11.1323514744506,11.1323514744506
"45","045","G4500450","2010","3","5","South Carolina","Greenville County",451225,"","Greenville County South Carolina",455901,449462,4676,1.03629009917447,1.03629009917447,-1763,-0.390714166989861,0.390714166989861
"45","047","G4500470","2010","3","5","South Carolina","Greenwood County",69661,"","Greenwood County South Carolina",70100,70906,439,0.630194800534015,0.630194800534015,1245,1.78722671222061,1.78722671222061
"45","049","G4500490","2010","3","5","South Carolina","Hampton County",21090,"","Hampton County South Carolina",20915,21993,-175,-0.829777145566619,0.829777145566619,903,4.28165007112376,4.28165007112376
"45","051","G4500510","2010","3","5","South Carolina","Horry County",269291,"","Horry County South Carolina",266847,283979,-2444,-0.907568392556751,0.907568392556751,14688,5.45432264724777,5.45432264724777
"45","053","G4500530","2010","3","5","South Carolina","Jasper County",24777,"","Jasper County South Carolina",23759,25878,-1018,-4.10864915042176,4.10864915042176,1101,4.44363724421843,4.44363724421843
"45","055","G4500550","2010","3","5","South Carolina","Kershaw County",61697,"","Kershaw County South Carolina",60442,61691,-1255,-2.03413456083764,2.03413456083764,-6,-0.00972494610759032,0.00972494610759032
"45","057","G4500570","2010","3","5","South Carolina","Lancaster County",76652,"","Lancaster County South Carolina",78361,73484,1709,2.22955695872254,2.22955695872254,-3168,-4.13296456713458,4.13296456713458
"45","059","G4500590","2010","3","5","South Carolina","Laurens County",66537,"","Laurens County South Carolina",69872,73050,3335,5.01224882396261,5.01224882396261,6513,9.78853870778665,9.78853870778665
"45","061","G4500610","2010","3","5","South Carolina","Lee County",19220,"","Lee County South Carolina",19636,21097,416,2.16441207075963,2.16441207075963,1877,9.76586888657648,9.76586888657648
"45","063","G4500630","2010","3","5","South Carolina","Lexington County",262391,"","Lexington County South Carolina",257894,259724,-4497,-1.71385451482711,1.71385451482711,-2667,-1.01642205715897,1.01642205715897
"45","065","G4500650","2010","3","5","South Carolina","McCormick County",10233,"","McCormick County South Carolina",10111,11127,-122,-1.19222124499169,1.19222124499169,894,8.73644092641454,8.73644092641454
"45","067","G4500670","2010","3","5","South Carolina","Marion County",33062,"","Marion County South Carolina",33414,36393,352,1.06466638436876,1.06466638436876,3331,10.0750105861714,10.0750105861714
"45","069","G4500690","2010","3","5","South Carolina","Marlboro County",28933,"","Marlboro County South Carolina",28538,29256,-395,-1.36522310164864,1.36522310164864,323,1.11637230843673,1.11637230843673
"45","071","G4500710","2010","3","5","South Carolina","Newberry County",37508,"","Newberry County South Carolina",38995,38397,1487,3.96448757598379,3.96448757598379,889,2.37016103231311,2.37016103231311
"45","073","G4500730","2010","3","5","South Carolina","Oconee County",74273,"","Oconee County South Carolina",71900,80205,-2373,-3.19496990831123,3.19496990831123,5932,7.98675157863557,7.98675157863557
"45","075","G4500750","2010","3","5","South Carolina","Orangeburg County",92501,"","Orangeburg County South Carolina",89812,97508,-2689,-2.90699560004757,2.90699560004757,5007,5.41291445497887,5.41291445497887
"45","077","G4500770","2010","3","5","South Carolina","Pickens County",119224,"","Pickens County South Carolina",118464,125727,-760,-0.637455545863249,0.637455545863249,6503,5.45443870361672,5.45443870361672
"45","079","G4500790","2010","3","5","South Carolina","Richland County",384504,"","Richland County South Carolina",373636,394483,-10868,-2.82649855398123,2.82649855398123,9979,2.59529159644633,2.59529159644633
"45","081","G4500810","2010","3","5","South Carolina","Saluda County",19875,"","Saluda County South Carolina",19218,20051,-657,-3.30566037735849,3.30566037735849,176,0.885534591194968,0.885534591194968
"45","083","G4500830","2010","3","5","South Carolina","Spartanburg County",284307,"","Spartanburg County South Carolina",287534,293786,3227,1.13504064268555,1.13504064268555,9479,3.3340719714956,3.3340719714956
"45","085","G4500850","2010","3","5","South Carolina","Sumter County",107456,"","Sumter County South Carolina",104305,116579,-3151,-2.93236301369863,2.93236301369863,9123,8.48998659916617,8.48998659916617
"45","087","G4500870","2010","3","5","South Carolina","Union County",28961,"","Union County South Carolina",27172,30469,-1789,-6.17727288422361,6.17727288422361,1508,5.20700252063119,5.20700252063119
"45","089","G4500890","2010","3","5","South Carolina","Williamsburg County",34423,"","Williamsburg County South Carolina",33966,38287,-457,-1.32760073206868,1.32760073206868,3864,11.2250530168783,11.2250530168783
"45","091","G4500910","2010","3","5","South Carolina","York County",226073,"","York County South Carolina",229580,229335,3507,1.55126883794173,1.55126883794173,3262,1.44289676343482,1.44289676343482
"46","003","G4600030","2010","2","4","South Dakota","Aurora County",2710,"","Aurora County South Dakota",2871,3193,161,5.9409594095941,5.9409594095941,483,17.8228782287823,17.8228782287823
"46","005","G4600050","2010","2","4","South Dakota","Beadle County",17398,"","Beadle County South Dakota",16385,17488,-1013,-5.8225083342913,5.8225083342913,90,0.517300839176917,0.517300839176917
"46","007","G4600070","2010","2","4","South Dakota","Bennett County",3431,"","Bennett County South Dakota",3397,3684,-34,-0.990964733313903,0.990964733313903,253,7.37394345671816,7.37394345671816
"46","009","G4600090","2010","2","4","South Dakota","Bon Homme County",7070,"","Bon Homme County South Dakota",7020,7446,-50,-0.707213578500707,0.707213578500707,376,5.31824611032532,5.31824611032532
"46","011","G4600110","2010","2","4","South Dakota","Brookings County",31965,"","Brookings County South Dakota",30181,33157,-1784,-5.58110433286407,5.58110433286407,1192,3.72907867980604,3.72907867980604
"46","013","G4600130","2010","2","4","South Dakota","Brown County",36531,"","Brown County South Dakota",35686,37863,-845,-2.3131039391202,2.3131039391202,1332,3.64621828036462,3.64621828036462
"46","015","G4600150","2010","2","4","South Dakota","Brule County",5255,"","Brule County South Dakota",5300,5632,45,0.856327307326356,0.856327307326356,377,7.17411988582303,7.17411988582303
"46","017","G4600170","2010","2","4","South Dakota","Buffalo County",1912,"","Buffalo County South Dakota",2112,2123,200,10.4602510460251,10.4602510460251,211,11.0355648535565,11.0355648535565
"46","019","G4600190","2010","2","4","South Dakota","Butte County",10110,"","Butte County South Dakota",9628,10128,-482,-4.7675568743818,4.7675568743818,18,0.178041543026706,0.178041543026706
"46","021","G4600210","2010","2","4","South Dakota","Campbell County",1466,"","Campbell County South Dakota",1346,1825,-120,-8.18553888130969,8.18553888130969,359,24.4884038199181,24.4884038199181
"46","023","G4600230","2010","2","4","South Dakota","Charles Mix County",9129,"","Charles Mix County South Dakota",9049,9602,-80,-0.876328184905247,0.876328184905247,473,5.18129039325227,5.18129039325227
"46","025","G4600250","2010","2","4","South Dakota","Clark County",3691,"","Clark County South Dakota",3405,4326,-286,-7.74857762124086,7.74857762124086,635,17.2040097534544,17.2040097534544
"46","027","G4600270","2010","2","4","South Dakota","Clay County",13864,"","Clay County South Dakota",13435,14773,-429,-3.09434506635892,3.09434506635892,909,6.55654933641085,6.55654933641085
"46","029","G4600290","2010","2","4","South Dakota","Codington County",27227,"","Codington County South Dakota",26263,28402,-964,-3.54060307782716,3.54060307782716,1175,4.31556910419804,4.31556910419804
"46","031","G4600310","2010","2","4","South Dakota","Corson County",4050,"","Corson County South Dakota",4143,4302,93,2.2962962962963,2.2962962962963,252,6.22222222222222,6.22222222222222
"46","033","G4600330","2010","2","4","South Dakota","Custer County",8216,"","Custer County South Dakota",8062,9050,-154,-1.87439143135346,1.87439143135346,834,10.1509250243427,10.1509250243427
"46","035","G4600350","2010","2","4","South Dakota","Davison County",19504,"","Davison County South Dakota",19008,20308,-496,-2.54306808859721,2.54306808859721,804,4.12223133716161,4.12223133716161
"46","037","G4600370","2010","2","4","South Dakota","Day County",5710,"","Day County South Dakota",5528,6547,-182,-3.18739054290718,3.18739054290718,837,14.6584938704028,14.6584938704028
"46","039","G4600390","2010","2","4","South Dakota","Deuel County",4364,"","Deuel County South Dakota",4180,4852,-184,-4.21631530705775,4.21631530705775,488,11.1824014665445,11.1824014665445
"46","041","G4600410","2010","2","4","South Dakota","Dewey County",5301,"","Dewey County South Dakota",6079,6235,778,14.676476136578,14.676476136578,934,17.6193171099792,17.6193171099792
"46","043","G4600430","2010","2","4","South Dakota","Douglas County",3002,"","Douglas County South Dakota",2947,3496,-55,-1.83211192538308,1.83211192538308,494,16.4556962025316,16.4556962025316
"46","045","G4600450","2010","2","4","South Dakota","Edmunds County",4071,"","Edmunds County South Dakota",3981,4639,-90,-2.21075902726603,2.21075902726603,568,13.9523458609678,13.9523458609678
"46","047","G4600470","2010","2","4","South Dakota","Fall River County",7094,"","Fall River County South Dakota",7199,7854,105,1.48012404849168,1.48012404849168,760,10.7132788271779,10.7132788271779
"46","049","G4600490","2010","2","4","South Dakota","Faulk County",2364,"","Faulk County South Dakota",2178,2766,-186,-7.86802030456853,7.86802030456853,402,17.005076142132,17.005076142132
"46","051","G4600510","2010","2","4","South Dakota","Grant County",7356,"","Grant County South Dakota",6993,8283,-363,-4.9347471451876,4.9347471451876,927,12.6019575856444,12.6019575856444
"46","053","G4600530","2010","2","4","South Dakota","Gregory County",4271,"","Gregory County South Dakota",3971,4969,-300,-7.02411613205338,7.02411613205338,698,16.3427768672442,16.3427768672442
"46","055","G4600550","2010","2","4","South Dakota","Haakon County",1937,"","Haakon County South Dakota",1771,2281,-166,-8.56995353639649,8.56995353639649,344,17.7594217862674,17.7594217862674
"46","057","G4600570","2010","2","4","South Dakota","Hamlin County",5903,"","Hamlin County South Dakota",5789,6091,-114,-1.93122141284093,1.93122141284093,188,3.18482127731662,3.18482127731662
"46","059","G4600590","2010","2","4","South Dakota","Hand County",3431,"","Hand County South Dakota",3268,3887,-163,-4.75080151559312,4.75080151559312,456,13.2905858350335,13.2905858350335
"46","061","G4600610","2010","2","4","South Dakota","Hanson County",3331,"","Hanson County South Dakota",3563,3226,232,6.96487541278895,6.96487541278895,-105,-3.15220654458121,3.15220654458121
"46","063","G4600630","2010","2","4","South Dakota","Harding County",1255,"","Harding County South Dakota",1125,1358,-130,-10.3585657370518,10.3585657370518,103,8.20717131474104,8.20717131474104
"46","065","G4600650","2010","2","4","South Dakota","Hughes County",17022,"","Hughes County South Dakota",17111,17606,89,0.522852778756903,0.522852778756903,584,3.43085418869698,3.43085418869698
"46","067","G4600670","2010","2","4","South Dakota","Hutchinson County",7343,"","Hutchinson County South Dakota",7139,8278,-204,-2.77815606700259,2.77815606700259,935,12.7332153070952,12.7332153070952
"46","069","G4600690","2010","2","4","South Dakota","Hyde County",1420,"","Hyde County South Dakota",1376,1706,-44,-3.09859154929577,3.09859154929577,286,20.1408450704225,20.1408450704225
"46","071","G4600710","2010","2","4","South Dakota","Jackson County",3031,"","Jackson County South Dakota",2676,3044,-355,-11.712306169581,11.712306169581,13,0.428901352688882,0.428901352688882
"46","073","G4600730","2010","2","4","South Dakota","Jerauld County",2071,"","Jerauld County South Dakota",1993,2404,-78,-3.76629647513279,3.76629647513279,333,16.0791887976823,16.0791887976823
"46","075","G4600750","2010","2","4","South Dakota","Jones County",1006,"","Jones County South Dakota",1055,1228,49,4.87077534791252,4.87077534791252,222,22.0675944333996,22.0675944333996
"46","077","G4600770","2010","2","4","South Dakota","Kingsbury County",5148,"","Kingsbury County South Dakota",5347,6067,199,3.86557886557887,3.86557886557887,919,17.8515928515929,17.8515928515929
"46","079","G4600790","2010","2","4","South Dakota","Lake County",11200,"","Lake County South Dakota",12056,12342,856,7.64285714285714,7.64285714285714,1142,10.1964285714286,10.1964285714286
"46","081","G4600810","2010","2","4","South Dakota","Lawrence County",24097,"","Lawrence County South Dakota",23727,25862,-370,-1.53546084574843,1.53546084574843,1765,7.3245632236378,7.3245632236378
"46","083","G4600830","2010","2","4","South Dakota","Lincoln County",44828,"","Lincoln County South Dakota",42230,33632,-2598,-5.79548496475417,5.79548496475417,-11196,-24.9754617649683,24.9754617649683
"46","085","G4600850","2010","2","4","South Dakota","Lyman County",3755,"","Lyman County South Dakota",3920,4085,165,4.39414114513981,4.39414114513981,330,8.78828229027963,8.78828229027963
"46","087","G4600870","2010","2","4","South Dakota","McCook County",5618,"","McCook County South Dakota",5649,6361,31,0.551797792808829,0.551797792808829,743,13.2253470986116,13.2253470986116
"46","089","G4600890","2010","2","4","South Dakota","McPherson County",2459,"","McPherson County South Dakota",2419,2928,-40,-1.62667751118341,1.62667751118341,469,19.0727938186255,19.0727938186255
"46","091","G4600910","2010","2","4","South Dakota","Marshall County",4656,"","Marshall County South Dakota",4203,4765,-453,-9.72938144329897,9.72938144329897,109,2.34106529209622,2.34106529209622
"46","093","G4600930","2010","2","4","South Dakota","Meade County",25434,"","Meade County South Dakota",23876,28147,-1558,-6.12565856727216,6.12565856727216,2713,10.666823936463,10.666823936463
"46","095","G4600950","2010","2","4","South Dakota","Mellette County",2048,"","Mellette County South Dakota",2061,2154,13,0.634765625,0.634765625,106,5.17578125,5.17578125
"46","097","G4600970","2010","2","4","South Dakota","Miner County",2389,"","Miner County South Dakota",2379,2928,-10,-0.418585182084554,0.418585182084554,539,22.5617413143575,22.5617413143575
"46","099","G4600990","2010","2","4","South Dakota","Minnehaha County",169468,"","Minnehaha County South Dakota",183459,189218,13991,8.25583591002431,8.25583591002431,19750,11.6541175915217,11.6541175915217
"46","101","G4601010","2010","2","4","South Dakota","Moody County",6486,"","Moody County South Dakota",6388,6978,-98,-1.51094665433241,1.51094665433241,492,7.58556891766882,7.58556891766882
"46","103","G4601030","2010","2","4","South Dakota","Pennington County",100948,"","Pennington County South Dakota",101771,103634,823,0.815271228751436,0.815271228751436,2686,2.6607758449895,2.6607758449895
"46","105","G4601050","2010","2","4","South Dakota","Perkins County",2982,"","Perkins County South Dakota",2934,3459,-48,-1.60965794768612,1.60965794768612,477,15.9959758551308,15.9959758551308
"46","107","G4601070","2010","2","4","South Dakota","Potter County",2329,"","Potter County South Dakota",2113,2796,-216,-9.27436668097896,9.27436668097896,467,20.0515242593388,20.0515242593388
"46","109","G4601090","2010","2","4","South Dakota","Roberts County",10149,"","Roberts County South Dakota",10106,10538,-43,-0.423687062764804,0.423687062764804,389,3.83288993989556,3.83288993989556
"46","111","G4601110","2010","2","4","South Dakota","Sanborn County",2355,"","Sanborn County South Dakota",2416,2823,61,2.59023354564756,2.59023354564756,468,19.8726114649682,19.8726114649682
"46","113","G4601130","2010","2","4","South Dakota","Shannon County",13586,"","Shannon County South Dakota",13956,13212,370,2.72339172677757,2.72339172677757,-374,-2.75283379949948,2.75283379949948
"46","115","G4601150","2010","2","4","South Dakota","Spink County",6415,"","Spink County South Dakota",6522,7652,107,1.66796570537802,1.66796570537802,1237,19.2829306313328,19.2829306313328
"46","117","G4601170","2010","2","4","South Dakota","Stanley County",2966,"","Stanley County South Dakota",2849,3123,-117,-3.94470667565745,3.94470667565745,157,5.29332434254889,5.29332434254889
"46","119","G4601190","2010","2","4","South Dakota","Sully County",1373,"","Sully County South Dakota",1349,1682,-24,-1.74799708667152,1.74799708667152,309,22.5054624908958,22.5054624908958
"46","121","G4601210","2010","2","4","South Dakota","Todd County",9612,"","Todd County South Dakota",10259,9773,647,6.73116937161881,6.73116937161881,161,1.67498959633791,1.67498959633791
"46","123","G4601230","2010","2","4","South Dakota","Tripp County",5644,"","Tripp County South Dakota",5568,6591,-76,-1.34656272147413,1.34656272147413,947,16.7788802267895,16.7788802267895
"46","125","G4601250","2010","2","4","South Dakota","Turner County",8347,"","Turner County South Dakota",8288,9323,-59,-0.706840781118965,0.706840781118965,976,11.6928237690188,11.6928237690188
"46","127","G4601270","2010","2","4","South Dakota","Union County",14399,"","Union County South Dakota",14847,14767,448,3.1113271754983,3.1113271754983,368,2.55573303701646,2.55573303701646
"46","129","G4601290","2010","2","4","South Dakota","Walworth County",5438,"","Walworth County South Dakota",5296,6146,-142,-2.61125413755057,2.61125413755057,708,13.0194924604634,13.0194924604634
"46","135","G4601350","2010","2","4","South Dakota","Yankton County",22438,"","Yankton County South Dakota",21976,23790,-462,-2.05900704162581,2.05900704162581,1352,6.02549246813441,6.02549246813441
"46","137","G4601370","2010","2","4","South Dakota","Ziebach County",2801,"","Ziebach County South Dakota",2583,2662,-218,-7.78293466619065,7.78293466619065,-139,-4.96251338807569,4.96251338807569
"47","001","G4700010","2010","3","6","Tennessee","Anderson County",75129,"","Anderson County Tennessee",75086,75943,-43,-0.0572348893236966,0.0572348893236966,814,1.08346976533695,1.08346976533695
"47","003","G4700030","2010","3","6","Tennessee","Bedford County",45058,"","Bedford County Tennessee",46409,44547,1351,2.99835767233344,2.99835767233344,-511,-1.13409383461317,1.13409383461317
"47","005","G4700050","2010","3","6","Tennessee","Benton County",16489,"","Benton County Tennessee",16054,17488,-435,-2.63812238462005,2.63812238462005,999,6.05858451088605,6.05858451088605
"47","007","G4700070","2010","3","6","Tennessee","Bledsoe County",12876,"","Bledsoe County Tennessee",12894,13138,18,0.139794967381174,0.139794967381174,262,2.03479341410376,2.03479341410376
"47","009","G4700090","2010","3","6","Tennessee","Blount County",123010,"","Blount County Tennessee",122961,120596,-49,-0.0398341598244045,0.0398341598244045,-2414,-1.96244207787985,1.96244207787985
"47","011","G4700110","2010","3","6","Tennessee","Bradley County",98963,"","Bradley County Tennessee",98343,100450,-620,-0.626496771520669,0.626496771520669,1487,1.50258177298586,1.50258177298586
"47","013","G4700130","2010","3","6","Tennessee","Campbell County",40716,"","Campbell County Tennessee",40913,42173,197,0.483839276942725,0.483839276942725,1457,3.57844581982513,3.57844581982513
"47","015","G4700150","2010","3","6","Tennessee","Cannon County",13801,"","Cannon County Tennessee",13821,13593,20,0.144917034997464,0.144917034997464,-208,-1.50713716397363,1.50713716397363
"47","017","G4700170","2010","3","6","Tennessee","Carroll County",28522,"","Carroll County Tennessee",28557,30955,35,0.12271229226562,0.12271229226562,2433,8.53025734520721,8.53025734520721
"47","019","G4700190","2010","3","6","Tennessee","Carter County",57424,"","Carter County Tennessee",58884,60644,1460,2.5424909445528,2.5424909445528,3220,5.60741153524659,5.60741153524659
"47","021","G4700210","2010","3","6","Tennessee","Cheatham County",39105,"","Cheatham County Tennessee",39745,42846,640,1.63661935813835,1.63661935813835,3741,9.56655159186805,9.56655159186805
"47","023","G4700230","2010","3","6","Tennessee","Chester County",17131,"","Chester County Tennessee",16792,17321,-339,-1.97886871752962,1.97886871752962,190,1.1091004611523,1.1091004611523
"47","025","G4700250","2010","3","6","Tennessee","Claiborne County",32213,"","Claiborne County Tennessee",31471,34339,-742,-2.30341787477106,2.30341787477106,2126,6.59981994846801,6.59981994846801
"47","027","G4700270","2010","3","6","Tennessee","Clay County",7861,"","Clay County Tennessee",7869,8474,8,0.101768222872408,0.101768222872408,613,7.79799007759827,7.79799007759827
"47","029","G4700290","2010","3","6","Tennessee","Cocke County",35662,"","Cocke County Tennessee",35813,35480,151,0.42341988671415,0.42341988671415,-182,-0.510347148225001,0.510347148225001
"47","031","G4700310","2010","3","6","Tennessee","Coffee County",52796,"","Coffee County Tennessee",52537,54719,-259,-0.490567467232366,0.490567467232366,1923,3.64232138798394,3.64232138798394
"47","033","G4700330","2010","3","6","Tennessee","Crockett County",14586,"","Crockett County Tennessee",14470,15221,-116,-0.795283148224325,0.795283148224325,635,4.35348964760729,4.35348964760729
"47","035","G4700350","2010","3","6","Tennessee","Cumberland County",56053,"","Cumberland County Tennessee",54355,51421,-1698,-3.02927586391451,3.02927586391451,-4632,-8.26360765703887,8.26360765703887
"47","037","G4700370","2010","3","6","Tennessee","Davidson County",626681,"","Davidson County Tennessee",640239,644395,13558,2.16346115487784,2.16346115487784,17714,2.82663747584497,2.82663747584497
"47","039","G4700390","2010","3","6","Tennessee","Decatur County",11757,"","Decatur County Tennessee",11445,12390,-312,-2.65373819852003,2.65373819852003,633,5.38402653738199,5.38402653738199
"47","041","G4700410","2010","3","6","Tennessee","DeKalb County",18723,"","DeKalb County Tennessee",18977,18501,254,1.35662019975431,1.35662019975431,-222,-1.1857074186829,1.1857074186829
"47","043","G4700430","2010","3","6","Tennessee","Dickson County",49666,"","Dickson County Tennessee",48468,49980,-1198,-2.41211291426731,2.41211291426731,314,0.63222325131881,0.63222325131881
"47","045","G4700450","2010","3","6","Tennessee","Dyer County",38335,"","Dyer County Tennessee",37852,39872,-483,-1.25994521977305,1.25994521977305,1537,4.009390896048,4.009390896048
"47","047","G4700470","2010","3","6","Tennessee","Fayette County",38413,"","Fayette County Tennessee",38890,38550,477,1.24176711009294,1.24176711009294,137,0.35665009241663,0.35665009241663
"47","049","G4700490","2010","3","6","Tennessee","Fentress County",17959,"","Fentress County Tennessee",17680,17582,-279,-1.55353861573584,1.55353861573584,-377,-2.09922601481151,2.09922601481151
"47","051","G4700510","2010","3","6","Tennessee","Franklin County",41052,"","Franklin County Tennessee",41256,45041,204,0.496930722011108,0.496930722011108,3989,9.71694436324661,9.71694436324661
"47","053","G4700530","2010","3","6","Tennessee","Gibson County",49683,"","Gibson County Tennessee",49674,52474,-9,-0.0181148481371898,0.0181148481371898,2791,5.61761568343297,5.61761568343297
"47","055","G4700550","2010","3","6","Tennessee","Giles County",29485,"","Giles County Tennessee",28952,31088,-533,-1.80769882991352,1.80769882991352,1603,5.43666270985247,5.43666270985247
"47","057","G4700570","2010","3","6","Tennessee","Grainger County",22657,"","Grainger County Tennessee",23028,21938,371,1.6374630357064,1.6374630357064,-719,-3.173412190493,3.173412190493
"47","059","G4700590","2010","3","6","Tennessee","Greene County",68831,"","Greene County Tennessee",66158,69831,-2673,-3.88342461972077,3.88342461972077,1000,1.45283375223373,1.45283375223373
"47","061","G4700610","2010","3","6","Tennessee","Grundy County",13703,"","Grundy County Tennessee",14056,15159,353,2.5760782310443,2.5760782310443,1456,10.6254104940524,10.6254104940524
"47","063","G4700630","2010","3","6","Tennessee","Hamblen County",62544,"","Hamblen County Tennessee",63262,63184,718,1.14799181376311,1.14799181376311,640,1.02327961115375,1.02327961115375
"47","065","G4700650","2010","3","6","Tennessee","Hamilton County",336463,"","Hamilton County Tennessee",339911,346701,3448,1.02477835601537,1.02477835601537,10238,3.04283086104564,3.04283086104564
"47","067","G4700670","2010","3","6","Tennessee","Hancock County",6819,"","Hancock County Tennessee",6620,7103,-199,-2.91831646869042,2.91831646869042,284,4.16483355330694,4.16483355330694
"47","069","G4700690","2010","3","6","Tennessee","Hardeman County",27253,"","Hardeman County Tennessee",27236,30294,-17,-0.0623784537482112,0.0623784537482112,3041,11.1584045793124,11.1584045793124
"47","071","G4700710","2010","3","6","Tennessee","Hardin County",26026,"","Hardin County Tennessee",26291,27285,265,1.0182125566741,1.0182125566741,1259,4.83747022208561,4.83747022208561
"47","073","G4700730","2010","3","6","Tennessee","Hawkins County",56833,"","Hawkins County Tennessee",57880,57898,1047,1.84223954392694,1.84223954392694,1065,1.87391128393715,1.87391128393715
"47","075","G4700750","2010","3","6","Tennessee","Haywood County",18787,"","Haywood County Tennessee",18840,21097,53,0.282109969659871,0.282109969659871,2310,12.2957364134774,12.2957364134774
"47","077","G4700770","2010","3","6","Tennessee","Henderson County",27769,"","Henderson County Tennessee",26908,27284,-861,-3.10057978321149,3.10057978321149,-485,-1.74655191040369,1.74655191040369
"47","079","G4700790","2010","3","6","Tennessee","Henry County",32330,"","Henry County Tennessee",31940,33162,-390,-1.20630992885865,1.20630992885865,832,2.57346118156511,2.57346118156511
"47","081","G4700810","2010","3","6","Tennessee","Hickman County",24690,"","Hickman County Tennessee",24099,23590,-591,-2.39368165249089,2.39368165249089,-1100,-4.45524503847712,4.45524503847712
"47","083","G4700830","2010","3","6","Tennessee","Houston County",8426,"","Houston County Tennessee",8187,8552,-239,-2.83645858058391,2.83645858058391,126,1.49537146926181,1.49537146926181
"47","085","G4700850","2010","3","6","Tennessee","Humphreys County",18538,"","Humphreys County Tennessee",18345,19175,-193,-1.0411047577948,1.0411047577948,637,3.43618513323983,3.43618513323983
"47","087","G4700870","2010","3","6","Tennessee","Jackson County",11638,"","Jackson County Tennessee",10894,11631,-744,-6.39285100532738,6.39285100532738,-7,-0.0601477917167898,0.0601477917167898
"47","089","G4700890","2010","3","6","Tennessee","Jefferson County",51407,"","Jefferson County Tennessee",52012,52471,605,1.17688252572607,1.17688252572607,1064,2.0697570369794,2.0697570369794
"47","091","G4700910","2010","3","6","Tennessee","Johnson County",18244,"","Johnson County Tennessee",18127,19103,-117,-0.641306730980048,0.641306730980048,859,4.70839728129796,4.70839728129796
"47","093","G4700930","2010","3","6","Tennessee","Knox County",432226,"","Knox County Tennessee",437294,444095,5068,1.17253473877092,1.17253473877092,11869,2.7460171299274,2.7460171299274
"47","095","G4700950","2010","3","6","Tennessee","Lake County",7832,"","Lake County Tennessee",7286,8144,-546,-6.97139938712972,6.97139938712972,312,3.98365679264556,3.98365679264556
"47","097","G4700970","2010","3","6","Tennessee","Lauderdale County",27815,"","Lauderdale County Tennessee",26345,29980,-1470,-5.28491820959914,5.28491820959914,2165,7.78357001617832,7.78357001617832
"47","099","G4700990","2010","3","6","Tennessee","Lawrence County",41869,"","Lawrence County Tennessee",41659,41632,-210,-0.50156440325778,0.50156440325778,-237,-0.566051255105209,0.566051255105209
"47","101","G4701010","2010","3","6","Tennessee","Lewis County",12161,"","Lewis County Tennessee",11591,12007,-570,-4.68711454650111,4.68711454650111,-154,-1.26634322835293,1.26634322835293
"47","103","G4701030","2010","3","6","Tennessee","Lincoln County",33361,"","Lincoln County Tennessee",33600,32810,239,0.716405383531669,0.716405383531669,-551,-1.65162914780732,1.65162914780732
"47","105","G4701050","2010","3","6","Tennessee","Loudon County",48556,"","Loudon County Tennessee",47229,46234,-1327,-2.73292692973062,2.73292692973062,-2322,-4.78210725759947,4.78210725759947
"47","107","G4701070","2010","3","6","Tennessee","McMinn County",52266,"","McMinn County Tennessee",52860,51796,594,1.1364940879348,1.1364940879348,-470,-0.899246163854131,0.899246163854131
"47","109","G4701090","2010","3","6","Tennessee","McNairy County",26075,"","McNairy County Tennessee",25855,26083,-220,-0.843720038350911,0.843720038350911,8,0.0306807286673058,0.0306807286673058
"47","111","G4701110","2010","3","6","Tennessee","Macon County",22248,"","Macon County Tennessee",22337,22175,89,0.400035958288386,0.400035958288386,-73,-0.32811938151744,0.32811938151744
"47","113","G4701130","2010","3","6","Tennessee","Madison County",98294,"","Madison County Tennessee",98546,104849,252,0.256373735935052,0.256373735935052,6555,6.66876920259629,6.66876920259629
"47","115","G4701150","2010","3","6","Tennessee","Marion County",28237,"","Marion County Tennessee",28178,31293,-59,-0.208945709530049,0.208945709530049,3056,10.8226794631158,10.8226794631158
"47","117","G4701170","2010","3","6","Tennessee","Marshall County",30617,"","Marshall County Tennessee",30481,31499,-136,-0.444197667962243,0.444197667962243,882,2.88075252310808,2.88075252310808
"47","119","G4701190","2010","3","6","Tennessee","Maury County",80956,"","Maury County Tennessee",84784,88751,3828,4.72849449083453,4.72849449083453,7795,9.62868718810218,9.62868718810218
"47","121","G4701210","2010","3","6","Tennessee","Meigs County",11753,"","Meigs County Tennessee",12111,12486,358,3.04603080064664,3.04603080064664,733,6.23670552199438,6.23670552199438
"47","123","G4701230","2010","3","6","Tennessee","Monroe County",44519,"","Monroe County Tennessee",46093,43233,1574,3.5355690828635,3.5355690828635,-1286,-2.8886542824412,2.8886542824412
"47","125","G4701250","2010","3","6","Tennessee","Montgomery County",172331,"","Montgomery County Tennessee",161196,181449,-11135,-6.46140276560804,6.46140276560804,9118,5.29098072894604,5.29098072894604
"47","127","G4701270","2010","3","6","Tennessee","Moore County",6362,"","Moore County Tennessee",6063,6808,-299,-4.69977994341402,4.69977994341402,446,7.01037409619616,7.01037409619616
"47","129","G4701290","2010","3","6","Tennessee","Morgan County",21987,"","Morgan County Tennessee",18823,20965,-3164,-14.3903215536453,14.3903215536453,-1022,-4.64820120980579,4.64820120980579
"47","131","G4701310","2010","3","6","Tennessee","Obion County",31807,"","Obion County Tennessee",31308,33634,-499,-1.56883704844845,1.56883704844845,1827,5.74401861225516,5.74401861225516
"47","133","G4701330","2010","3","6","Tennessee","Overton County",22083,"","Overton County Tennessee",21040,21246,-1043,-4.72309015985147,4.72309015985147,-837,-3.79024589050401,3.79024589050401
"47","135","G4701350","2010","3","6","Tennessee","Perry County",7915,"","Perry County Tennessee",7851,8083,-64,-0.808591282375237,0.808591282375237,168,2.122552116235,2.122552116235
"47","137","G4701370","2010","3","6","Tennessee","Pickett County",5077,"","Pickett County Tennessee",4734,5234,-343,-6.75595824305692,6.75595824305692,157,3.09237738822139,3.09237738822139
"47","139","G4701390","2010","3","6","Tennessee","Polk County",16825,"","Polk County Tennessee",15632,18442,-1193,-7.09063893016345,7.09063893016345,1617,9.61069836552749,9.61069836552749
"47","141","G4701410","2010","3","6","Tennessee","Putnam County",72321,"","Putnam County Tennessee",73337,72983,1016,1.40484783119702,1.40484783119702,662,0.915363449067353,0.915363449067353
"47","143","G4701430","2010","3","6","Tennessee","Rhea County",31809,"","Rhea County Tennessee",31525,31707,-284,-0.892829073532648,0.892829073532648,-102,-0.320663963029331,0.320663963029331
"47","145","G4701450","2010","3","6","Tennessee","Roane County",54181,"","Roane County Tennessee",53130,55552,-1051,-1.93979439286835,1.93979439286835,1371,2.53040733836585,2.53040733836585
"47","147","G4701470","2010","3","6","Tennessee","Robertson County",66283,"","Robertson County Tennessee",67187,66861,904,1.36384895071134,1.36384895071134,578,0.872018466273404,0.872018466273404
"47","149","G4701490","2010","3","6","Tennessee","Rutherford County",262604,"","Rutherford County Tennessee",258995,269307,-3609,-1.37431265327261,1.37431265327261,6703,2.55251252836971,2.55251252836971
"47","151","G4701510","2010","3","6","Tennessee","Scott County",22228,"","Scott County Tennessee",21933,22357,-295,-1.32715493971567,1.32715493971567,129,0.5803491092316,0.5803491092316
"47","153","G4701530","2010","3","6","Tennessee","Sequatchie County",14112,"","Sequatchie County Tennessee",13677,12142,-435,-3.08248299319728,3.08248299319728,-1970,-13.9597505668934,13.9597505668934
"47","155","G4701550","2010","3","6","Tennessee","Sevier County",89889,"","Sevier County Tennessee",86721,83921,-3168,-3.52434669425625,3.52434669425625,-5968,-6.63929958059384,6.63929958059384
"47","157","G4701570","2010","3","6","Tennessee","Shelby County",927644,"","Shelby County Tennessee",924406,996432,-3238,-0.349056319018934,0.349056319018934,68788,7.41534467964003,7.41534467964003
"47","159","G4701590","2010","3","6","Tennessee","Smith County",19166,"","Smith County Tennessee",19077,19397,-89,-0.464363977877491,0.464363977877491,231,1.20525931336742,1.20525931336742
"47","161","G4701610","2010","3","6","Tennessee","Stewart County",13324,"","Stewart County Tennessee",13329,13247,5,0.0375262683878715,0.0375262683878715,-77,-0.577904533173221,0.577904533173221
"47","163","G4701630","2010","3","6","Tennessee","Sullivan County",156823,"","Sullivan County Tennessee",154496,165794,-2327,-1.48383846757172,1.48383846757172,8971,5.7204619220395,5.7204619220395
"47","165","G4701650","2010","3","6","Tennessee","Sumner County",160645,"","Sumner County Tennessee",160471,162996,-174,-0.108313361760403,0.108313361760403,2351,1.46347536493511,1.46347536493511
"47","167","G4701670","2010","3","6","Tennessee","Tipton County",61081,"","Tipton County Tennessee",59528,63990,-1553,-2.54252549892765,2.54252549892765,2909,4.76252844583422,4.76252844583422
"47","169","G4701690","2010","3","6","Tennessee","Trousdale County",7870,"","Trousdale County Tennessee",8017,8148,147,1.86785260482846,1.86785260482846,278,3.53240152477764,3.53240152477764
"47","171","G4701710","2010","3","6","Tennessee","Unicoi County",18313,"","Unicoi County Tennessee",17658,18563,-655,-3.57669415169552,3.57669415169552,250,1.36515043957844,1.36515043957844
"47","173","G4701730","2010","3","6","Tennessee","Union County",19109,"","Union County Tennessee",19017,21130,-92,-0.481448532105291,0.481448532105291,2021,10.5761682976608,10.5761682976608
"47","175","G4701750","2010","3","6","Tennessee","Van Buren County",5548,"","Van Buren County Tennessee",5452,5840,-96,-1.73035328046143,1.73035328046143,292,5.26315789473684,5.26315789473684
"47","177","G4701770","2010","3","6","Tennessee","Warren County",39839,"","Warren County Tennessee",40642,40481,803,2.01561284168779,2.01561284168779,642,1.61148623208414,1.61148623208414
"47","179","G4701790","2010","3","6","Tennessee","Washington County",122979,"","Washington County Tennessee",121742,122537,-1237,-1.00586278958196,1.00586278958196,-442,-0.35941095634214,0.35941095634214
"47","181","G4701810","2010","3","6","Tennessee","Wayne County",17021,"","Wayne County Tennessee",16420,17890,-601,-3.53093237765114,3.53093237765114,869,5.10545796369191,5.10545796369191
"47","183","G4701830","2010","3","6","Tennessee","Weakley County",35021,"","Weakley County Tennessee",34185,37095,-836,-2.38713914508438,2.38713914508438,2074,5.92216098912081,5.92216098912081
"47","185","G4701850","2010","3","6","Tennessee","White County",25841,"","White County Tennessee",25466,24454,-375,-1.45118222978987,1.45118222978987,-1387,-5.36743934058279,5.36743934058279
"47","187","G4701870","2010","3","6","Tennessee","Williamson County",183182,"","Williamson County Tennessee",179159,171548,-4023,-2.19617648022186,2.19617648022186,-11634,-6.35106069373628,6.35106069373628
"47","189","G4701890","2010","3","6","Tennessee","Wilson County",113993,"","Wilson County Tennessee",113736,114605,-257,-0.225452440062109,0.225452440062109,612,0.536875071276306,0.536875071276306
"48","001","G4800010","2010","3","7","Texas","Anderson County",58458,"","Anderson County Texas",57157,58582,-1301,-2.22552943993979,2.22552943993979,124,0.212118101885114,0.212118101885114
"48","003","G4800030","2010","3","7","Texas","Andrews County",14786,"","Andrews County Texas",14213,14062,-573,-3.87528743405925,3.87528743405925,-724,-4.89652373867172,4.89652373867172
"48","005","G4800050","2010","3","7","Texas","Angelina County",86771,"","Angelina County Texas",84199,85435,-2572,-2.96412395846539,2.96412395846539,-1336,-1.53968491777207,1.53968491777207
"48","007","G4800070","2010","3","7","Texas","Aransas County",23158,"","Aransas County Texas",24728,26286,1570,6.77951463856983,6.77951463856983,3128,13.5072113308576,13.5072113308576
"48","009","G4800090","2010","3","7","Texas","Archer County",9054,"","Archer County Texas",8930,9322,-124,-1.36956041528606,1.36956041528606,268,2.96001767174729,2.96001767174729
"48","011","G4800110","2010","3","7","Texas","Armstrong County",1901,"","Armstrong County Texas",2075,2214,174,9.15307732772225,9.15307732772225,313,16.4650184113624,16.4650184113624
"48","013","G4800130","2010","3","7","Texas","Atascosa County",44911,"","Atascosa County Texas",44813,41758,-98,-0.218209347375921,0.218209347375921,-3153,-7.02055175792122,7.02055175792122
"48","015","G4800150","2010","3","7","Texas","Austin County",28417,"","Austin County Texas",27373,25442,-1044,-3.67385719815603,3.67385719815603,-2975,-10.4690854066228,10.4690854066228
"48","017","G4800170","2010","3","7","Texas","Bailey County",7165,"","Bailey County Texas",6226,6675,-939,-13.1053733426378,13.1053733426378,-490,-6.83879972086532,6.83879972086532
"48","019","G4800190","2010","3","7","Texas","Bandera County",20485,"","Bandera County Texas",20471,18836,-14,-0.0683426897730046,0.0683426897730046,-1649,-8.04979253112033,8.04979253112033
"48","021","G4800210","2010","3","7","Texas","Bastrop County",74171,"","Bastrop County Texas",75505,65927,1334,1.79854660177158,1.79854660177158,-8244,-11.1148562106484,11.1148562106484
"48","023","G4800230","2010","3","7","Texas","Baylor County",3726,"","Baylor County Texas",3652,4136,-74,-1.98604401502952,1.98604401502952,410,11.003757380569,11.003757380569
"48","025","G4800250","2010","3","7","Texas","Bee County",31861,"","Bee County Texas",32653,33302,792,2.48579768368852,2.48579768368852,1441,4.52277078559995,4.52277078559995
"48","027","G4800270","2010","3","7","Texas","Bell County",310235,"","Bell County Texas",289267,306260,-20968,-6.75874740116363,6.75874740116363,-3975,-1.28128676648347,1.28128676648347
"48","029","G4800290","2010","3","7","Texas","Bexar County",1714773,"","Bexar County Texas",1672592,1658185,-42181,-2.45985911837893,2.45985911837893,-56588,-3.30002863352759,3.30002863352759
"48","031","G4800310","2010","3","7","Texas","Blanco County",10497,"","Blanco County Texas",9327,9206,-1170,-11.1460417262075,11.1460417262075,-1291,-12.2987520243879,12.2987520243879
"48","033","G4800330","2010","3","7","Texas","Borden County",641,"","Borden County Texas",633,764,-8,-1.24804992199688,1.24804992199688,123,19.188767550702,19.188767550702
"48","035","G4800350","2010","3","7","Texas","Bosque County",18212,"","Bosque County Texas",17796,17913,-416,-2.28420821436416,2.28420821436416,-299,-1.64177465407424,1.64177465407424
"48","037","G4800370","2010","3","7","Texas","Bowie County",92565,"","Bowie County Texas",94241,95652,1676,1.81061956463026,1.81061956463026,3087,3.33495381623724,3.33495381623724
"48","039","G4800390","2010","3","7","Texas","Brazoria County",313166,"","Brazoria County Texas",313069,318661,-97,-0.0309739882362709,0.0309739882362709,5495,1.75466046761143,1.75466046761143
"48","041","G4800410","2010","3","7","Texas","Brazos County",194851,"","Brazos County Texas",182357,191947,-12494,-6.41207897316411,6.41207897316411,-2904,-1.49036956443642,1.49036956443642
"48","043","G4800430","2010","3","7","Texas","Brewster County",9232,"","Brewster County Texas",9860,9495,628,6.80242634315425,6.80242634315425,263,2.84878682842288,2.84878682842288
"48","045","G4800450","2010","3","7","Texas","Briscoe County",1637,"","Briscoe County Texas",1444,1876,-193,-11.7898594990837,11.7898594990837,239,14.5998778252902,14.5998778252902
"48","047","G4800470","2010","3","7","Texas","Brooks County",7223,"","Brooks County Texas",7319,8199,96,1.32908763671605,1.32908763671605,976,13.5123909732798,13.5123909732798
"48","049","G4800490","2010","3","7","Texas","Brown County",38106,"","Brown County Texas",38176,40439,70,0.183698105285257,0.183698105285257,2333,6.12239542329292,6.12239542329292
"48","051","G4800510","2010","3","7","Texas","Burleson County",17187,"","Burleson County Texas",16621,17582,-566,-3.29318671088613,3.29318671088613,395,2.29824867632513,2.29824867632513
"48","053","G4800530","2010","3","7","Texas","Burnet County",42750,"","Burnet County Texas",45403,44507,2653,6.20584795321637,6.20584795321637,1757,4.10994152046784,4.10994152046784
"48","055","G4800550","2010","3","7","Texas","Caldwell County",38066,"","Caldwell County Texas",37853,36468,-213,-0.559554458046551,0.559554458046551,-1598,-4.19797194346661,4.19797194346661
"48","057","G4800570","2010","3","7","Texas","Calhoun County",21381,"","Calhoun County Texas",20547,22529,-834,-3.9006594640101,3.9006594640101,1148,5.36925307516019,5.36925307516019
"48","059","G4800590","2010","3","7","Texas","Callahan County",13544,"","Callahan County Texas",13368,13594,-176,-1.2994683992912,1.2994683992912,50,0.369167158889545,0.369167158889545
"48","061","G4800610","2010","3","7","Texas","Cameron County",406220,"","Cameron County Texas",400621,413280,-5599,-1.37831716803702,1.37831716803702,7060,1.73797449657821,1.73797449657821
"48","063","G4800630","2010","3","7","Texas","Camp County",12401,"","Camp County Texas",12749,12109,348,2.80622530441093,2.80622530441093,-292,-2.35464881864366,2.35464881864366
"48","065","G4800650","2010","3","7","Texas","Carson County",6182,"","Carson County Texas",6024,6737,-158,-2.5558071821417,2.5558071821417,555,8.97767712714332,8.97767712714332
"48","067","G4800670","2010","3","7","Texas","Cass County",30464,"","Cass County Texas",29291,32049,-1173,-3.85044642857143,3.85044642857143,1585,5.20286239495798,5.20286239495798
"48","069","G4800690","2010","3","7","Texas","Castro County",8062,"","Castro County Texas",7264,8374,-798,-9.89828826593897,9.89828826593897,312,3.870007442322,3.870007442322
"48","071","G4800710","2010","3","7","Texas","Chambers County",35096,"","Chambers County Texas",32135,36333,-2961,-8.43685890129929,8.43685890129929,1237,3.52461819010713,3.52461819010713
"48","073","G4800730","2010","3","7","Texas","Cherokee County",50845,"","Cherokee County Texas",48828,49618,-2017,-3.96695840298948,3.96695840298948,-1227,-2.41321663880421,2.41321663880421
"48","075","G4800750","2010","3","7","Texas","Childress County",7041,"","Childress County Texas",7632,7788,591,8.3936940775458,8.3936940775458,747,10.6092884533447,10.6092884533447
"48","077","G4800770","2010","3","7","Texas","Clay County",10752,"","Clay County Texas",10804,11513,52,0.483630952380952,0.483630952380952,761,7.07775297619048,7.07775297619048
"48","079","G4800790","2010","3","7","Texas","Cochran County",3127,"","Cochran County Texas",2977,3752,-150,-4.79692996482251,4.79692996482251,625,19.9872081867605,19.9872081867605
"48","081","G4800810","2010","3","7","Texas","Coke County",3320,"","Coke County Texas",3224,4038,-96,-2.89156626506024,2.89156626506024,718,21.6265060240964,21.6265060240964
"48","083","G4800830","2010","3","7","Texas","Coleman County",8895,"","Coleman County Texas",8483,9480,-412,-4.6318156267566,4.6318156267566,585,6.57672849915683,6.57672849915683
"48","085","G4800850","2010","3","7","Texas","Collin County",782341,"","Collin County Texas",808830,743746,26489,3.38586370904759,3.38586370904759,-38595,-4.93327078601275,4.93327078601275
"48","087","G4800870","2010","3","7","Texas","Collingsworth County",3057,"","Collingsworth County Texas",3033,3197,-24,-0.785083415112856,0.785083415112856,140,4.57965325482499,4.57965325482499
"48","089","G4800890","2010","3","7","Texas","Colorado County",20874,"","Colorado County Texas",20722,21134,-152,-0.728178595381815,0.728178595381815,260,1.24556864999521,1.24556864999521
"48","091","G4800910","2010","3","7","Texas","Comal County",108472,"","Comal County Texas",117156,114417,8684,8.00575263662512,8.00575263662512,5945,5.48067704107973,5.48067704107973
"48","093","G4800930","2010","3","7","Texas","Comanche County",13974,"","Comanche County Texas",13587,14578,-387,-2.769428939459,2.769428939459,604,4.32231286675254,4.32231286675254
"48","095","G4800950","2010","3","7","Texas","Concho County",4087,"","Concho County Texas",3516,4140,-571,-13.9711279667238,13.9711279667238,53,1.29679471494984,1.29679471494984
"48","097","G4800970","2010","3","7","Texas","Cooke County",38437,"","Cooke County Texas",38752,38746,315,0.819522855581861,0.819522855581861,309,0.803912896427921,0.803912896427921
"48","099","G4800990","2010","3","7","Texas","Coryell County",75388,"","Coryell County Texas",70743,83426,-4645,-6.1614580569852,6.1614580569852,8038,10.6621743513557,10.6621743513557
"48","101","G4801010","2010","3","7","Texas","Cottle County",1505,"","Cottle County Texas",1545,1887,40,2.6578073089701,2.6578073089701,382,25.3820598006645,25.3820598006645
"48","103","G4801030","2010","3","7","Texas","Crane County",4375,"","Crane County Texas",4179,4129,-196,-4.48,4.48,-246,-5.62285714285714,5.62285714285714
"48","105","G4801050","2010","3","7","Texas","Crockett County",3719,"","Crockett County Texas",3719,4297,0,0,0,578,15.5418123151385,15.5418123151385
"48","107","G4801070","2010","3","7","Texas","Crosby County",6059,"","Crosby County Texas",6068,7176,9,0.148539362931177,0.148539362931177,1117,18.4353853771249,18.4353853771249
"48","109","G4801090","2010","3","7","Texas","Culberson County",2398,"","Culberson County Texas",2352,3132,-46,-1.91826522101751,1.91826522101751,734,30.6088407005838,30.6088407005838
"48","111","G4801110","2010","3","7","Texas","Dallam County",6703,"","Dallam County Texas",6373,6460,-330,-4.92316873041922,4.92316873041922,-243,-3.62524242876324,3.62524242876324
"48","113","G4801130","2010","3","7","Texas","Dallas County",2368139,"","Dallas County Texas",2483536,2488475,115397,4.87289808579648,4.87289808579648,120336,5.08145847857748,5.08145847857748
"48","115","G4801150","2010","3","7","Texas","Dawson County",13833,"","Dawson County Texas",13838,15069,5,0.0361454492879346,0.0361454492879346,1236,8.93515506397745,8.93515506397745
"48","117","G4801170","2010","3","7","Texas","Deaf Smith County",19372,"","Deaf Smith County Texas",18580,19091,-792,-4.08837497418955,4.08837497418955,-281,-1.45054718149907,1.45054718149907
"48","119","G4801190","2010","3","7","Texas","Delta County",5231,"","Delta County Texas",5437,5562,206,3.93806155610782,3.93806155610782,331,6.32766201491111,6.32766201491111
"48","121","G4801210","2010","3","7","Texas","Denton County",662614,"","Denton County Texas",670885,599305,8271,1.24823803903932,1.24823803903932,-63309,-9.55443138841014,9.55443138841014
"48","123","G4801230","2010","3","7","Texas","DeWitt County",20097,"","DeWitt County Texas",19785,20639,-312,-1.55247051798776,1.55247051798776,542,2.69691993829925,2.69691993829925
"48","125","G4801250","2010","3","7","Texas","Dickens County",2444,"","Dickens County Texas",2466,2859,22,0.900163666121113,0.900163666121113,415,16.9803600654664,16.9803600654664
"48","127","G4801270","2010","3","7","Texas","Dimmit County",9996,"","Dimmit County Texas",9812,10653,-184,-1.84073629451781,1.84073629451781,657,6.57262905162065,6.57262905162065
"48","129","G4801290","2010","3","7","Texas","Donley County",3677,"","Donley County Texas",3715,3956,38,1.03345118302964,1.03345118302964,279,7.5877073701387,7.5877073701387
"48","131","G4801310","2010","3","7","Texas","Duval County",11782,"","Duval County Texas",11835,13764,53,0.449838737056527,0.449838737056527,1982,16.822271261246,16.822271261246
"48","133","G4801330","2010","3","7","Texas","Eastland County",18583,"","Eastland County Texas",18229,18856,-354,-1.90496690523597,1.90496690523597,273,1.46908464725825,1.46908464725825
"48","135","G4801350","2010","3","7","Texas","Ector County",137130,"","Ector County Texas",134919,128489,-2211,-1.61233865674907,1.61233865674907,-8641,-6.30131991540874,6.30131991540874
"48","137","G4801370","2010","3","7","Texas","Edwards County",2002,"","Edwards County Texas",1810,2268,-192,-9.59040959040959,9.59040959040959,266,13.2867132867133,13.2867132867133
"48","139","G4801390","2010","3","7","Texas","Ellis County",149610,"","Ellis County Texas",154184,150266,4574,3.05728226722813,3.05728226722813,656,0.438473364079941,0.438473364079941
"48","141","G4801410","2010","3","7","Texas","El Paso County",800647,"","El Paso County Texas",759042,795739,-41605,-5.19642239338935,5.19642239338935,-4908,-0.613004232826701,0.613004232826701
"48","143","G4801430","2010","3","7","Texas","Erath County",37890,"","Erath County Texas",36263,36075,-1627,-4.29400897334389,4.29400897334389,-1815,-4.7901821060966,4.7901821060966
"48","145","G4801450","2010","3","7","Texas","Falls County",17866,"","Falls County Texas",16848,19148,-1018,-5.69797380499272,5.69797380499272,1282,7.17564088212247,7.17564088212247
"48","147","G4801470","2010","3","7","Texas","Fannin County",33915,"","Fannin County Texas",32910,33263,-1005,-2.96329057938965,2.96329057938965,-652,-1.92245319180304,1.92245319180304
"48","149","G4801490","2010","3","7","Texas","Fayette County",24554,"","Fayette County Texas",22717,22735,-1837,-7.48146941435204,7.48146941435204,-1819,-7.40816160299747,7.40816160299747
"48","151","G4801510","2010","3","7","Texas","Fisher County",3974,"","Fisher County Texas",3773,4458,-201,-5.05787619526925,5.05787619526925,484,12.1791645697031,12.1791645697031
"48","153","G4801530","2010","3","7","Texas","Floyd County",6446,"","Floyd County Texas",6420,7859,-26,-0.403350915296308,0.403350915296308,1413,21.9205708966801,21.9205708966801
"48","155","G4801550","2010","3","7","Texas","Foard County",1336,"","Foard County Texas",1360,1673,24,1.79640718562874,1.79640718562874,337,25.2245508982036,25.2245508982036
"48","157","G4801570","2010","3","7","Texas","Fort Bend County",585375,"","Fort Bend County Texas",570484,507618,-14891,-2.54383941917574,2.54383941917574,-77757,-13.2832799487508,13.2832799487508
"48","159","G4801590","2010","3","7","Texas","Franklin County",10605,"","Franklin County Texas",10906,10057,301,2.83828382838284,2.83828382838284,-548,-5.16737388024517,5.16737388024517
"48","161","G4801610","2010","3","7","Texas","Freestone County",19816,"","Freestone County Texas",19380,19212,-436,-2.20024222850222,2.20024222850222,-604,-3.04804198627372,3.04804198627372
"48","163","G4801630","2010","3","7","Texas","Frio County",17217,"","Frio County Texas",16297,17108,-920,-5.34355578788407,5.34355578788407,-109,-0.633095196608004,0.633095196608004
"48","165","G4801650","2010","3","7","Texas","Gaines County",17526,"","Gaines County Texas",15546,15102,-1980,-11.2975008558713,11.2975008558713,-2424,-13.8308798356727,13.8308798356727
"48","167","G4801670","2010","3","7","Texas","Galveston County",291309,"","Galveston County Texas",290939,303985,-370,-0.127012896958213,0.127012896958213,12676,4.35139319416839,4.35139319416839
"48","169","G4801690","2010","3","7","Texas","Garza County",6461,"","Garza County Texas",4704,4967,-1757,-27.1939328277356,27.1939328277356,-1494,-23.1233555177217,23.1233555177217
"48","171","G4801710","2010","3","7","Texas","Gillespie County",24837,"","Gillespie County Texas",24483,23377,-354,-1.42529290977171,1.42529290977171,-1460,-5.87832669001892,5.87832669001892
"48","173","G4801730","2010","3","7","Texas","Glasscock County",1226,"","Glasscock County Texas",1235,1483,9,0.734094616639478,0.734094616639478,257,20.9624796084829,20.9624796084829
"48","175","G4801750","2010","3","7","Texas","Goliad County",7210,"","Goliad County Texas",7035,7305,-175,-2.42718446601942,2.42718446601942,95,1.31761442441054,1.31761442441054
"48","177","G4801770","2010","3","7","Texas","Gonzales County",19807,"","Gonzales County Texas",19715,19340,-92,-0.464482253748675,0.464482253748675,-467,-2.35775230978947,2.35775230978947
"48","179","G4801790","2010","3","7","Texas","Gray County",22535,"","Gray County Texas",21820,22873,-715,-3.17284224539605,3.17284224539605,338,1.49988906145995,1.49988906145995
"48","181","G4801810","2010","3","7","Texas","Grayson County",120877,"","Grayson County Texas",120899,120314,22,0.0182003193328756,0.0182003193328756,-563,-0.465762717473134,0.465762717473134
"48","183","G4801830","2010","3","7","Texas","Gregg County",121730,"","Gregg County Texas",120076,118269,-1654,-1.35874476300008,1.35874476300008,-3461,-2.84317752402859,2.84317752402859
"48","185","G4801850","2010","3","7","Texas","Grimes County",26604,"","Grimes County Texas",26260,25043,-344,-1.29303864080589,1.29303864080589,-1561,-5.86753871598256,5.86753871598256
"48","187","G4801870","2010","3","7","Texas","Guadalupe County",131533,"","Guadalupe County Texas",123417,117115,-8116,-6.17031467388412,6.17031467388412,-14418,-10.9615077585093,10.9615077585093
"48","189","G4801890","2010","3","7","Texas","Hale County",36273,"","Hale County Texas",35699,37576,-574,-1.58244424227387,1.58244424227387,1303,3.59220356739172,3.59220356739172
"48","191","G4801910","2010","3","7","Texas","Hall County",3353,"","Hall County Texas",3322,3790,-31,-0.924545183417835,0.924545183417835,437,13.033104682374,13.033104682374
"48","193","G4801930","2010","3","7","Texas","Hamilton County",8517,"","Hamilton County Texas",8007,8485,-510,-5.98802395209581,5.98802395209581,-32,-0.375719149935423,0.375719149935423
"48","195","G4801950","2010","3","7","Texas","Hansford County",5613,"","Hansford County Texas",5399,5390,-214,-3.81257794405844,3.81257794405844,-223,-3.97292000712631,3.97292000712631
"48","197","G4801970","2010","3","7","Texas","Hardeman County",4139,"","Hardeman County Texas",3902,4741,-237,-5.72602077796569,5.72602077796569,602,14.5445759845373,14.5445759845373
"48","199","G4801990","2010","3","7","Texas","Hardin County",54635,"","Hardin County Texas",53715,51867,-920,-1.68390226045575,1.68390226045575,-2768,-5.06634940971904,5.06634940971904
"48","201","G4802010","2010","3","7","Texas","Harris County",4092459,"","Harris County Texas",4128979,4226035,36520,0.892373020719328,0.892373020719328,133576,3.26395450754669,3.26395450754669
"48","203","G4802030","2010","3","7","Texas","Harrison County",65631,"","Harrison County Texas",65126,65319,-505,-0.769453459493227,0.769453459493227,-312,-0.475385107647301,0.475385107647301
"48","205","G4802050","2010","3","7","Texas","Hartley County",6062,"","Hartley County Texas",4965,5768,-1097,-18.0963378422963,18.0963378422963,-294,-4.84988452655889,4.84988452655889
"48","207","G4802070","2010","3","7","Texas","Haskell County",5899,"","Haskell County Texas",5018,6268,-881,-14.9347347007967,14.9347347007967,369,6.25529750805221,6.25529750805221
"48","209","G4802090","2010","3","7","Texas","Hays County",157107,"","Hays County Texas",159598,148568,2491,1.58554361040565,1.58554361040565,-8539,-5.43514929315689,5.43514929315689
"48","211","G4802110","2010","3","7","Texas","Hemphill County",3807,"","Hemphill County Texas",3459,3411,-348,-9.14105594956659,9.14105594956659,-396,-10.4018912529551,10.4018912529551
"48","213","G4802130","2010","3","7","Texas","Henderson County",78532,"","Henderson County Texas",79308,79092,776,0.988132226353588,0.988132226353588,560,0.713085111801559,0.713085111801559
"48","215","G4802150","2010","3","7","Texas","Hidalgo County",774769,"","Hidalgo County Texas",756020,766523,-18749,-2.41994710681506,2.41994710681506,-8246,-1.06431723520172,1.06431723520172
"48","217","G4802170","2010","3","7","Texas","Hill County",35089,"","Hill County Texas",35982,33833,893,2.54495710906552,2.54495710906552,-1256,-3.57946934936875,3.57946934936875
"48","219","G4802190","2010","3","7","Texas","Hockley County",22935,"","Hockley County Texas",22148,23501,-787,-3.43143666884674,3.43143666884674,566,2.46784390669283,2.46784390669283
"48","221","G4802210","2010","3","7","Texas","Hood County",51182,"","Hood County Texas",51927,45344,745,1.45558985580868,1.45558985580868,-5838,-11.4063537962565,11.4063537962565
"48","223","G4802230","2010","3","7","Texas","Hopkins County",35161,"","Hopkins County Texas",34795,33688,-366,-1.04092602599471,1.04092602599471,-1473,-4.18930064560166,4.18930064560166
"48","225","G4802250","2010","3","7","Texas","Houston County",23732,"","Houston County Texas",22405,24211,-1327,-5.59160627001517,5.59160627001517,479,2.0183718186415,2.0183718186415
"48","227","G4802270","2010","3","7","Texas","Howard County",35012,"","Howard County Texas",32860,34278,-2152,-6.1464640694619,6.1464640694619,-734,-2.09642408317148,2.09642408317148
"48","229","G4802290","2010","3","7","Texas","Hudspeth County",3476,"","Hudspeth County Texas",3120,3574,-356,-10.2416570771001,10.2416570771001,98,2.81933256616801,2.81933256616801
"48","231","G4802310","2010","3","7","Texas","Hunt County",86129,"","Hunt County Texas",83462,82861,-2667,-3.09651801367716,3.09651801367716,-3268,-3.79430853719421,3.79430853719421
"48","233","G4802330","2010","3","7","Texas","Hutchinson County",22150,"","Hutchinson County Texas",21591,24110,-559,-2.52370203160271,2.52370203160271,1960,8.84875846501129,8.84875846501129
"48","235","G4802350","2010","3","7","Texas","Irion County",1599,"","Irion County Texas",1771,1850,172,10.7567229518449,10.7567229518449,251,15.697310819262,15.697310819262
"48","237","G4802370","2010","3","7","Texas","Jack County",9044,"","Jack County Texas",8542,9019,-502,-5.55064130915524,5.55064130915524,-25,-0.276426360017691,0.276426360017691
"48","239","G4802390","2010","3","7","Texas","Jackson County",14075,"","Jackson County Texas",14303,14750,228,1.61989342806394,1.61989342806394,675,4.79573712255773,4.79573712255773
"48","241","G4802410","2010","3","7","Texas","Jasper County",35710,"","Jasper County Texas",34655,36486,-1055,-2.95435452254271,2.95435452254271,776,2.17306076729207,2.17306076729207
"48","243","G4802430","2010","3","7","Texas","Jeff Davis County",2342,"","Jeff Davis County Texas",2267,2316,-75,-3.20239111870196,3.20239111870196,-26,-1.11016225448335,1.11016225448335
"48","245","G4802450","2010","3","7","Texas","Jefferson County",252273,"","Jefferson County Texas",243811,267220,-8462,-3.35430268003314,3.35430268003314,14947,5.92493053160663,5.92493053160663
"48","247","G4802470","2010","3","7","Texas","Jim Hogg County",5300,"","Jim Hogg County Texas",4986,5539,-314,-5.92452830188679,5.92452830188679,239,4.50943396226415,4.50943396226415
"48","249","G4802490","2010","3","7","Texas","Jim Wells County",40838,"","Jim Wells County Texas",41478,41451,640,1.56716783388021,1.56716783388021,613,1.50105294088839,1.50105294088839
"48","251","G4802510","2010","3","7","Texas","Johnson County",150934,"","Johnson County Texas",157255,151343,6321,4.18792319821909,4.18792319821909,409,0.270979368465687,0.270979368465687
"48","253","G4802530","2010","3","7","Texas","Jones County",20202,"","Jones County Texas",19031,21776,-1171,-5.7964557964558,5.7964557964558,1574,7.79130779130779,7.79130779130779
"48","255","G4802550","2010","3","7","Texas","Karnes County",14824,"","Karnes County Texas",15107,16191,283,1.90906637884512,1.90906637884512,1367,9.22153264975715,9.22153264975715
"48","257","G4802570","2010","3","7","Texas","Kaufman County",103350,"","Kaufman County Texas",104904,88205,1554,1.50362844702467,1.50362844702467,-15145,-14.6540880503145,14.6540880503145
"48","259","G4802590","2010","3","7","Texas","Kendall County",33410,"","Kendall County Texas",34901,34246,1491,4.46273570787189,4.46273570787189,836,2.50224483687519,2.50224483687519
"48","261","G4802610","2010","3","7","Texas","Kenedy County",416,"","Kenedy County Texas",382,432,-34,-8.17307692307692,8.17307692307692,16,3.84615384615385,3.84615384615385
"48","263","G4802630","2010","3","7","Texas","Kent County",808,"","Kent County Texas",707,900,-101,-12.5,12.5,92,11.3861386138614,11.3861386138614
"48","265","G4802650","2010","3","7","Texas","Kerr County",49625,"","Kerr County Texas",48569,46699,-1056,-2.127959697733,2.127959697733,-2926,-5.89622166246851,5.89622166246851
"48","267","G4802670","2010","3","7","Texas","Kimble County",4607,"","Kimble County Texas",4479,4629,-128,-2.77838072498372,2.77838072498372,22,0.477534187106577,0.477534187106577
"48","269","G4802690","2010","3","7","Texas","King County",286,"","King County Texas",273,373,-13,-4.54545454545455,4.54545454545455,87,30.4195804195804,30.4195804195804
"48","271","G4802710","2010","3","7","Texas","Kinney County",3598,"","Kinney County Texas",3255,3511,-343,-9.53307392996109,9.53307392996109,-87,-2.41801000555864,2.41801000555864
"48","273","G4802730","2010","3","7","Texas","Kleberg County",32061,"","Kleberg County Texas",30969,32393,-1092,-3.40600729858707,3.40600729858707,332,1.03552602850816,1.03552602850816
"48","275","G4802750","2010","3","7","Texas","Knox County",3719,"","Knox County Texas",3377,4405,-342,-9.19602043560097,9.19602043560097,686,18.4458187684862,18.4458187684862
"48","277","G4802770","2010","3","7","Texas","Lamar County",49793,"","Lamar County Texas",49297,51101,-496,-0.996123953166108,0.996123953166108,1308,2.62687526359127,2.62687526359127
"48","279","G4802790","2010","3","7","Texas","Lamb County",13977,"","Lamb County Texas",13413,14881,-564,-4.03520068684267,4.03520068684267,904,6.46776847678329,6.46776847678329
"48","281","G4802810","2010","3","7","Texas","Lampasas County",19677,"","Lampasas County Texas",21028,19346,1351,6.86588402703664,6.86588402703664,-331,-1.68216699700158,1.68216699700158
"48","283","G4802830","2010","3","7","Texas","La Salle County",6886,"","La Salle County Texas",5864,6154,-1022,-14.8417078129538,14.8417078129538,-732,-10.6302643043857,10.6302643043857
"48","285","G4802850","2010","3","7","Texas","Lavaca County",19263,"","Lavaca County Texas",18511,19923,-752,-3.903857135441,3.903857135441,660,3.42625759227535,3.42625759227535
"48","287","G4802870","2010","3","7","Texas","Lee County",16612,"","Lee County Texas",16206,16715,-406,-2.44401637370575,2.44401637370575,103,0.620033710570672,0.620033710570672
"48","289","G4802890","2010","3","7","Texas","Leon County",16801,"","Leon County Texas",16806,16284,5,0.0297601333253973,0.0297601333253973,-517,-3.07719778584608,3.07719778584608
"48","291","G4802910","2010","3","7","Texas","Liberty County",75643,"","Liberty County Texas",76265,77604,622,0.822283621749534,0.822283621749534,1961,2.59244080747723,2.59244080747723
"48","293","G4802930","2010","3","7","Texas","Limestone County",23384,"","Limestone County Texas",22432,22966,-952,-4.0711597673623,4.0711597673623,-418,-1.7875470407116,1.7875470407116
"48","295","G4802950","2010","3","7","Texas","Lipscomb County",3302,"","Lipscomb County Texas",3038,3106,-264,-7.99515445184737,7.99515445184737,-196,-5.93579648697759,5.93579648697759
"48","297","G4802970","2010","3","7","Texas","Live Oak County",11531,"","Live Oak County Texas",11182,12888,-349,-3.02662388344463,3.02662388344463,1357,11.7682768190096,11.7682768190096
"48","299","G4802990","2010","3","7","Texas","Llano County",19301,"","Llano County Texas",18342,20708,-959,-4.96865447386146,4.96865447386146,1407,7.28977773172375,7.28977773172375
"48","301","G4803010","2010","3","7","Texas","Loving County",82,"","Loving County Texas",57,71,-25,-30.4878048780488,30.4878048780488,-11,-13.4146341463415,13.4146341463415
"48","303","G4803030","2010","3","7","Texas","Lubbock County",278831,"","Lubbock County Texas",275199,284084,-3632,-1.3025811333747,1.3025811333747,5253,1.88393686498273,1.88393686498273
"48","305","G4803050","2010","3","7","Texas","Lynn County",5915,"","Lynn County Texas",5639,6677,-276,-4.66610312764159,4.66610312764159,762,12.8825021132713,12.8825021132713
"48","307","G4803070","2010","3","7","Texas","McCulloch County",8283,"","McCulloch County Texas",7898,8483,-385,-4.64807436918991,4.64807436918991,200,2.41458408789086,2.41458408789086
"48","309","G4803090","2010","3","7","Texas","McLennan County",234906,"","McLennan County Texas",237355,236916,2449,1.04254467744545,1.04254467744545,2010,0.855661413501571,0.855661413501571
"48","311","G4803110","2010","3","7","Texas","McMullen County",707,"","McMullen County Texas",831,898,124,17.5388967468175,17.5388967468175,191,27.015558698727,27.015558698727
"48","313","G4803130","2010","3","7","Texas","Madison County",13664,"","Madison County Texas",13587,13816,-77,-0.563524590163934,0.563524590163934,152,1.11241217798595,1.11241217798595
"48","315","G4803150","2010","3","7","Texas","Marion County",10546,"","Marion County Texas",10146,11595,-400,-3.79290726341741,3.79290726341741,1049,9.94689929831216,9.94689929831216
"48","317","G4803170","2010","3","7","Texas","Martin County",4799,"","Martin County Texas",4676,5424,-123,-2.56303396540946,2.56303396540946,625,13.0235465722025,13.0235465722025
"48","319","G4803190","2010","3","7","Texas","Mason County",4012,"","Mason County Texas",4027,3904,15,0.373878364905284,0.373878364905284,-108,-2.69192422731805,2.69192422731805
"48","321","G4803210","2010","3","7","Texas","Matagorda County",36702,"","Matagorda County Texas",37077,40075,375,1.02174268432238,1.02174268432238,3373,9.19023486458504,9.19023486458504
"48","323","G4803230","2010","3","7","Texas","Maverick County",54258,"","Maverick County Texas",53703,54097,-555,-1.02289063363928,1.02289063363928,-161,-0.296730436064728,0.296730436064728
"48","325","G4803250","2010","3","7","Texas","Medina County",46006,"","Medina County Texas",44944,42299,-1062,-2.30839455723167,2.30839455723167,-3707,-8.05764465504499,8.05764465504499
"48","327","G4803270","2010","3","7","Texas","Menard County",2242,"","Menard County Texas",2130,2473,-112,-4.99553969669938,4.99553969669938,231,10.3033006244425,10.3033006244425
"48","329","G4803290","2010","3","7","Texas","Midland County",136872,"","Midland County Texas",132741,123581,-4131,-3.01814834297738,3.01814834297738,-13291,-9.71053246829154,9.71053246829154
"48","331","G4803310","2010","3","7","Texas","Milam County",24757,"","Milam County Texas",24559,25250,-198,-0.799773801349113,0.799773801349113,493,1.99135598012683,1.99135598012683
"48","333","G4803330","2010","3","7","Texas","Mills County",4936,"","Mills County Texas",5065,5378,129,2.61345218800648,2.61345218800648,442,8.95461912479741,8.95461912479741
"48","335","G4803350","2010","3","7","Texas","Mitchell County",9403,"","Mitchell County Texas",9398,9875,-5,-0.0531745187706051,0.0531745187706051,472,5.01967457194512,5.01967457194512
"48","337","G4803370","2010","3","7","Texas","Montague County",19719,"","Montague County Texas",19433,20060,-286,-1.45037780820528,1.45037780820528,341,1.72929661747553,1.72929661747553
"48","339","G4803390","2010","3","7","Texas","Montgomery County",455746,"","Montgomery County Texas",456263,442207,517,0.113440381265003,0.113440381265003,-13539,-2.97073369815643,2.97073369815643
"48","341","G4803410","2010","3","7","Texas","Moore County",21904,"","Moore County Texas",20920,21019,-984,-4.49233016800584,4.49233016800584,-885,-4.04035792549306,4.04035792549306
"48","343","G4803430","2010","3","7","Texas","Morris County",12934,"","Morris County Texas",12611,13518,-323,-2.4972939539199,2.4972939539199,584,4.51523117365084,4.51523117365084
"48","345","G4803450","2010","3","7","Texas","Motley County",1210,"","Motley County Texas",1284,1472,74,6.11570247933884,6.11570247933884,262,21.6528925619835,21.6528925619835
"48","347","G4803470","2010","3","7","Texas","Nacogdoches County",64524,"","Nacogdoches County Texas",65071,64027,547,0.84774657491786,0.84774657491786,-497,-0.770256028764491,0.770256028764491
"48","349","G4803490","2010","3","7","Texas","Navarro County",47735,"","Navarro County Texas",49675,47114,1940,4.06410390698649,4.06410390698649,-621,-1.3009322300199,1.3009322300199
"48","351","G4803510","2010","3","7","Texas","Newton County",14445,"","Newton County Texas",13622,15461,-823,-5.69747317410869,5.69747317410869,1016,7.03357563170647,7.03357563170647
"48","353","G4803530","2010","3","7","Texas","Nolan County",15216,"","Nolan County Texas",15260,15778,44,0.289169295478444,0.289169295478444,562,3.69348054679285,3.69348054679285
"48","355","G4803550","2010","3","7","Texas","Nueces County",340223,"","Nueces County Texas",322947,348406,-17276,-5.07784600100522,5.07784600100522,8183,2.4051871860515,2.4051871860515
"48","357","G4803570","2010","3","7","Texas","Ochiltree County",10223,"","Ochiltree County Texas",9770,9187,-453,-4.43118458378167,4.43118458378167,-1036,-10.1340115426,10.1340115426
"48","359","G4803590","2010","3","7","Texas","Oldham County",2052,"","Oldham County Texas",2116,2280,64,3.11890838206628,3.11890838206628,228,11.1111111111111,11.1111111111111
"48","361","G4803610","2010","3","7","Texas","Orange County",81837,"","Orange County Texas",82358,89902,521,0.636631352566687,0.636631352566687,8065,9.85495558243826,9.85495558243826
"48","363","G4803630","2010","3","7","Texas","Palo Pinto County",28111,"","Palo Pinto County Texas",27708,27947,-403,-1.43360250435772,1.43360250435772,-164,-0.58340151542101,0.58340151542101
"48","365","G4803650","2010","3","7","Texas","Panola County",23796,"","Panola County Texas",23333,24020,-463,-1.94570516053118,1.94570516053118,224,0.941334678097159,0.941334678097159
"48","367","G4803670","2010","3","7","Texas","Parker County",116927,"","Parker County Texas",115952,103352,-975,-0.833853600964704,0.833853600964704,-13575,-11.6098078288163,11.6098078288163
"48","369","G4803690","2010","3","7","Texas","Parmer County",10269,"","Parmer County Texas",9306,10188,-963,-9.37773882559159,9.37773882559159,-81,-0.788781770376862,0.788781770376862
"48","371","G4803710","2010","3","7","Texas","Pecos County",15507,"","Pecos County Texas",16328,17496,821,5.29438318178887,5.29438318178887,1989,12.8264654672084,12.8264654672084
"48","373","G4803730","2010","3","7","Texas","Polk County",45413,"","Polk County Texas",46505,45875,1092,2.40459780239139,2.40459780239139,462,1.01732983947328,1.01732983947328
"48","375","G4803750","2010","3","7","Texas","Potter County",121073,"","Potter County Texas",123017,126475,1944,1.60564287661163,1.60564287661163,5402,4.46177099766257,4.46177099766257
"48","377","G4803770","2010","3","7","Texas","Presidio County",7818,"","Presidio County Texas",7676,8548,-142,-1.8163213097979,1.8163213097979,730,9.33742645177795,9.33742645177795
"48","379","G4803790","2010","3","7","Texas","Rains County",10914,"","Rains County Texas",11225,9810,311,2.84955103536742,2.84955103536742,-1104,-10.1154480483782,10.1154480483782
"48","381","G4803810","2010","3","7","Texas","Randall County",120725,"","Randall County Texas",117907,113290,-2818,-2.33423068958376,2.33423068958376,-7435,-6.15862497411472,6.15862497411472
"48","383","G4803830","2010","3","7","Texas","Reagan County",3367,"","Reagan County Texas",2999,3453,-368,-10.9296109296109,10.9296109296109,86,2.55420255420255,2.55420255420255
"48","385","G4803850","2010","3","7","Texas","Real County",3309,"","Real County Texas",2896,3295,-413,-12.4811121184648,12.4811121184648,-14,-0.423088546388637,0.423088546388637
"48","387","G4803870","2010","3","7","Texas","Red River County",12860,"","Red River County Texas",12861,14877,1,0.00777604976671851,0.00777604976671851,2017,15.6842923794712,15.6842923794712
"48","389","G4803890","2010","3","7","Texas","Reeves County",13783,"","Reeves County Texas",11183,13435,-2600,-18.8638177464993,18.8638177464993,-348,-2.52484945222375,2.52484945222375
"48","391","G4803910","2010","3","7","Texas","Refugio County",7383,"","Refugio County Texas",7214,8009,-169,-2.2890423946905,2.2890423946905,626,8.47893810104294,8.47893810104294
"48","393","G4803930","2010","3","7","Texas","Roberts County",929,"","Roberts County Texas",872,917,-57,-6.13562970936491,6.13562970936491,-12,-1.29171151776103,1.29171151776103
"48","395","G4803950","2010","3","7","Texas","Robertson County",16622,"","Robertson County Texas",15652,16789,-970,-5.83563951389724,5.83563951389724,167,1.00469257610396,1.00469257610396
"48","397","G4803970","2010","3","7","Texas","Rockwall County",78337,"","Rockwall County Texas",82994,75823,4657,5.94482811442869,5.94482811442869,-2514,-3.20921148371778,3.20921148371778
"48","399","G4803990","2010","3","7","Texas","Runnels County",10501,"","Runnels County Texas",10267,11564,-234,-2.22835920388534,2.22835920388534,1063,10.1228454432911,10.1228454432911
"48","401","G4804010","2010","3","7","Texas","Rusk County",53330,"","Rusk County Texas",49385,49662,-3945,-7.39733733358335,7.39733733358335,-3668,-6.87792987061691,6.87792987061691
"48","403","G4804030","2010","3","7","Texas","Sabine County",10834,"","Sabine County Texas",10181,11100,-653,-6.02732139560642,6.02732139560642,266,2.45523352409083,2.45523352409083
"48","405","G4804050","2010","3","7","Texas","San Augustine County",8865,"","San Augustine County Texas",8347,9425,-518,-5.84320360970107,5.84320360970107,560,6.31697687535251,6.31697687535251
"48","407","G4804070","2010","3","7","Texas","San Jacinto County",26384,"","San Jacinto County Texas",25141,23607,-1243,-4.711188599151,4.711188599151,-2777,-10.5253183747726,10.5253183747726
"48","409","G4804090","2010","3","7","Texas","San Patricio County",64804,"","San Patricio County Texas",66699,75530,1895,2.92420220974014,2.92420220974014,10726,16.551447441516,16.551447441516
"48","411","G4804110","2010","3","7","Texas","San Saba County",6131,"","San Saba County Texas",6071,6458,-60,-0.978633175664655,0.978633175664655,327,5.33355080737237,5.33355080737237
"48","413","G4804130","2010","3","7","Texas","Schleicher County",3461,"","Schleicher County Texas",2789,3018,-672,-19.416353655013,19.416353655013,-443,-12.7997688529327,12.7997688529327
"48","415","G4804150","2010","3","7","Texas","Scurry County",16921,"","Scurry County Texas",16475,16543,-446,-2.63577802730335,2.63577802730335,-378,-2.23391052538266,2.23391052538266
"48","417","G4804170","2010","3","7","Texas","Shackelford County",3378,"","Shackelford County Texas",3018,3443,-360,-10.6571936056838,10.6571936056838,65,1.92421551213736,1.92421551213736
"48","419","G4804190","2010","3","7","Texas","Shelby County",25448,"","Shelby County Texas",26839,26621,1391,5.46604841244892,5.46604841244892,1173,4.60939955988683,4.60939955988683
"48","421","G4804210","2010","3","7","Texas","Sherman County",3034,"","Sherman County Texas",2902,3636,-132,-4.3506921555702,4.3506921555702,602,19.8417930125247,19.8417930125247
"48","423","G4804230","2010","3","7","Texas","Smith County",209714,"","Smith County Texas",207417,191364,-2297,-1.09530121975643,1.09530121975643,-18350,-8.75001192099717,8.75001192099717
"48","425","G4804250","2010","3","7","Texas","Somervell County",8490,"","Somervell County Texas",8164,8112,-326,-3.83981154299175,3.83981154299175,-378,-4.45229681978799,4.45229681978799
"48","427","G4804270","2010","3","7","Texas","Starr County",60968,"","Starr County Texas",63235,56306,2267,3.71834404933736,3.71834404933736,-4662,-7.64663429996063,7.64663429996063
"48","429","G4804290","2010","3","7","Texas","Stephens County",9630,"","Stephens County Texas",9608,9852,-22,-0.228452751817238,0.228452751817238,222,2.30529595015576,2.30529595015576
"48","431","G4804310","2010","3","7","Texas","Sterling County",1143,"","Sterling County Texas",1232,1461,89,7.78652668416448,7.78652668416448,318,27.8215223097113,27.8215223097113
"48","433","G4804330","2010","3","7","Texas","Stonewall County",1490,"","Stonewall County Texas",1386,1763,-104,-6.97986577181208,6.97986577181208,273,18.3221476510067,18.3221476510067
"48","435","G4804350","2010","3","7","Texas","Sutton County",4128,"","Sutton County Texas",4114,4177,-14,-0.339147286821705,0.339147286821705,49,1.18701550387597,1.18701550387597
"48","437","G4804370","2010","3","7","Texas","Swisher County",7854,"","Swisher County Texas",7536,8427,-318,-4.0488922841864,4.0488922841864,573,7.29564553093965,7.29564553093965
"48","439","G4804390","2010","3","7","Texas","Tarrant County",1809034,"","Tarrant County Texas",1818092,1780030,9058,0.500709218289982,0.500709218289982,-29004,-1.60328661595083,1.60328661595083
"48","441","G4804410","2010","3","7","Texas","Taylor County",131506,"","Taylor County Texas",128178,132353,-3328,-2.53068301066111,2.53068301066111,847,0.644077076331118,0.644077076331118
"48","443","G4804430","2010","3","7","Texas","Terrell County",984,"","Terrell County Texas",1034,1127,50,5.08130081300813,5.08130081300813,143,14.5325203252033,14.5325203252033
"48","445","G4804450","2010","3","7","Texas","Terry County",12651,"","Terry County Texas",12296,12865,-355,-2.8061022844044,2.8061022844044,214,1.69156588411983,1.69156588411983
"48","447","G4804470","2010","3","7","Texas","Throckmorton County",1641,"","Throckmorton County Texas",1597,1916,-44,-2.68129189518586,2.68129189518586,275,16.7580743449116,16.7580743449116
"48","449","G4804490","2010","3","7","Texas","Titus County",32334,"","Titus County Texas",30763,29906,-1571,-4.8586627079854,4.8586627079854,-2428,-7.50912352322633,7.50912352322633
"48","451","G4804510","2010","3","7","Texas","Tom Green County",110224,"","Tom Green County Texas",109391,110669,-833,-0.755733778487444,0.755733778487444,445,0.403723327043112,0.403723327043112
"48","453","G4804530","2010","3","7","Texas","Travis County",1024266,"","Travis County Texas",1047338,1061017,23072,2.25253986757346,2.25253986757346,36751,3.58803279616818,3.58803279616818
"48","455","G4804550","2010","3","7","Texas","Trinity County",14585,"","Trinity County Texas",14012,14629,-573,-3.92869386355845,3.92869386355845,44,0.30167980802194,0.30167980802194
"48","457","G4804570","2010","3","7","Texas","Tyler County",21766,"","Tyler County Texas",20385,21749,-1381,-6.34475787926123,6.34475787926123,-17,-0.0781034641183497,0.0781034641183497
"48","459","G4804590","2010","3","7","Texas","Upshur County",39309,"","Upshur County Texas",38280,37395,-1029,-2.61772113256506,2.61772113256506,-1914,-4.86911394337175,4.86911394337175
"48","461","G4804610","2010","3","7","Texas","Upton County",3355,"","Upton County Texas",3150,3501,-205,-6.11028315946349,6.11028315946349,146,4.35171385991058,4.35171385991058
"48","463","G4804630","2010","3","7","Texas","Uvalde County",26405,"","Uvalde County Texas",26891,27263,486,1.84056049990532,1.84056049990532,858,3.2493845862526,3.2493845862526
"48","465","G4804650","2010","3","7","Texas","Val Verde County",48879,"","Val Verde County Texas",48384,49230,-495,-1.01270484257043,1.01270484257043,351,0.718099797459031,0.718099797459031
"48","467","G4804670","2010","3","7","Texas","Van Zandt County",52579,"","Van Zandt County Texas",52291,51227,-288,-0.547747199452253,0.547747199452253,-1352,-2.57136879742863,2.57136879742863
"48","469","G4804690","2010","3","7","Texas","Victoria County",86793,"","Victoria County Texas",88117,88536,1324,1.52546864378464,1.52546864378464,1743,2.0082264698766,2.0082264698766
"48","471","G4804710","2010","3","7","Texas","Walker County",67861,"","Walker County Texas",65290,69570,-2571,-3.78862675174253,3.78862675174253,1709,2.51838316558848,2.51838316558848
"48","473","G4804730","2010","3","7","Texas","Waller County",43205,"","Waller County Texas",37245,39288,-5960,-13.7946996875362,13.7946996875362,-3917,-9.06608031477838,9.06608031477838
"48","475","G4804750","2010","3","7","Texas","Ward County",10658,"","Ward County Texas",10327,11123,-331,-3.10564833927566,3.10564833927566,465,4.36291987239632,4.36291987239632
"48","477","G4804770","2010","3","7","Texas","Washington County",33718,"","Washington County Texas",33188,33057,-530,-1.57186072720802,1.57186072720802,-661,-1.96037724657453,1.96037724657453
"48","479","G4804790","2010","3","7","Texas","Webb County",250304,"","Webb County Texas",244659,252640,-5645,-2.25525760675019,2.25525760675019,2336,0.933265149578113,0.933265149578113
"48","481","G4804810","2010","3","7","Texas","Wharton County",41280,"","Wharton County Texas",41263,43681,-17,-0.0411821705426357,0.0411821705426357,2401,5.81637596899225,5.81637596899225
"48","483","G4804830","2010","3","7","Texas","Wheeler County",5410,"","Wheeler County Texas",4879,5372,-531,-9.81515711645102,9.81515711645102,-38,-0.702402957486137,0.702402957486137
"48","485","G4804850","2010","3","7","Texas","Wichita County",131500,"","Wichita County Texas",126945,139537,-4555,-3.4638783269962,3.4638783269962,8037,6.11178707224335,6.11178707224335
"48","487","G4804870","2010","3","7","Texas","Wilbarger County",13535,"","Wilbarger County Texas",13636,14884,101,0.746213520502401,0.746213520502401,1349,9.96675286294791,9.96675286294791
"48","489","G4804890","2010","3","7","Texas","Willacy County",22134,"","Willacy County Texas",20462,21667,-1672,-7.55398933767055,7.55398933767055,-467,-2.10987620854794,2.10987620854794
"48","491","G4804910","2010","3","7","Texas","Williamson County",422679,"","Williamson County Texas",422479,389242,-200,-0.0473172312795289,0.0473172312795289,-33437,-7.91073131146804,7.91073131146804
"48","493","G4804930","2010","3","7","Texas","Wilson County",42918,"","Wilson County Texas",41206,35171,-1712,-3.9890022834242,3.9890022834242,-7747,-18.0507013374342,18.0507013374342
"48","495","G4804950","2010","3","7","Texas","Winkler County",7110,"","Winkler County Texas",6780,7227,-330,-4.64135021097046,4.64135021097046,117,1.64556962025316,1.64556962025316
"48","497","G4804970","2010","3","7","Texas","Wise County",59127,"","Wise County Texas",59686,54096,559,0.945422564987231,0.945422564987231,-5031,-8.50880308488508,8.50880308488508
"48","499","G4804990","2010","3","7","Texas","Wood County",41964,"","Wood County Texas",43158,38570,1194,2.84529596797255,2.84529596797255,-3394,-8.08788485368411,8.08788485368411
"48","501","G4805010","2010","3","7","Texas","Yoakum County",7879,"","Yoakum County Texas",7670,7549,-209,-2.65262089097601,2.65262089097601,-330,-4.18834877522528,4.18834877522528
"48","503","G4805030","2010","3","7","Texas","Young County",18550,"","Young County Texas",17883,18227,-667,-3.59568733153639,3.59568733153639,-323,-1.74123989218329,1.74123989218329
"48","505","G4805050","2010","3","7","Texas","Zapata County",14018,"","Zapata County Texas",14187,12943,169,1.20559280924526,1.20559280924526,-1075,-7.66871165644172,7.66871165644172
"48","507","G4805070","2010","3","7","Texas","Zavala County",11677,"","Zavala County Texas",11721,12126,44,0.376809111929434,0.376809111929434,449,3.84516571037081,3.84516571037081
"49","001","G4900010","2010","4","8","Utah","Beaver County",6629,"","Beaver County Utah",6264,6656,-365,-5.50610951878111,5.50610951878111,27,0.407301252074219,0.407301252074219
"49","003","G4900030","2010","4","8","Utah","Box Elder County",49975,"","Box Elder County Utah",50477,52603,502,1.00450225112556,1.00450225112556,2628,5.25862931465733,5.25862931465733
"49","005","G4900050","2010","4","8","Utah","Cache County",112656,"","Cache County Utah",117431,113982,4775,4.23856696491976,4.23856696491976,1326,1.17703451214316,1.17703451214316
"49","007","G4900070","2010","4","8","Utah","Carbon County",21403,"","Carbon County Utah",20278,21571,-1125,-5.25627248516563,5.25627248516563,168,0.784936691118068,0.784936691118068
"49","009","G4900090","2010","4","8","Utah","Daggett County",1059,"","Daggett County Utah",962,1038,-97,-9.15958451369216,9.15958451369216,-21,-1.98300283286119,1.98300283286119
"49","011","G4900110","2010","4","8","Utah","Davis County",306479,"","Davis County Utah",303144,307622,-3335,-1.0881659102255,1.0881659102255,1143,0.372945617807419,0.372945617807419
"49","013","G4900130","2010","4","8","Utah","Duchesne County",18607,"","Duchesne County Utah",18071,17418,-536,-2.88063631966464,2.88063631966464,-1189,-6.39006825388295,6.39006825388295
"49","015","G4900150","2010","4","8","Utah","Emery County",10976,"","Emery County Utah",10545,11534,-431,-3.92674927113703,3.92674927113703,558,5.08381924198251,5.08381924198251
"49","017","G4900170","2010","4","8","Utah","Garfield County",5172,"","Garfield County Utah",4664,5955,-508,-9.82211910286156,9.82211910286156,783,15.139211136891,15.139211136891
"49","019","G4900190","2010","4","8","Utah","Grand County",9225,"","Grand County Utah",9871,9849,646,7.00271002710027,7.00271002710027,624,6.76422764227642,6.76422764227642
"49","021","G4900210","2010","4","8","Utah","Iron County",46163,"","Iron County Utah",45700,47286,-463,-1.00296774473063,1.00296774473063,1123,2.43268418430345,2.43268418430345
"49","023","G4900230","2010","4","8","Utah","Juab County",10246,"","Juab County Utah",10177,10435,-69,-0.673433535038064,0.673433535038064,189,1.844622291626,1.844622291626
"49","025","G4900250","2010","4","8","Utah","Kane County",7125,"","Kane County Utah",6725,8153,-400,-5.6140350877193,5.6140350877193,1028,14.4280701754386,14.4280701754386
"49","027","G4900270","2010","4","8","Utah","Millard County",12503,"","Millard County Utah",12429,13467,-74,-0.591857954091018,0.591857954091018,964,7.71014956410461,7.71014956410461
"49","029","G4900290","2010","4","8","Utah","Morgan County",9469,"","Morgan County Utah",8988,9986,-481,-5.07973386841272,5.07973386841272,517,5.45992185024818,5.45992185024818
"49","031","G4900310","2010","4","8","Utah","Piute County",1556,"","Piute County Utah",1423,1541,-133,-8.54755784061697,8.54755784061697,-15,-0.96401028277635,0.96401028277635
"49","033","G4900330","2010","4","8","Utah","Rich County",2264,"","Rich County Utah",2165,2688,-99,-4.37279151943463,4.37279151943463,424,18.7279151943463,18.7279151943463
"49","035","G4900350","2010","4","8","Utah","Salt Lake County",1029655,"","Salt Lake County Utah",1048624,1045116,18969,1.84226755563757,1.84226755563757,15461,1.50157091452962,1.50157091452962
"49","037","G4900370","2010","4","8","Utah","San Juan County",14746,"","San Juan County Utah",15256,15507,510,3.45856503458565,3.45856503458565,761,5.16072155160722,5.16072155160722
"49","039","G4900390","2010","4","8","Utah","Sanpete County",27822,"","Sanpete County Utah",26032,25127,-1790,-6.43375745812666,6.43375745812666,-2695,-9.68657896628567,9.68657896628567
"49","041","G4900410","2010","4","8","Utah","Sevier County",20802,"","Sevier County Utah",20035,21365,-767,-3.68714546678204,3.68714546678204,563,2.70647053167965,2.70647053167965
"49","043","G4900430","2010","4","8","Utah","Summit County",36324,"","Summit County Utah",37591,40131,1267,3.48805197665455,3.48805197665455,3807,10.4806739345887,10.4806739345887
"49","045","G4900450","2010","4","8","Utah","Tooele County",58218,"","Tooele County Utah",59316,56180,1098,1.88601463464908,1.88601463464908,-2038,-3.50063554227215,3.50063554227215
"49","047","G4900470","2010","4","8","Utah","Uintah County",32588,"","Uintah County Utah",30995,31887,-1593,-4.88830244261691,4.88830244261691,-701,-2.15109856388855,2.15109856388855
"49","049","G4900490","2010","4","8","Utah","Utah County",516564,"","Utah County Utah",554800,512006,38236,7.40198697547642,7.40198697547642,-4558,-0.882368883623326,0.882368883623326
"49","051","G4900510","2010","4","8","Utah","Wasatch County",23530,"","Wasatch County Utah",22033,22935,-1497,-6.36209094772631,6.36209094772631,-595,-2.52868678283043,2.52868678283043
"49","053","G4900530","2010","4","8","Utah","Washington County",138115,"","Washington County Utah",138153,142183,38,0.0275133041306158,0.0275133041306158,4068,2.94537161061434,2.94537161061434
"49","055","G4900550","2010","4","8","Utah","Wayne County",2778,"","Wayne County Utah",2566,2839,-212,-7.63138948884089,7.63138948884089,61,2.19582433405328,2.19582433405328
"49","057","G4900570","2010","4","8","Utah","Weber County",231236,"","Weber County Utah",233527,234261,2291,0.99076268401114,0.99076268401114,3025,1.30818730647477,1.30818730647477
"50","001","G5000010","2010","1","1","Vermont","Addison County",36821,"","Addison County Vermont",36655,39200,-166,-0.450829689579316,0.450829689579316,2379,6.46098693680237,6.46098693680237
"50","003","G5000030","2010","1","1","Vermont","Bennington County",37125,"","Bennington County Vermont",36245,39781,-880,-2.37037037037037,2.37037037037037,2656,7.15420875420875,7.15420875420875
"50","005","G5000050","2010","1","1","Vermont","Caledonia County",31227,"","Caledonia County Vermont",30048,31640,-1179,-3.77557882601595,3.77557882601595,413,1.32257341403273,1.32257341403273
"50","007","G5000070","2010","1","1","Vermont","Chittenden County",156545,"","Chittenden County Vermont",152574,158925,-3971,-2.5366508032834,2.5366508032834,2380,1.52032961768182,1.52032961768182
"50","009","G5000090","2010","1","1","Vermont","Essex County",6306,"","Essex County Vermont",6353,6661,47,0.745321915635902,0.745321915635902,355,5.62955915001586,5.62955915001586
"50","011","G5000110","2010","1","1","Vermont","Franklin County",47746,"","Franklin County Vermont",48402,50255,656,1.37393708373476,1.37393708373476,2509,5.25489046202823,5.25489046202823
"50","013","G5000130","2010","1","1","Vermont","Grand Isle County",6970,"","Grand Isle County Vermont",7500,7364,530,7.60401721664275,7.60401721664275,394,5.65279770444763,5.65279770444763
"50","015","G5000150","2010","1","1","Vermont","Lamoille County",24475,"","Lamoille County Vermont",26663,25891,2188,8.93973442288049,8.93973442288049,1416,5.78549540347293,5.78549540347293
"50","017","G5000170","2010","1","1","Vermont","Orange County",28936,"","Orange County Vermont",28954,29394,18,0.0622062482720487,0.0622062482720487,458,1.58280342825546,1.58280342825546
"50","019","G5000190","2010","1","1","Vermont","Orleans County",27231,"","Orleans County Vermont",27248,28653,17,0.0624288494730271,0.0624288494730271,1422,5.22198964415556,5.22198964415556
"50","021","G5000210","2010","1","1","Vermont","Rutland County",61642,"","Rutland County Vermont",62733,64836,1091,1.76989714804841,1.76989714804841,3194,5.18153207228838,5.18153207228838
"50","023","G5000230","2010","1","1","Vermont","Washington County",59534,"","Washington County Vermont",58820,61902,-714,-1.19931467732724,1.19931467732724,2368,3.97755904189203,3.97755904189203
"50","025","G5000250","2010","1","1","Vermont","Windham County",44513,"","Windham County Vermont",43452,46519,-1061,-2.38357333812594,2.38357333812594,2006,4.50654864870937,4.50654864870937
"50","027","G5000270","2010","1","1","Vermont","Windsor County",56670,"","Windsor County Vermont",56544,60827,-126,-0.222339862361038,0.222339862361038,4157,7.33545085583201,7.33545085583201
"51","001","G5100010","2010","3","5","Virginia","Accomack County",33164,"","Accomack County Virginia",38453,42349,5289,15.9480159208781,15.9480159208781,9185,27.6956941261609,27.6956941261609
"51","003","G5100030","2010","3","5","Virginia","Albemarle County",98970,"","Albemarle County Virginia",94277,102825,-4693,-4.74184096190765,4.74184096190765,3855,3.8951197332525,3.8951197332525
"51","005","G5100050","2010","3","5","Virginia","Alleghany County",16250,"","Alleghany County Virginia",16172,17674,-78,-0.48,0.48,1424,8.76307692307692,8.76307692307692
"51","007","G5100070","2010","3","5","Virginia","Amelia County",12690,"","Amelia County Virginia",13003,13628,313,2.46650906225374,2.46650906225374,938,7.39164696611505,7.39164696611505
"51","009","G5100090","2010","3","5","Virginia","Amherst County",32353,"","Amherst County Virginia",32353,34486,0,0,0,2133,6.59289710382345,6.59289710382345
"51","011","G5100110","2010","3","5","Virginia","Appomattox County",14973,"","Appomattox County Virginia",14646,15790,-327,-2.18393107593669,2.18393107593669,817,5.45648834568891,5.45648834568891
"51","013","G5100130","2010","3","5","Virginia","Arlington County",207627,"","Arlington County Virginia",222674,218225,15047,7.24713067182977,7.24713067182977,10598,5.10434577391187,5.10434577391187
"51","015","G5100150","2010","3","5","Virginia","Augusta County",73750,"","Augusta County Virginia",71640,75650,-2110,-2.86101694915254,2.86101694915254,1900,2.57627118644068,2.57627118644068
"51","017","G5100170","2010","3","5","Virginia","Bath County",4731,"","Bath County Virginia",4455,5528,-276,-5.83386176284084,5.83386176284084,797,16.8463326992179,16.8463326992179
"51","019","G5100190","2010","3","5","Virginia","Bedford County",68676,"","Bedford County Virginia",67265,71705,-1411,-2.05457510629623,2.05457510629623,3029,4.41056555419652,4.41056555419652
"51","021","G5100210","2010","3","5","Virginia","Bland County",6824,"","Bland County Virginia",6683,7857,-141,-2.0662368112544,2.0662368112544,1033,15.1377491207503,15.1377491207503
"51","023","G5100230","2010","3","5","Virginia","Botetourt County",33148,"","Botetourt County Virginia",32790,34978,-358,-1.08000482683721,1.08000482683721,1830,5.52069506455895,5.52069506455895
"51","025","G5100250","2010","3","5","Virginia","Brunswick County",17434,"","Brunswick County Virginia",17361,19480,-73,-0.418722037398187,0.418722037398187,2046,11.7356888837903,11.7356888837903
"51","027","G5100270","2010","3","5","Virginia","Buchanan County",24098,"","Buchanan County Virginia",22603,27785,-1495,-6.20383434309901,6.20383434309901,3687,15.3000248983318,15.3000248983318
"51","029","G5100290","2010","3","5","Virginia","Buckingham County",17146,"","Buckingham County Virginia",16073,17460,-1073,-6.25801936311676,6.25801936311676,314,1.83133092266418,1.83133092266418
"51","031","G5100310","2010","3","5","Virginia","Campbell County",54842,"","Campbell County Virginia",53065,57175,-1777,-3.24021735166478,3.24021735166478,2333,4.25403887531454,4.25403887531454
"51","033","G5100330","2010","3","5","Virginia","Caroline County",28545,"","Caroline County Virginia",28173,29410,-372,-1.30320546505518,1.30320546505518,865,3.03030303030303,3.03030303030303
"51","035","G5100350","2010","3","5","Virginia","Carroll County",30042,"","Carroll County Virginia",29000,32177,-1042,-3.4684774648825,3.4684774648825,2135,7.10671726249917,7.10671726249917
"51","036","G5100360","2010","3","5","Virginia","Charles City County",7256,"","Charles City County Virginia",7245,7762,-11,-0.151598676957001,0.151598676957001,506,6.97353914002205,6.97353914002205
"51","037","G5100370","2010","3","5","Virginia","Charlotte County",12586,"","Charlotte County Virginia",12016,13859,-570,-4.52884156999841,4.52884156999841,1273,10.1144128396631,10.1144128396631
"51","041","G5100410","2010","3","5","Virginia","Chesterfield County",316236,"","Chesterfield County Virginia",308026,319183,-8210,-2.59616235975664,2.59616235975664,2947,0.931898961535056,0.931898961535056
"51","043","G5100430","2010","3","5","Virginia","Clarke County",14034,"","Clarke County Virginia",14566,14855,532,3.79079378651846,3.79079378651846,821,5.85007838107453,5.85007838107453
"51","045","G5100450","2010","3","5","Virginia","Craig County",5190,"","Craig County Virginia",5022,5677,-168,-3.23699421965318,3.23699421965318,487,9.38342967244701,9.38342967244701
"51","047","G5100470","2010","3","5","Virginia","Culpeper County",46689,"","Culpeper County Virginia",47026,51852,337,0.721797425517788,0.721797425517788,5163,11.0582792520722,11.0582792520722
"51","049","G5100490","2010","3","5","Virginia","Cumberland County",10052,"","Cumberland County Virginia",9735,10106,-317,-3.15360127337843,3.15360127337843,54,0.537206526064465,0.537206526064465
"51","051","G5100510","2010","3","5","Virginia","Dickenson County",15903,"","Dickenson County Virginia",15969,16915,66,0.415016034710432,0.415016034710432,1012,6.36357919889329,6.36357919889329
"51","053","G5100530","2010","3","5","Virginia","Dinwiddie County",28001,"","Dinwiddie County Virginia",26370,28688,-1631,-5.8247919717153,5.8247919717153,687,2.45348380414985,2.45348380414985
"51","057","G5100570","2010","3","5","Virginia","Essex County",11151,"","Essex County Virginia",11222,11903,71,0.63671419603623,0.63671419603623,752,6.74378979463725,6.74378979463725
"51","059","G5100590","2010","3","5","Virginia","Fairfax County",1081726,"","Fairfax County Virginia",1050686,1063213,-31040,-2.86948820681023,2.86948820681023,-18513,-1.71143154551153,1.71143154551153
"51","061","G5100610","2010","3","5","Virginia","Fauquier County",65203,"","Fauquier County Virginia",68491,68559,3288,5.0427127586154,5.0427127586154,3356,5.1470024385381,5.1470024385381
"51","063","G5100630","2010","3","5","Virginia","Floyd County",15279,"","Floyd County Virginia",15086,15626,-193,-1.26317167353884,1.26317167353884,347,2.27109103998953,2.27109103998953
"51","065","G5100650","2010","3","5","Virginia","Fluvanna County",25691,"","Fluvanna County Virginia",25731,26453,40,0.155696547429061,0.155696547429061,762,2.96601922852361,2.96601922852361
"51","067","G5100670","2010","3","5","Virginia","Franklin County",56159,"","Franklin County Virginia",51919,55743,-4240,-7.54999198703681,7.54999198703681,-416,-0.740753930803611,0.740753930803611
"51","069","G5100690","2010","3","5","Virginia","Frederick County",78305,"","Frederick County Virginia",75529,76737,-2776,-3.54511206180959,3.54511206180959,-1568,-2.00242640955239,2.00242640955239
"51","071","G5100710","2010","3","5","Virginia","Giles County",17286,"","Giles County Virginia",17400,17794,114,0.659493231516834,0.659493231516834,508,2.93879440009256,2.93879440009256
"51","073","G5100730","2010","3","5","Virginia","Gloucester County",36858,"","Gloucester County Virginia",39286,40206,2428,6.58744370285962,6.58744370285962,3348,9.08350968582126,9.08350968582126
"51","075","G5100750","2010","3","5","Virginia","Goochland County",21717,"","Goochland County Virginia",21370,22649,-347,-1.59782658746604,1.59782658746604,932,4.29156881705576,4.29156881705576
"51","077","G5100770","2010","3","5","Virginia","Grayson County",15533,"","Grayson County Virginia",15537,18137,4,0.0257516255713642,0.0257516255713642,2604,16.7643082469581,16.7643082469581
"51","079","G5100790","2010","3","5","Virginia","Greene County",18403,"","Greene County Virginia",18596,19487,193,1.04874205292615,1.04874205292615,1084,5.89034396565777,5.89034396565777
"51","081","G5100810","2010","3","5","Virginia","Greensville County",12243,"","Greensville County Virginia",12112,12902,-131,-1.06999918320673,1.06999918320673,659,5.38266764681859,5.38266764681859
"51","083","G5100830","2010","3","5","Virginia","Halifax County",36241,"","Halifax County Virginia",35110,38952,-1131,-3.12077481305703,3.12077481305703,2711,7.4804779117574,7.4804779117574
"51","085","G5100850","2010","3","5","Virginia","Hanover County",99863,"","Hanover County Virginia",100320,102848,457,0.45762694892002,0.45762694892002,2985,2.98909506023252,2.98909506023252
"51","087","G5100870","2010","3","5","Virginia","Henrico County",306935,"","Henrico County Virginia",298398,298407,-8537,-2.78137064850864,2.78137064850864,-8528,-2.77843843158975,2.77843843158975
"51","089","G5100890","2010","3","5","Virginia","Henry County",54151,"","Henry County Virginia",54650,59761,499,0.921497294602131,0.921497294602131,5610,10.3599194844047,10.3599194844047
"51","091","G5100910","2010","3","5","Virginia","Highland County",2321,"","Highland County Virginia",2273,2744,-48,-2.0680741059888,2.0680741059888,423,18.2249030590263,18.2249030590263
"51","093","G5100930","2010","3","5","Virginia","Isle of Wight County",35270,"","Isle of Wight County Virginia",35987,36917,717,2.03288914091296,2.03288914091296,1647,4.66969095548625,4.66969095548625
"51","095","G5100950","2010","3","5","Virginia","James City County",67009,"","James City County Virginia",64469,67545,-2540,-3.79053559969556,3.79053559969556,536,0.79989255174678,0.79989255174678
"51","097","G5100970","2010","3","5","Virginia","King and Queen County",6945,"","King and Queen County Virginia",6829,7541,-116,-1.6702663786897,1.6702663786897,596,8.58171346292297,8.58171346292297
"51","099","G5100990","2010","3","5","Virginia","King George County",23584,"","King George County Virginia",23636,23386,52,0.220488466757123,0.220488466757123,-198,-0.83955223880597,0.83955223880597
"51","101","G5101010","2010","3","5","Virginia","King William County",15935,"","King William County Virginia",16456,16732,521,3.26953247568246,3.26953247568246,797,5.00156887354879,5.00156887354879
"51","103","G5101030","2010","3","5","Virginia","Lancaster County",11391,"","Lancaster County Virginia",11242,13164,-149,-1.30805021508208,1.30805021508208,1773,15.5649196734264,15.5649196734264
"51","105","G5101050","2010","3","5","Virginia","Lee County",25587,"","Lee County Virginia",25178,24828,-409,-1.59846797201704,1.59846797201704,-759,-2.96635009965998,2.96635009965998
"51","107","G5101070","2010","3","5","Virginia","Loudoun County",312311,"","Loudoun County Virginia",308887,293338,-3424,-1.0963430682877,1.0963430682877,-18973,-6.07503418067247,6.07503418067247
"51","109","G5101090","2010","3","5","Virginia","Louisa County",33153,"","Louisa County Virginia",33431,34905,278,0.83853648236962,0.83853648236962,1752,5.28458962989775,5.28458962989775
"51","111","G5101110","2010","3","5","Virginia","Lunenburg County",12914,"","Lunenburg County Virginia",12867,13837,-47,-0.363946105002323,0.363946105002323,923,7.14728201951371,7.14728201951371
"51","113","G5101130","2010","3","5","Virginia","Madison County",13308,"","Madison County Virginia",13680,14572,372,2.79531109107304,2.79531109107304,1264,9.4980462879471,9.4980462879471
"51","115","G5101150","2010","3","5","Virginia","Mathews County",8978,"","Mathews County Virginia",8924,10085,-54,-0.601470260637113,0.601470260637113,1107,12.3301403430608,12.3301403430608
"51","117","G5101170","2010","3","5","Virginia","Mecklenburg County",32727,"","Mecklenburg County Virginia",31728,35395,-999,-3.05252543771198,3.05252543771198,2668,8.15229015797354,8.15229015797354
"51","119","G5101190","2010","3","5","Virginia","Middlesex County",10959,"","Middlesex County Virginia",10714,11395,-245,-2.23560543845241,2.23560543845241,436,3.9784651884296,3.9784651884296
"51","121","G5101210","2010","3","5","Virginia","Montgomery County",94392,"","Montgomery County Virginia",91420,96635,-2972,-3.14857191287397,3.14857191287397,2243,2.37626070005933,2.37626070005933
"51","125","G5101250","2010","3","5","Virginia","Nelson County",15020,"","Nelson County Virginia",15336,16528,316,2.10386151797603,2.10386151797603,1508,10.0399467376831,10.0399467376831
"51","127","G5101270","2010","3","5","Virginia","New Kent County",18429,"","New Kent County Virginia",18458,19157,29,0.157360681534538,0.157360681534538,728,3.95029572955668,3.95029572955668
"51","131","G5101310","2010","3","5","Virginia","Northampton County",12389,"","Northampton County Virginia",13434,15170,1045,8.43490192913068,8.43490192913068,2781,22.447332310921,22.447332310921
"51","133","G5101330","2010","3","5","Virginia","Northumberland County",12330,"","Northumberland County Virginia",12934,14497,604,4.89862124898621,4.89862124898621,2167,17.5750202757502,17.5750202757502
"51","135","G5101350","2010","3","5","Virginia","Nottoway County",15853,"","Nottoway County Virginia",15849,17152,-4,-0.0252318173216426,0.0252318173216426,1299,8.19403267520343,8.19403267520343
"51","137","G5101370","2010","3","5","Virginia","Orange County",33481,"","Orange County Virginia",33637,33369,156,0.465935903945521,0.465935903945521,-112,-0.334518084883964,0.334518084883964
"51","139","G5101390","2010","3","5","Virginia","Page County",24042,"","Page County Virginia",23988,25414,-54,-0.224606937858747,0.224606937858747,1372,5.70667997670743,5.70667997670743
"51","141","G5101410","2010","3","5","Virginia","Patrick County",18490,"","Patrick County Virginia",18589,20976,99,0.535424553812872,0.535424553812872,2486,13.4451054624121,13.4451054624121
"51","143","G5101430","2010","3","5","Virginia","Pittsylvania County",63506,"","Pittsylvania County Virginia",61311,66388,-2195,-3.45636632759109,3.45636632759109,2882,4.53815387522439,4.53815387522439
"51","145","G5101450","2010","3","5","Virginia","Powhatan County",28046,"","Powhatan County Virginia",28025,29870,-21,-0.0748769878057477,0.0748769878057477,1824,6.50360122655637,6.50360122655637
"51","147","G5101470","2010","3","5","Virginia","Prince Edward County",23368,"","Prince Edward County Virginia",22395,22624,-973,-4.16381376241013,4.16381376241013,-744,-3.183841150291,3.183841150291
"51","149","G5101490","2010","3","5","Virginia","Prince George County",35725,"","Prince George County Virginia",36323,38732,598,1.6738978306508,1.6738978306508,3007,8.41707487753674,8.41707487753674
"51","153","G5101530","2010","3","5","Virginia","Prince William County",402002,"","Prince William County Virginia",388441,398956,-13561,-3.37336630166019,3.37336630166019,-3046,-0.757707673096154,0.757707673096154
"51","155","G5101550","2010","3","5","Virginia","Pulaski County",34872,"","Pulaski County Virginia",34808,37489,-64,-0.183528332186281,0.183528332186281,2617,7.50458820830466,7.50458820830466
"51","157","G5101570","2010","3","5","Virginia","Rappahannock County",7373,"","Rappahannock County Virginia",6968,7941,-405,-5.49301505493015,5.49301505493015,568,7.70378407703784,7.70378407703784
"51","159","G5101590","2010","3","5","Virginia","Richmond County",9254,"","Richmond County Virginia",8938,9695,-316,-3.41473957207694,3.41473957207694,441,4.76550680786687,4.76550680786687
"51","161","G5101610","2010","3","5","Virginia","Roanoke County",92376,"","Roanoke County Virginia",90977,94949,-1399,-1.5144626309864,1.5144626309864,2573,2.78535550359401,2.78535550359401
"51","163","G5101630","2010","3","5","Virginia","Rockbridge County",22307,"","Rockbridge County Virginia",21208,24343,-1099,-4.92670462186758,4.92670462186758,2036,9.12717980902856,9.12717980902856
"51","165","G5101650","2010","3","5","Virginia","Rockingham County",76314,"","Rockingham County Virginia",75469,80338,-845,-1.10726734282045,1.10726734282045,4024,5.27295122782189,5.27295122782189
"51","167","G5101670","2010","3","5","Virginia","Russell County",28897,"","Russell County Virginia",29138,30832,241,0.833996608644496,0.833996608644496,1935,6.69619683704191,6.69619683704191
"51","169","G5101690","2010","3","5","Virginia","Scott County",23177,"","Scott County Virginia",22576,24469,-601,-2.59308797514778,2.59308797514778,1292,5.57449195322949,5.57449195322949
"51","171","G5101710","2010","3","5","Virginia","Shenandoah County",41993,"","Shenandoah County Virginia",41142,41791,-851,-2.02652823089563,2.02652823089563,-202,-0.481032553044555,0.481032553044555
"51","173","G5101730","2010","3","5","Virginia","Smyth County",32208,"","Smyth County Virginia",31601,34146,-607,-1.88462493790363,1.88462493790363,1938,6.01713859910581,6.01713859910581
"51","175","G5101750","2010","3","5","Virginia","Southampton County",18570,"","Southampton County Virginia",18420,19327,-150,-0.807754442649435,0.807754442649435,757,4.07646742057081,4.07646742057081
"51","177","G5101770","2010","3","5","Virginia","Spotsylvania County",122397,"","Spotsylvania County Virginia",122093,123052,-304,-0.248372100623381,0.248372100623381,655,0.53514383522472,0.53514383522472
"51","179","G5101790","2010","3","5","Virginia","Stafford County",128961,"","Stafford County Virginia",125549,129182,-3412,-2.64576112157939,2.64576112157939,221,0.171369638883073,0.171369638883073
"51","181","G5101810","2010","3","5","Virginia","Surry County",7058,"","Surry County Virginia",7095,8046,37,0.524227826579768,0.524227826579768,988,13.9982998016435,13.9982998016435
"51","183","G5101830","2010","3","5","Virginia","Sussex County",12087,"","Sussex County Virginia",12078,13388,-9,-0.0744601638123604,0.0744601638123604,1301,10.7636303466534,10.7636303466534
"51","185","G5101850","2010","3","5","Virginia","Tazewell County",45078,"","Tazewell County Virginia",44938,46309,-140,-0.31057278495053,0.31057278495053,1231,2.73082213052931,2.73082213052931
"51","187","G5101870","2010","3","5","Virginia","Warren County",37575,"","Warren County Virginia",37109,37452,-466,-1.24018629407851,1.24018629407851,-123,-0.327345309381238,0.327345309381238
"51","191","G5101910","2010","3","5","Virginia","Washington County",54876,"","Washington County Virginia",53026,56668,-1850,-3.37123697062468,3.37123697062468,1792,3.26554413586996,3.26554413586996
"51","193","G5101930","2010","3","5","Virginia","Westmoreland County",17454,"","Westmoreland County Virginia",17740,19640,286,1.63859287269394,1.63859287269394,2186,12.5243497192621,12.5243497192621
"51","195","G5101950","2010","3","5","Virginia","Wise County",41452,"","Wise County Virginia",41788,43745,336,0.810576088005404,0.810576088005404,2293,5.53169931487021,5.53169931487021
"51","197","G5101970","2010","3","5","Virginia","Wythe County",29235,"","Wythe County Virginia",28811,29851,-424,-1.45031640157346,1.45031640157346,616,2.10706345134257,2.10706345134257
"51","199","G5101990","2010","3","5","Virginia","York County",65464,"","York County Virginia",60421,69201,-5043,-7.70347060980081,7.70347060980081,3737,5.70848099718929,5.70848099718929
"51","510","G5105100","2010","3","5","Virginia","Alexandria City",139966,"","Alexandria City Virginia",152712,141462,12746,9.10649729219953,9.10649729219953,1496,1.06883100181473,1.06883100181473
"51","515","G5105150","2010","3","5","Virginia","Bedford City",6222,"","Bedford City Virginia",6506,6685,284,4.5644487303118,4.5644487303118,463,7.44133719061395,7.44133719061395
"51","520","G5105200","2010","3","5","Virginia","Bristol City",17835,"","Bristol City Virginia",17629,18336,-206,-1.15503223997757,1.15503223997757,501,2.80908326324643,2.80908326324643
"51","530","G5105300","2010","3","5","Virginia","Buena Vista City",6650,"","Buena Vista City Virginia",6172,6802,-478,-7.18796992481203,7.18796992481203,152,2.28571428571429,2.28571428571429
"51","540","G5105400","2010","3","5","Virginia","Charlottesville City",43475,"","Charlottesville City Virginia",42404,44928,-1071,-2.4634847613571,2.4634847613571,1453,3.3421506612996,3.3421506612996
"51","550","G5105500","2010","3","5","Virginia","Chesapeake City",222209,"","Chesapeake City Virginia",223306,229663,1097,0.493679373922748,0.493679373922748,7454,3.35449959272577,3.35449959272577
"51","570","G5105700","2010","3","5","Virginia","Colonial Heights City",17411,"","Colonial Heights City Virginia",17761,17710,350,2.01022342197461,2.01022342197461,299,1.71730515191546,1.71730515191546
"51","580","G5105800","2010","3","5","Virginia","Covington City",5961,"","Covington City Virginia",6176,6335,215,3.60677738634457,3.60677738634457,374,6.27411508136219,6.27411508136219
"51","590","G5105900","2010","3","5","Virginia","Danville City",43055,"","Danville City Virginia",44101,48840,1046,2.42945070258971,2.42945070258971,5785,13.436302403902,13.436302403902
"51","595","G5105950","2010","3","5","Virginia","Emporia City",5927,"","Emporia City Virginia",5649,6298,-278,-4.69039986502446,4.69039986502446,371,6.25949046735279,6.25949046735279
"51","600","G5106000","2010","3","5","Virginia","Fairfax City",22565,"","Fairfax City Virginia",24949,22709,2384,10.5650343452249,10.5650343452249,144,0.638156436959894,0.638156436959894
"51","610","G5106100","2010","3","5","Virginia","Falls Church City",12332,"","Falls Church City Virginia",12592,10425,260,2.10833603632825,2.10833603632825,-1907,-15.4638339279922,15.4638339279922
"51","620","G5106200","2010","3","5","Virginia","Franklin City",8582,"","Franklin City Virginia",8911,8925,329,3.83360522022839,3.83360522022839,343,3.99673735725938,3.99673735725938
"51","630","G5106300","2010","3","5","Virginia","Fredericksburg City",24286,"","Fredericksburg City Virginia",23735,22145,-551,-2.26879683768426,2.26879683768426,-2141,-8.81577863789838,8.81577863789838
"51","640","G5106400","2010","3","5","Virginia","Galax City",7042,"","Galax City Virginia",7061,7079,19,0.269809713149673,0.269809713149673,37,0.525418915080943,0.525418915080943
"51","650","G5106500","2010","3","5","Virginia","Hampton City",137436,"","Hampton City Virginia",142809,155116,5373,3.90945603771937,3.90945603771937,17680,12.8641695043511,12.8641695043511
"51","660","G5106600","2010","3","5","Virginia","Harrisonburg City",48914,"","Harrisonburg City Virginia",45459,49909,-3455,-7.06341742650366,7.06341742650366,995,2.03418244265445,2.03418244265445
"51","670","G5106700","2010","3","5","Virginia","Hopewell City",22591,"","Hopewell City Virginia",23353,24055,762,3.37302465583639,3.37302465583639,1464,6.48045681908725,6.48045681908725
"51","678","G5106780","2010","3","5","Virginia","Lexington City",7042,"","Lexington City Virginia",6927,7032,-115,-1.63305879011644,1.63305879011644,-10,-0.142005112184039,0.142005112184039
"51","680","G5106800","2010","3","5","Virginia","Lynchburg City",75568,"","Lynchburg City Virginia",74426,71875,-1142,-1.51122168113487,1.51122168113487,-3693,-4.88698920177853,4.88698920177853
"51","683","G5106830","2010","3","5","Virginia","Manassas City",37821,"","Manassas City Virginia",37608,37438,-213,-0.563179186166415,0.563179186166415,-383,-1.0126649216044,1.0126649216044
"51","685","G5106850","2010","3","5","Virginia","Manassas Park City",14273,"","Manassas Park City Virginia",12522,13156,-1751,-12.2679184474182,12.2679184474182,-1117,-7.82596510894696,7.82596510894696
"51","690","G5106900","2010","3","5","Virginia","Martinsville City",13821,"","Martinsville City Virginia",14471,15499,650,4.70298820635265,4.70298820635265,1678,12.1409449388612,12.1409449388612
"51","700","G5107000","2010","3","5","Virginia","Newport News City",180719,"","Newport News City Virginia",192566,196014,11847,6.55548116136101,6.55548116136101,15295,8.46341557888213,8.46341557888213
"51","710","G5107100","2010","3","5","Virginia","Norfolk City",242803,"","Norfolk City Virginia",233459,239570,-9344,-3.84838737577378,3.84838737577378,-3233,-1.33153214746111,1.33153214746111
"51","720","G5107200","2010","3","5","Virginia","Norton City",3958,"","Norton City Virginia",3777,4048,-181,-4.57301667508843,4.57301667508843,90,2.27387569479535,2.27387569479535
"51","730","G5107300","2010","3","5","Virginia","Petersburg City",32420,"","Petersburg City Virginia",33324,34227,904,2.78840222085133,2.78840222085133,1807,5.57371992597162,5.57371992597162
"51","735","G5107350","2010","3","5","Virginia","Poquoson City",12150,"","Poquoson City Virginia",11753,12795,-397,-3.26748971193416,3.26748971193416,645,5.30864197530864,5.30864197530864
"51","740","G5107400","2010","3","5","Virginia","Portsmouth City",95535,"","Portsmouth City Virginia",99203,104656,3668,3.83943057518187,3.83943057518187,9121,9.5472863348511,9.5472863348511
"51","750","G5107500","2010","3","5","Virginia","Radford City",16408,"","Radford City Virginia",16272,16723,-136,-0.828863968795709,0.828863968795709,315,1.919795221843,1.919795221843
"51","760","G5107600","2010","3","5","Virginia","Richmond City",204214,"","Richmond City Virginia",203904,202313,-310,-0.15180154152017,0.15180154152017,-1901,-0.930886227193043,0.930886227193043
"51","770","G5107700","2010","3","5","Virginia","Roanoke City",97032,"","Roanoke City Virginia",94576,97282,-2456,-2.5311237529887,2.5311237529887,250,0.257646961827026,0.257646961827026
"51","775","G5107750","2010","3","5","Virginia","Salem City",24802,"","Salem City Virginia",25605,25594,803,3.23764212563503,3.23764212563503,792,3.19329086364003,3.19329086364003
"51","790","G5107900","2010","3","5","Virginia","Staunton City",23746,"","Staunton City Virginia",24003,26349,257,1.08228754316516,1.08228754316516,2603,10.9618462056767,10.9618462056767
"51","800","G5108000","2010","3","5","Virginia","Suffolk City",84585,"","Suffolk City Virginia",84205,85906,-380,-0.449252231483123,0.449252231483123,1321,1.56174262576107,1.56174262576107
"51","810","G5108100","2010","3","5","Virginia","Virginia Beach City",437994,"","Virginia Beach City Virginia",430454,462966,-7540,-1.72148476919775,1.72148476919775,24972,5.70144796504062,5.70144796504062
"51","820","G5108200","2010","3","5","Virginia","Waynesboro City",21006,"","Waynesboro City Virginia",22413,21273,1407,6.69808626106827,6.69808626106827,267,1.27106540988289,1.27106540988289
"51","830","G5108300","2010","3","5","Virginia","Williamsburg City",14068,"","Williamsburg City Virginia",13036,14983,-1032,-7.33579755473415,7.33579755473415,915,6.50412283195906,6.50412283195906
"51","840","G5108400","2010","3","5","Virginia","Winchester City",26203,"","Winchester City Virginia",26493,25988,290,1.10674350265237,1.10674350265237,-215,-0.820516734725032,0.820516734725032
"53","001","G5300010","2010","4","9","Washington","Adams County",18728,"","Adams County Washington",18131,17321,-597,-3.1877402819308,3.1877402819308,-1407,-7.51281503630927,7.51281503630927
"53","003","G5300030","2010","4","9","Washington","Asotin County",21623,"","Asotin County Washington",21557,21667,-66,-0.305230541552976,0.305230541552976,44,0.203487027701984,0.203487027701984
"53","005","G5300050","2010","4","9","Washington","Benton County",175177,"","Benton County Washington",172107,165573,-3070,-1.75251317239135,1.75251317239135,-9604,-5.48245488848422,5.48245488848422
"53","007","G5300070","2010","4","9","Washington","Chelan County",72453,"","Chelan County Washington",73376,74287,923,1.27392930589486,1.27392930589486,1834,2.53129615060798,2.53129615060798
"53","009","G5300090","2010","4","9","Washington","Clallam County",71404,"","Clallam County Washington",71633,71885,229,0.320710324351577,0.320710324351577,481,0.673631729314884,0.673631729314884
"53","011","G5300110","2010","4","9","Washington","Clark County",425363,"","Clark County Washington",436117,421966,10754,2.5281935664362,2.5281935664362,-3397,-0.798612009036987,0.798612009036987
"53","013","G5300130","2010","4","9","Washington","Columbia County",4078,"","Columbia County Washington",4167,4191,89,2.1824423737126,2.1824423737126,113,2.7709661598823,2.7709661598823
"53","015","G5300150","2010","4","9","Washington","Cowlitz County",102410,"","Cowlitz County Washington",102299,102426,-111,-0.108387852748755,0.108387852748755,16,0.0156234742700908,0.0156234742700908
"53","017","G5300170","2010","4","9","Washington","Douglas County",38431,"","Douglas County Washington",38214,38354,-217,-0.564648330774635,0.564648330774635,-77,-0.20035908511358,0.20035908511358
"53","019","G5300190","2010","4","9","Washington","Ferry County",7551,"","Ferry County Washington",7476,7725,-75,-0.993245927691696,0.993245927691696,174,2.30433055224474,2.30433055224474
"53","021","G5300210","2010","4","9","Washington","Franklin County",78163,"","Franklin County Washington",81580,72358,3417,4.37163363739877,4.37163363739877,-5805,-7.42678761050625,7.42678761050625
"53","023","G5300230","2010","4","9","Washington","Garfield County",2266,"","Garfield County Washington",2093,2440,-173,-7.63459841129744,7.63459841129744,174,7.67872903795234,7.67872903795234
"53","025","G5300250","2010","4","9","Washington","Grant County",89120,"","Grant County Washington",90288,85394,1168,1.31059245960503,1.31059245960503,-3726,-4.18087971274686,4.18087971274686
"53","027","G5300270","2010","4","9","Washington","Grays Harbor County",72797,"","Grays Harbor County Washington",71695,72599,-1102,-1.51379864554858,1.51379864554858,-198,-0.271989230325425,0.271989230325425
"53","029","G5300290","2010","4","9","Washington","Island County",78506,"","Island County Washington",80139,83157,1633,2.0800957888569,2.0800957888569,4651,5.92438794487046,5.92438794487046
"53","031","G5300310","2010","4","9","Washington","Jefferson County",29872,"","Jefferson County Washington",29796,30663,-76,-0.254418853776111,0.254418853776111,791,2.64796464916979,2.64796464916979
"53","033","G5300330","2010","4","9","Washington","King County",1931249,"","King County Washington",1941997,1965578,10748,0.556531032507978,0.556531032507978,34329,1.77755431847473,1.77755431847473
"53","035","G5300350","2010","4","9","Washington","Kitsap County",251133,"","Kitsap County Washington",241166,258021,-9967,-3.9688133379524,3.9688133379524,6888,2.74276976741408,2.74276976741408
"53","037","G5300370","2010","4","9","Washington","Kittitas County",40915,"","Kittitas County Washington",39919,40750,-996,-2.43431504338262,2.43431504338262,-165,-0.403275082488085,0.403275082488085
"53","039","G5300390","2010","4","9","Washington","Klickitat County",20318,"","Klickitat County Washington",20643,21236,325,1.59956688650458,1.59956688650458,918,4.51816123634216,4.51816123634216
"53","041","G5300410","2010","4","9","Washington","Lewis County",75455,"","Lewis County Washington",74870,75547,-585,-0.775296534358227,0.775296534358227,92,0.121926976343516,0.121926976343516
"53","043","G5300430","2010","4","9","Washington","Lincoln County",10570,"","Lincoln County Washington",10194,10738,-376,-3.55723746452223,3.55723746452223,168,1.58940397350993,1.58940397350993
"53","045","G5300450","2010","4","9","Washington","Mason County",60699,"","Mason County Washington",58277,57007,-2422,-3.99018105734856,3.99018105734856,-3692,-6.08247252837773,6.08247252837773
"53","047","G5300470","2010","4","9","Washington","Okanogan County",41120,"","Okanogan County Washington",41051,43050,-69,-0.167801556420233,0.167801556420233,1930,4.69357976653697,4.69357976653697
"53","049","G5300490","2010","4","9","Washington","Pacific County",20920,"","Pacific County Washington",21017,22275,97,0.463671128107075,0.463671128107075,1355,6.47705544933078,6.47705544933078
"53","051","G5300510","2010","4","9","Washington","Pend Oreille County",13001,"","Pend Oreille County Washington",12889,13081,-112,-0.861472194446581,0.861472194446581,80,0.615337281747558,0.615337281747558
"53","053","G5300530","2010","4","9","Washington","Pierce County",795225,"","Pierce County Washington",793581,819571,-1644,-0.206733943223616,0.206733943223616,24346,3.06152346820082,3.06152346820082
"53","055","G5300550","2010","4","9","Washington","San Juan County",15769,"","San Juan County Washington",15581,16807,-188,-1.19221256896442,1.19221256896442,1038,6.58253535417592,6.58253535417592
"53","057","G5300570","2010","4","9","Washington","Skagit County",116901,"","Skagit County Washington",120292,119484,3391,2.90074507489243,2.90074507489243,2583,2.20956193702364,2.20956193702364
"53","059","G5300590","2010","4","9","Washington","Skamania County",11066,"","Skamania County Washington",11016,11367,-50,-0.451834447858305,0.451834447858305,301,2.72004337610699,2.72004337610699
"53","061","G5300610","2010","4","9","Washington","Snohomish County",713335,"","Snohomish County Washington",707418,727532,-5917,-0.829484043261581,0.829484043261581,14197,1.99022899479207,1.99022899479207
"53","063","G5300630","2010","4","9","Washington","Spokane County",471221,"","Spokane County Washington",470840,478737,-381,-0.0808537819834006,0.0808537819834006,7516,1.595005315977,1.595005315977
"53","065","G5300650","2010","4","9","Washington","Stevens County",43531,"","Stevens County Washington",42026,43334,-1505,-3.45730628747329,3.45730628747329,-197,-0.452551055569594,0.452551055569594
"53","067","G5300670","2010","4","9","Washington","Thurston County",252264,"","Thurston County Washington",252849,250822,585,0.231899914375416,0.231899914375416,-1442,-0.57162337868265,0.57162337868265
"53","069","G5300690","2010","4","9","Washington","Wahkiakum County",3978,"","Wahkiakum County Washington",3987,4300,9,0.226244343891403,0.226244343891403,322,8.09451985922574,8.09451985922574
"53","071","G5300710","2010","4","9","Washington","Walla Walla County",58781,"","Walla Walla County Washington",59896,59762,1115,1.89687143804971,1.89687143804971,981,1.66890661948589,1.66890661948589
"53","073","G5300730","2010","4","9","Washington","Whatcom County",201140,"","Whatcom County Washington",201408,199565,268,0.133240528984787,0.133240528984787,-1575,-0.783036690862086,0.783036690862086
"53","075","G5300750","2010","4","9","Washington","Whitman County",44776,"","Whitman County Washington",42656,45890,-2120,-4.73467929247811,4.73467929247811,1114,2.48793996783991,2.48793996783991
"53","077","G5300770","2010","4","9","Washington","Yakima County",243231,"","Yakima County Washington",243228,238402,-3,-0.00123339541423585,0.00123339541423585,-4829,-1.98535548511497,1.98535548511497
"54","001","G5400010","2010","3","5","West Virginia","Barbour County",16589,"","Barbour County West Virginia",15853,16165,-736,-4.43667490505757,4.43667490505757,-424,-2.55591054313099,2.55591054313099
"54","003","G5400030","2010","3","5","West Virginia","Berkeley County",104169,"","Berkeley County West Virginia",105158,103866,989,0.94941873302038,0.94941873302038,-303,-0.290873484433949,0.290873484433949
"54","005","G5400050","2010","3","5","West Virginia","Boone County",24629,"","Boone County West Virginia",24670,26338,41,0.166470421048358,0.166470421048358,1709,6.93897437979618,6.93897437979618
"54","007","G5400070","2010","3","5","West Virginia","Braxton County",14523,"","Braxton County West Virginia",14475,15383,-48,-0.330510225160091,0.330510225160091,860,5.9216415341183,5.9216415341183
"54","009","G5400090","2010","3","5","West Virginia","Brooke County",24069,"","Brooke County West Virginia",23217,25635,-852,-3.53982300884956,3.53982300884956,1566,6.50629440358968,6.50629440358968
"54","011","G5400110","2010","3","5","West Virginia","Cabell County",96319,"","Cabell County West Virginia",95597,99102,-722,-0.749592499922134,0.749592499922134,2783,2.88935724000457,2.88935724000457
"54","013","G5400130","2010","3","5","West Virginia","Calhoun County",7627,"","Calhoun County West Virginia",7160,7950,-467,-6.12298413530877,6.12298413530877,323,4.23495476596303,4.23495476596303
"54","015","G5400150","2010","3","5","West Virginia","Clay County",9386,"","Clay County West Virginia",9935,10812,549,5.84913701257192,5.84913701257192,1426,15.1928404005966,15.1928404005966
"54","017","G5400170","2010","3","5","West Virginia","Doddridge County",8202,"","Doddridge County West Virginia",7181,7696,-1021,-12.4481833699098,12.4481833699098,-506,-6.16922701780054,6.16922701780054
"54","019","G5400190","2010","3","5","West Virginia","Fayette County",46039,"","Fayette County West Virginia",46243,49480,204,0.443102586937162,0.443102586937162,3441,7.47409804730772,7.47409804730772
"54","021","G5400210","2010","3","5","West Virginia","Gilmer County",8693,"","Gilmer County West Virginia",6862,7428,-1831,-21.0629241918785,21.0629241918785,-1265,-14.5519383411941,14.5519383411941
"54","023","G5400230","2010","3","5","West Virginia","Grant County",11937,"","Grant County West Virginia",11795,12596,-142,-1.18957862109408,1.18957862109408,659,5.52065007958449,5.52065007958449
"54","025","G5400250","2010","3","5","West Virginia","Greenbrier County",35480,"","Greenbrier County West Virginia",34604,36819,-876,-2.46899661781285,2.46899661781285,1339,3.7739571589628,3.7739571589628
"54","027","G5400270","2010","3","5","West Virginia","Hampshire County",23964,"","Hampshire County West Virginia",22739,23106,-1225,-5.11183441829411,5.11183441829411,-858,-3.58037055583375,3.58037055583375
"54","029","G5400290","2010","3","5","West Virginia","Hancock County",30676,"","Hancock County West Virginia",29710,33116,-966,-3.14904159603599,3.14904159603599,2440,7.95410092580519,7.95410092580519
"54","031","G5400310","2010","3","5","West Virginia","Hardy County",14025,"","Hardy County West Virginia",13667,14488,-358,-2.55258467023173,2.55258467023173,463,3.30124777183601,3.30124777183601
"54","033","G5400330","2010","3","5","West Virginia","Harrison County",69099,"","Harrison County West Virginia",69317,71227,218,0.315489370323738,0.315489370323738,2128,3.07963935802255,3.07963935802255
"54","035","G5400350","2010","3","5","West Virginia","Jackson County",29211,"","Jackson County West Virginia",28134,29250,-1077,-3.68696723836911,3.68696723836911,39,0.133511348464619,0.133511348464619
"54","037","G5400370","2010","3","5","West Virginia","Jefferson County",53498,"","Jefferson County West Virginia",53412,54290,-86,-0.160753673034506,0.160753673034506,792,1.48042917492243,1.48042917492243
"54","039","G5400390","2010","3","5","West Virginia","Kanawha County",193063,"","Kanawha County West Virginia",191168,203850,-1895,-0.981544884312375,0.981544884312375,10787,5.58729533882722,5.58729533882722
"54","041","G5400410","2010","3","5","West Virginia","Lewis County",16372,"","Lewis County West Virginia",17487,17508,1115,6.8104080136819,6.8104080136819,1136,6.93867578793061,6.93867578793061
"54","043","G5400430","2010","3","5","West Virginia","Lincoln County",21720,"","Lincoln County West Virginia",22066,22974,346,1.59300184162063,1.59300184162063,1254,5.77348066298343,5.77348066298343
"54","045","G5400450","2010","3","5","West Virginia","Logan County",36743,"","Logan County West Virginia",35438,39453,-1305,-3.55169692186267,3.55169692186267,2710,7.37555452739297,7.37555452739297
"54","047","G5400470","2010","3","5","West Virginia","McDowell County",22113,"","McDowell County West Virginia",22227,27697,114,0.515533848867182,0.515533848867182,5584,25.252114141003,25.252114141003
"54","049","G5400490","2010","3","5","West Virginia","Marion County",56418,"","Marion County West Virginia",57180,57985,762,1.35063277677337,1.35063277677337,1567,2.77748236378461,2.77748236378461
"54","051","G5400510","2010","3","5","West Virginia","Marshall County",33107,"","Marshall County West Virginia",32638,36169,-469,-1.41661884193675,1.41661884193675,3062,9.24879934757,9.24879934757
"54","053","G5400530","2010","3","5","West Virginia","Mason County",27324,"","Mason County West Virginia",25630,27063,-1694,-6.19967793880837,6.19967793880837,-261,-0.955204216073781,0.955204216073781
"54","055","G5400550","2010","3","5","West Virginia","Mercer County",62264,"","Mercer County West Virginia",62146,63325,-118,-0.189515610946936,0.189515610946936,1061,1.70403443402287,1.70403443402287
"54","057","G5400570","2010","3","5","West Virginia","Mineral County",28212,"","Mineral County West Virginia",27535,29583,-677,-2.39968807599603,2.39968807599603,1371,4.85963419821353,4.85963419821353
"54","059","G5400590","2010","3","5","West Virginia","Mingo County",26839,"","Mingo County West Virginia",26224,29620,-615,-2.29144155892544,2.29144155892544,2781,10.3617869518238,10.3617869518238
"54","061","G5400610","2010","3","5","West Virginia","Monongalia County",96189,"","Monongalia County West Virginia",91704,86317,-4485,-4.66269531859152,4.66269531859152,-9872,-10.2631278004761,10.2631278004761
"54","063","G5400630","2010","3","5","West Virginia","Monroe County",13502,"","Monroe County West Virginia",13706,13827,204,1.51088727595912,1.51088727595912,325,2.40705080728781,2.40705080728781
"54","065","G5400650","2010","3","5","West Virginia","Morgan County",17541,"","Morgan County West Virginia",16320,17959,-1221,-6.96083461604241,6.96083461604241,418,2.38298842711362,2.38298842711362
"54","067","G5400670","2010","3","5","West Virginia","Nicholas County",26233,"","Nicholas County West Virginia",26096,27899,-137,-0.522242976403766,0.522242976403766,1666,6.35077955247208,6.35077955247208
"54","069","G5400690","2010","3","5","West Virginia","Ohio County",44443,"","Ohio County West Virginia",44197,47515,-246,-0.553517989334653,0.553517989334653,3072,6.91222464730104,6.91222464730104
"54","071","G5400710","2010","3","5","West Virginia","Pendleton County",7695,"","Pendleton County West Virginia",7315,8745,-380,-4.93827160493827,4.93827160493827,1050,13.64522417154,13.64522417154
"54","073","G5400730","2010","3","5","West Virginia","Pleasants County",7605,"","Pleasants County West Virginia",7315,7637,-290,-3.81328073635766,3.81328073635766,32,0.42077580539119,0.42077580539119
"54","075","G5400750","2010","3","5","West Virginia","Pocahontas County",8719,"","Pocahontas County West Virginia",8341,9566,-378,-4.33535955958252,4.33535955958252,847,9.71441679091639,9.71441679091639
"54","077","G5400770","2010","3","5","West Virginia","Preston County",33520,"","Preston County West Virginia",30205,30561,-3315,-9.88961813842482,9.88961813842482,-2959,-8.82756563245824,8.82756563245824
"54","079","G5400790","2010","3","5","West Virginia","Putnam County",55486,"","Putnam County West Virginia",55936,57178,450,0.81101539126987,0.81101539126987,1692,3.04941787117471,3.04941787117471
"54","081","G5400810","2010","3","5","West Virginia","Raleigh County",78859,"","Raleigh County West Virginia",79552,83253,693,0.878783651834287,0.878783651834287,4394,5.5719702253389,5.5719702253389
"54","083","G5400830","2010","3","5","West Virginia","Randolph County",29405,"","Randolph County West Virginia",28544,29468,-861,-2.92807345689509,2.92807345689509,63,0.214249277333787,0.214249277333787
"54","085","G5400850","2010","3","5","West Virginia","Ritchie County",10449,"","Ritchie County West Virginia",10154,10706,-295,-2.82323667336587,2.82323667336587,257,2.45956550866112,2.45956550866112
"54","087","G5400870","2010","3","5","West Virginia","Roane County",14926,"","Roane County West Virginia",14798,16553,-128,-0.857563982312743,0.857563982312743,1627,10.9004421814284,10.9004421814284
"54","089","G5400890","2010","3","5","West Virginia","Summers County",13927,"","Summers County West Virginia",13175,14802,-752,-5.39958354275867,5.39958354275867,875,6.2827601062684,6.2827601062684
"54","091","G5400910","2010","3","5","West Virginia","Taylor County",16895,"","Taylor County West Virginia",16252,16606,-643,-3.80585972181119,3.80585972181119,-289,-1.7105652559929,1.7105652559929
"54","093","G5400930","2010","3","5","West Virginia","Tucker County",7141,"","Tucker County West Virginia",6845,7665,-296,-4.14507772020725,4.14507772020725,524,7.33790785604257,7.33790785604257
"54","095","G5400950","2010","3","5","West Virginia","Tyler County",9208,"","Tyler County West Virginia",8602,9880,-606,-6.58123370981755,6.58123370981755,672,7.29800173761946,7.29800173761946
"54","097","G5400970","2010","3","5","West Virginia","Upshur County",24254,"","Upshur County West Virginia",23892,24883,-362,-1.49253731343284,1.49253731343284,629,2.59338665787087,2.59338665787087
"54","099","G5400990","2010","3","5","West Virginia","Wayne County",42481,"","Wayne County West Virginia",40853,44356,-1628,-3.83230149949389,3.83230149949389,1875,4.41373790635814,4.41373790635814
"54","101","G5401010","2010","3","5","West Virginia","Webster County",9154,"","Webster County West Virginia",9433,10140,279,3.04784793532882,3.04784793532882,986,10.7712475420581,10.7712475420581
"54","103","G5401030","2010","3","5","West Virginia","Wetzel County",16583,"","Wetzel County West Virginia",16201,17877,-382,-2.30356389073147,2.30356389073147,1294,7.80317192305373,7.80317192305373
"54","105","G5401050","2010","3","5","West Virginia","Wirt County",5717,"","Wirt County West Virginia",5605,6279,-112,-1.95906944201504,1.95906944201504,562,9.83033059296834,9.83033059296834
"54","107","G5401070","2010","3","5","West Virginia","Wood County",86956,"","Wood County West Virginia",86832,90977,-124,-0.142600855605134,0.142600855605134,4021,4.62417774506647,4.62417774506647
"54","109","G5401090","2010","3","5","West Virginia","Wyoming County",23796,"","Wyoming County West Virginia",23164,26342,-632,-2.65590855605984,2.65590855605984,2546,10.6992771894436,10.6992771894436
"55","001","G5500010","2010","2","3","Wisconsin","Adams County",20875,"","Adams County Wisconsin",20073,23431,-802,-3.84191616766467,3.84191616766467,2556,12.2443113772455,12.2443113772455
"55","003","G5500030","2010","2","3","Wisconsin","Ashland County",16157,"","Ashland County Wisconsin",16237,17993,80,0.49514142476945,0.49514142476945,1836,11.3634956984589,11.3634956984589
"55","005","G5500050","2010","2","3","Wisconsin","Barron County",45870,"","Barron County Wisconsin",45510,50791,-360,-0.78482668410726,0.78482668410726,4921,10.7281447569217,10.7281447569217
"55","007","G5500070","2010","2","3","Wisconsin","Bayfield County",15014,"","Bayfield County Wisconsin",14683,17335,-331,-2.20460903157053,2.20460903157053,2321,15.4589050219795,15.4589050219795
"55","009","G5500090","2010","2","3","Wisconsin","Brown County",248007,"","Brown County Wisconsin",248218,261678,211,0.0850782437592487,0.0850782437592487,13671,5.5123444096336,5.5123444096336
"55","011","G5500110","2010","2","3","Wisconsin","Buffalo County",13587,"","Buffalo County Wisconsin",13386,15109,-201,-1.47935526606315,1.47935526606315,1522,11.2018841539707,11.2018841539707
"55","013","G5500130","2010","2","3","Wisconsin","Burnett County",15457,"","Burnett County Wisconsin",15757,17459,300,1.9408682150482,1.9408682150482,2002,12.9520605550883,12.9520605550883
"55","015","G5500150","2010","2","3","Wisconsin","Calumet County",48971,"","Calumet County Wisconsin",45016,50239,-3955,-8.07620836821792,8.07620836821792,1268,2.58928753752221,2.58928753752221
"55","017","G5500170","2010","2","3","Wisconsin","Chippewa County",62415,"","Chippewa County Wisconsin",60607,64145,-1808,-2.8967395658095,2.8967395658095,1730,2.77176960666506,2.77176960666506
"55","019","G5500190","2010","2","3","Wisconsin","Clark County",34690,"","Clark County Wisconsin",33388,36320,-1302,-3.75324300951283,3.75324300951283,1630,4.69876044969732,4.69876044969732
"55","021","G5500210","2010","2","3","Wisconsin","Columbia County",56833,"","Columbia County Wisconsin",55438,59502,-1395,-2.45455985079091,2.45455985079091,2669,4.69621522706878,4.69621522706878
"55","023","G5500230","2010","2","3","Wisconsin","Crawford County",16644,"","Crawford County Wisconsin",16626,18500,-18,-0.108147080028839,0.108147080028839,1856,11.1511655851959,11.1511655851959
"55","025","G5500250","2010","2","3","Wisconsin","Dane County",488073,"","Dane County Wisconsin",494586,508477,6513,1.33443152970969,1.33443152970969,20404,4.18052217598597,4.18052217598597
"55","027","G5500270","2010","2","3","Wisconsin","Dodge County",88759,"","Dodge County Wisconsin",87254,94257,-1505,-1.69560269944456,1.69560269944456,5498,6.19430142295429,6.19430142295429
"55","029","G5500290","2010","2","3","Wisconsin","Door County",27785,"","Door County Wisconsin",27602,32452,-183,-0.658628756523304,0.658628756523304,4667,16.7968328234659,16.7968328234659
"55","031","G5500310","2010","2","3","Wisconsin","Douglas County",44159,"","Douglas County Wisconsin",44384,46252,225,0.509522407663217,0.509522407663217,2093,4.73969066328495,4.73969066328495
"55","033","G5500330","2010","2","3","Wisconsin","Dunn County",43857,"","Dunn County Wisconsin",43138,46183,-719,-1.63941902090886,1.63941902090886,2326,5.30360033746038,5.30360033746038
"55","035","G5500350","2010","2","3","Wisconsin","Eau Claire County",98736,"","Eau Claire County Wisconsin",100028,104539,1292,1.30853994490358,1.30853994490358,5803,5.87728893210177,5.87728893210177
"55","037","G5500370","2010","2","3","Wisconsin","Florence County",4423,"","Florence County Wisconsin",4481,5597,58,1.31132715351571,1.31132715351571,1174,26.5430703142663,26.5430703142663
"55","039","G5500390","2010","2","3","Wisconsin","Fond du Lac County",101633,"","Fond du Lac County Wisconsin",100254,107312,-1379,-1.35684275776569,1.35684275776569,5679,5.58775200968189,5.58775200968189
"55","041","G5500410","2010","2","3","Wisconsin","Forest County",9304,"","Forest County Wisconsin",9447,10903,143,1.53697334479794,1.53697334479794,1599,17.1861564918315,17.1861564918315
"55","043","G5500430","2010","2","3","Wisconsin","Grant County",51208,"","Grant County Wisconsin",49194,53593,-2014,-3.93297922199656,3.93297922199656,2385,4.65747539446961,4.65747539446961
"55","045","G5500450","2010","2","3","Wisconsin","Green County",36842,"","Green County Wisconsin",36222,38444,-620,-1.68286195103415,1.68286195103415,1602,4.34829813799468,4.34829813799468
"55","047","G5500470","2010","2","3","Wisconsin","Green Lake County",19051,"","Green Lake County Wisconsin",18389,20456,-662,-3.47488320823054,3.47488320823054,1405,7.37494094798173,7.37494094798173
"55","049","G5500490","2010","2","3","Wisconsin","Iowa County",23687,"","Iowa County Wisconsin",23586,25556,-101,-0.426394224680204,0.426394224680204,1869,7.8904040190822,7.8904040190822
"55","051","G5500510","2010","2","3","Wisconsin","Iron County",5916,"","Iron County Wisconsin",6019,7422,103,1.74104124408384,1.74104124408384,1506,25.4563894523327,25.4563894523327
"55","053","G5500530","2010","2","3","Wisconsin","Jackson County",20449,"","Jackson County Wisconsin",19880,21703,-569,-2.78253215316152,2.78253215316152,1254,6.13232920925229,6.13232920925229
"55","055","G5500550","2010","2","3","Wisconsin","Jefferson County",83686,"","Jefferson County Wisconsin",80896,86920,-2790,-3.33389097340057,3.33389097340057,3234,3.86444566594173,3.86444566594173
"55","057","G5500570","2010","2","3","Wisconsin","Juneau County",26664,"","Juneau County Wisconsin",26464,28393,-200,-0.75007500750075,0.75007500750075,1729,6.48439843984398,6.48439843984398
"55","059","G5500590","2010","2","3","Wisconsin","Kenosha County",166426,"","Kenosha County Wisconsin",166216,169534,-210,-0.126182207107063,0.126182207107063,3108,1.86749666518453,1.86749666518453
"55","061","G5500610","2010","2","3","Wisconsin","Kewaunee County",20574,"","Kewaunee County Wisconsin",20230,22561,-344,-1.67201322056965,1.67201322056965,1987,9.657820550209,9.657820550209
"55","063","G5500630","2010","2","3","Wisconsin","La Crosse County",114638,"","La Crosse County Wisconsin",114338,118440,-300,-0.261693330309322,0.261693330309322,3802,3.31652680612013,3.31652680612013
"55","065","G5500650","2010","2","3","Wisconsin","Lafayette County",16836,"","Lafayette County Wisconsin",15682,17399,-1154,-6.8543597053932,6.8543597053932,563,3.344024708957,3.344024708957
"55","067","G5500670","2010","2","3","Wisconsin","Langlade County",19977,"","Langlade County Wisconsin",19894,22640,-83,-0.41547779946939,0.41547779946939,2663,13.3303298793613,13.3303298793613
"55","069","G5500690","2010","2","3","Wisconsin","Lincoln County",28743,"","Lincoln County Wisconsin",29147,32395,404,1.40555961451484,1.40555961451484,3652,12.7057022579411,12.7057022579411
"55","071","G5500710","2010","2","3","Wisconsin","Manitowoc County",81442,"","Manitowoc County Wisconsin",80171,88588,-1271,-1.56061982760738,1.56061982760738,7146,8.77434247685469,8.77434247685469
"55","073","G5500730","2010","2","3","Wisconsin","Marathon County",134063,"","Marathon County Wisconsin",131766,145380,-2297,-1.71337356317552,1.71337356317552,11317,8.4415535979353,8.4415535979353
"55","075","G5500750","2010","2","3","Wisconsin","Marinette County",41749,"","Marinette County Wisconsin",41898,47710,149,0.356894775922777,0.356894775922777,5961,14.2781863038636,14.2781863038636
"55","077","G5500770","2010","2","3","Wisconsin","Marquette County",15404,"","Marquette County Wisconsin",14633,16060,-771,-5.00519345624513,5.00519345624513,656,4.25863412100753,4.25863412100753
"55","078","G5500780","2010","2","3","Wisconsin","Menominee County",4232,"","Menominee County Wisconsin",4583,4858,351,8.29395085066163,8.29395085066163,626,14.7920604914934,14.7920604914934
"55","079","G5500790","2010","2","3","Wisconsin","Milwaukee County",947735,"","Milwaukee County Wisconsin",964066,963818,16331,1.723161010198,1.723161010198,16083,1.69699335784792,1.69699335784792
"55","081","G5500810","2010","2","3","Wisconsin","Monroe County",44673,"","Monroe County Wisconsin",43804,47449,-869,-1.94524656951626,1.94524656951626,2776,6.21404427730396,6.21404427730396
"55","083","G5500830","2010","2","3","Wisconsin","Oconto County",37660,"","Oconto County Wisconsin",37119,41383,-541,-1.43653744025491,1.43653744025491,3723,9.8858204992034,9.8858204992034
"55","085","G5500850","2010","2","3","Wisconsin","Oneida County",35998,"","Oneida County Wisconsin",35559,40837,-439,-1.21951219512195,1.21951219512195,4839,13.4424134674149,13.4424134674149
"55","087","G5500870","2010","2","3","Wisconsin","Outagamie County",176695,"","Outagamie County Wisconsin",177484,186737,789,0.446532159936614,0.446532159936614,10042,5.68323948046068,5.68323948046068
"55","089","G5500890","2010","2","3","Wisconsin","Ozaukee County",86395,"","Ozaukee County Wisconsin",86288,92737,-107,-0.123849759824064,0.123849759824064,6342,7.34070258695526,7.34070258695526
"55","091","G5500910","2010","2","3","Wisconsin","Pepin County",7469,"","Pepin County Wisconsin",7354,8199,-115,-1.53969741598608,1.53969741598608,730,9.77373142321596,9.77373142321596
"55","093","G5500930","2010","2","3","Wisconsin","Pierce County",41019,"","Pierce County Wisconsin",40328,43062,-691,-1.68458519222799,1.68458519222799,2043,4.98061873765816,4.98061873765816
"55","095","G5500950","2010","2","3","Wisconsin","Polk County",44205,"","Polk County Wisconsin",44039,48221,-166,-0.375523130867549,0.375523130867549,4016,9.08494514195227,9.08494514195227
"55","097","G5500970","2010","2","3","Wisconsin","Portage County",70019,"","Portage County Wisconsin",69317,75297,-702,-1.00258501263943,1.00258501263943,5278,7.53795398391865,7.53795398391865
"55","099","G5500990","2010","2","3","Wisconsin","Price County",14159,"","Price County Wisconsin",14072,17116,-87,-0.614450173034819,0.614450173034819,2957,20.8842432375168,20.8842432375168
"55","101","G5501010","2010","2","3","Wisconsin","Racine County",195408,"","Racine County Wisconsin",201025,205287,5617,2.87449848522067,2.87449848522067,9879,5.05557602554655,5.05557602554655
"55","103","G5501030","2010","2","3","Wisconsin","Richland County",18021,"","Richland County Wisconsin",17725,19237,-296,-1.64252816158926,1.64252816158926,1216,6.74768325842073,6.74768325842073
"55","105","G5501050","2010","2","3","Wisconsin","Rock County",160331,"","Rock County Wisconsin",159976,168606,-355,-0.221416943697725,0.221416943697725,8275,5.16119777210895,5.16119777210895
"55","107","G5501070","2010","2","3","Wisconsin","Rusk County",14755,"","Rusk County Wisconsin",14189,16821,-566,-3.83598780074551,3.83598780074551,2066,14.0020332090817,14.0020332090817
"55","109","G5501090","2010","2","3","Wisconsin","St. Croix County",84345,"","St. Croix County Wisconsin",83654,88075,-691,-0.819254253364159,0.819254253364159,3730,4.42231311873851,4.42231311873851
"55","111","G5501110","2010","2","3","Wisconsin","Sauk County",61976,"","Sauk County Wisconsin",59080,66476,-2896,-4.67277655866787,4.67277655866787,4500,7.26087517748806,7.26087517748806
"55","113","G5501130","2010","2","3","Wisconsin","Sawyer County",16557,"","Sawyer County Wisconsin",16990,18698,433,2.61520806909464,2.61520806909464,2141,12.9310865494957,12.9310865494957
"55","115","G5501150","2010","2","3","Wisconsin","Shawano County",41949,"","Shawano County Wisconsin",41120,45314,-829,-1.97620920641732,1.97620920641732,3365,8.02164533123555,8.02164533123555
"55","117","G5501170","2010","2","3","Wisconsin","Sheboygan County",115507,"","Sheboygan County Wisconsin",114242,123835,-1265,-1.09517172119439,1.09517172119439,8328,7.20995264356273,7.20995264356273
"55","119","G5501190","2010","2","3","Wisconsin","Taylor County",20689,"","Taylor County Wisconsin",19066,21278,-1623,-7.84474841703321,7.84474841703321,589,2.84692348591039,2.84692348591039
"55","121","G5501210","2010","2","3","Wisconsin","Trempealeau County",28816,"","Trempealeau County Wisconsin",27796,30140,-1020,-3.53970016657413,3.53970016657413,1324,4.59466962798445,4.59466962798445
"55","123","G5501230","2010","2","3","Wisconsin","Vernon County",29773,"","Vernon County Wisconsin",29337,31388,-436,-1.46441406643603,1.46441406643603,1615,5.42437779195916,5.42437779195916
"55","125","G5501250","2010","2","3","Wisconsin","Vilas County",21430,"","Vilas County Wisconsin",21457,23593,27,0.125991600559963,0.125991600559963,2163,10.0933271115259,10.0933271115259
"55","127","G5501270","2010","2","3","Wisconsin","Walworth County",102228,"","Walworth County Wisconsin",100614,107112,-1614,-1.57882380561099,1.57882380561099,4884,4.77755605117972,4.77755605117972
"55","129","G5501290","2010","2","3","Wisconsin","Washburn County",15911,"","Washburn County Wisconsin",16622,18477,711,4.46860662434794,4.46860662434794,2566,16.1272075922318,16.1272075922318
"55","131","G5501310","2010","2","3","Wisconsin","Washington County",131887,"","Washington County Wisconsin",130773,139471,-1114,-0.844662476210696,0.844662476210696,7584,5.75037721685989,5.75037721685989
"55","133","G5501330","2010","2","3","Wisconsin","Waukesha County",389891,"","Waukesha County Wisconsin",382388,405222,-7503,-1.92438399450103,1.92438399450103,15331,3.93212461944492,3.93212461944492
"55","135","G5501350","2010","2","3","Wisconsin","Waupaca County",52410,"","Waupaca County Wisconsin",51590,57387,-820,-1.56458691089487,1.56458691089487,4977,9.49627933600458,9.49627933600458
"55","137","G5501370","2010","2","3","Wisconsin","Waushara County",24496,"","Waushara County Wisconsin",24334,25571,-162,-0.661332462442848,0.661332462442848,1075,4.38847158719791,4.38847158719791
"55","139","G5501390","2010","2","3","Wisconsin","Winnebago County",166994,"","Winnebago County Wisconsin",163551,175102,-3443,-2.06175072158281,2.06175072158281,8108,4.85526426099141,4.85526426099141
"55","141","G5501410","2010","2","3","Wisconsin","Wood County",74749,"","Wood County Wisconsin",73938,80480,-811,-1.08496434734913,1.08496434734913,5731,7.66699220056456,7.66699220056456
"56","001","G5600010","2010","4","8","Wyoming","Albany County",36299,"","Albany County Wyoming",34411,37139,-1888,-5.20124521336676,5.20124521336676,840,2.31411333645555,2.31411333645555
"56","003","G5600030","2010","4","8","Wyoming","Big Horn County",11668,"","Big Horn County Wyoming",11699,11849,31,0.265683921837504,0.265683921837504,181,1.55125128556736,1.55125128556736
"56","005","G5600050","2010","4","8","Wyoming","Campbell County",46133,"","Campbell County Wyoming",44428,41380,-1705,-3.69583595257191,3.69583595257191,-4753,-10.3028201070817,10.3028201070817
"56","007","G5600070","2010","4","8","Wyoming","Carbon County",15885,"","Carbon County Wyoming",15875,16387,-10,-0.0629524708844822,0.0629524708844822,502,3.16021403840101,3.16021403840101
"56","009","G5600090","2010","4","8","Wyoming","Converse County",13833,"","Converse County Wyoming",13532,13088,-301,-2.17595604713367,2.17595604713367,-745,-5.38567194390226,5.38567194390226
"56","011","G5600110","2010","4","8","Wyoming","Crook County",7083,"","Crook County Wyoming",6734,6464,-349,-4.92729069603275,4.92729069603275,-619,-8.73923478751941,8.73923478751941
"56","013","G5600130","2010","4","8","Wyoming","Fremont County",40123,"","Fremont County Wyoming",39075,37662,-1048,-2.61196819779179,2.61196819779179,-2461,-6.13363905989084,6.13363905989084
"56","015","G5600150","2010","4","8","Wyoming","Goshen County",13249,"","Goshen County Wyoming",12508,12818,-741,-5.59287493395728,5.59287493395728,-431,-3.2530757038267,3.2530757038267
"56","017","G5600170","2010","4","8","Wyoming","Hot Springs County",4812,"","Hot Springs County Wyoming",4575,4973,-237,-4.92518703241895,4.92518703241895,161,3.34580216126351,3.34580216126351
"56","019","G5600190","2010","4","8","Wyoming","Johnson County",8569,"","Johnson County Wyoming",8488,7700,-81,-0.945267825884,0.945267825884,-869,-10.1412066752246,10.1412066752246
"56","021","G5600210","2010","4","8","Wyoming","Laramie County",91738,"","Laramie County Wyoming",89288,91787,-2450,-2.67064902221544,2.67064902221544,49,0.0534129804443088,0.0534129804443088
"56","023","G5600230","2010","4","8","Wyoming","Lincoln County",18106,"","Lincoln County Wyoming",16892,18321,-1214,-6.70495968187341,6.70495968187341,215,1.1874516734784,1.1874516734784
"56","025","G5600250","2010","4","8","Wyoming","Natrona County",75450,"","Natrona County Wyoming",74811,72303,-639,-0.846918489065606,0.846918489065606,-3147,-4.17097415506958,4.17097415506958
"56","027","G5600270","2010","4","8","Wyoming","Niobrara County",2484,"","Niobrara County Wyoming",2325,2439,-159,-6.40096618357488,6.40096618357488,-45,-1.81159420289855,1.81159420289855
"56","029","G5600290","2010","4","8","Wyoming","Park County",28205,"","Park County Wyoming",28299,29491,94,0.333274242155646,0.333274242155646,1286,4.55947527034214,4.55947527034214
"56","031","G5600310","2010","4","8","Wyoming","Platte County",8667,"","Platte County Wyoming",8204,9251,-463,-5.34210222683743,5.34210222683743,584,6.73820237683166,6.73820237683166
"56","033","G5600330","2010","4","8","Wyoming","Sheridan County",29116,"","Sheridan County Wyoming",29280,30293,164,0.563264184640747,0.563264184640747,1177,4.04245088611073,4.04245088611073
"56","035","G5600350","2010","4","8","Wyoming","Sublette County",10247,"","Sublette County Wyoming",8788,7866,-1459,-14.2383136527764,14.2383136527764,-2381,-23.2360690933932,23.2360690933932
"56","037","G5600370","2010","4","8","Wyoming","Sweetwater County",43806,"","Sweetwater County Wyoming",40807,41812,-2999,-6.84609414235493,6.84609414235493,-1994,-4.55188786924166,4.55188786924166
"56","039","G5600390","2010","4","8","Wyoming","Teton County",21294,"","Teton County Wyoming",20805,22417,-489,-2.29642152719076,2.29642152719076,1123,5.27378604301681,5.27378604301681
"56","041","G5600410","2010","4","8","Wyoming","Uinta County",21118,"","Uinta County Wyoming",21028,22066,-90,-0.426176721280424,0.426176721280424,948,4.4890614641538,4.4890614641538
"56","043","G5600430","2010","4","8","Wyoming","Washakie County",8533,"","Washakie County Wyoming",8005,8448,-528,-6.18774170866049,6.18774170866049,-85,-0.996132661432087,0.996132661432087
"56","045","G5600450","2010","4","8","Wyoming","Weston County",7208,"","Weston County Wyoming",6964,6906,-244,-3.38512763596004,3.38512763596004,-302,-4.18978912319645,4.18978912319645
