"STATE","COUNTY","SUMLEV","NAME","CENSUS2020","POPESTIMATE042020","HUBasedPop042020","Error","PctError","AbsPctError","Error_HUBasedPop","PctError_HUBasedPop","AbsPctError_HUBasedPop"
"01","001","050","Autauga County",58805,56130,59428,-2675,-4.54893291386787,4.54893291386787,623,1.05943372162231,1.05943372162231
"01","003","050","Baldwin County",231767,227989,213232,-3778,-1.63008538747967,1.63008538747967,-18535,-7.99725586472621,7.99725586472621
"01","005","050","Barbour County",25223,24652,28116,-571,-2.26380684296079,2.26380684296079,2893,11.4696903619712,11.4696903619712
"01","007","050","Bibb County",22293,22199,23784,-94,-0.421657022383708,0.421657022383708,1491,6.68819808908626,6.68819808908626
"01","009","050","Blount County",59134,57932,59033,-1202,-2.03267155950891,2.03267155950891,-101,-0.170798525383028,0.170798525383028
"01","011","050","Bullock County",10357,10050,11224,-307,-2.96417881625953,2.96417881625953,867,8.37114994689582,8.37114994689582
"01","013","050","Butler County",19051,19525,21379,474,2.48805836963939,2.48805836963939,2328,12.219830980001,12.219830980001
"01","015","050","Calhoun County",116441,113704,119964,-2737,-2.35054662876478,2.35054662876478,3523,3.02556659595847,3.02556659595847
"01","017","050","Chambers County",34772,32989,34257,-1783,-5.12768894512826,5.12768894512826,-515,-1.48107672840216,1.48107672840216
"01","019","050","Cherokee County",24971,26319,26744,1348,5.39826198390133,5.39826198390133,1773,7.10023627407793,7.10023627407793
"01","021","050","Chilton County",45014,44417,45584,-597,-1.32625405429422,1.32625405429422,570,1.26627271515529,1.26627271515529
"01","023","050","Choctaw County",12665,12469,14209,-196,-1.54757204895381,1.54757204895381,1544,12.1910777733912,12.1910777733912
"01","025","050","Clarke County",23087,23398,26310,311,1.34707844241348,1.34707844241348,3223,13.9602373630181,13.9602373630181
"01","027","050","Clay County",14236,13152,14094,-1084,-7.61449845462208,7.61449845462208,-142,-0.997471199775218,0.997471199775218
"01","029","050","Cleburne County",15056,14976,15371,-80,-0.53134962805526,0.53134962805526,315,2.09218916046759,2.09218916046759
"01","031","050","Coffee County",53465,53160,52884,-305,-0.570466660432058,0.570466660432058,-581,-1.08669222856074,1.08669222856074
"01","033","050","Colbert County",57227,55402,56980,-1825,-3.18905411781152,3.18905411781152,-247,-0.431614447725724,0.431614447725724
"01","035","050","Conecuh County",11597,11924,13504,327,2.81969474864189,2.81969474864189,1907,16.4439079072174,16.4439079072174
"01","037","050","Coosa County",10387,10681,12060,294,2.83046115336478,2.83046115336478,1673,16.1066718012901,16.1066718012901
"01","039","050","Covington County",37570,36993,38410,-577,-1.53579984029811,1.53579984029811,840,2.23582645727974,2.23582645727974
"01","041","050","Crenshaw County",13194,13713,14207,519,3.93360618462938,3.93360618462938,1013,7.67773230256177,7.67773230256177
"01","043","050","Cullman County",87866,84344,83507,-3522,-4.00837639132315,4.00837639132315,-4359,-4.96096328500216,4.96096328500216
"01","045","050","Dale County",49326,49076,51543,-250,-0.506832096663017,0.506832096663017,2217,4.49458703320764,4.49458703320764
"01","047","050","Dallas County",38462,36424,44355,-2038,-5.29873641516302,5.29873641516302,5893,15.3216161406063,15.3216161406063
"01","049","050","DeKalb County",71608,71664,72377,56,0.0782035526756787,0.0782035526756787,769,1.07390235727852,1.07390235727852
"01","051","050","Elmore County",87977,82048,83990,-5929,-6.73926139786535,6.73926139786535,-3987,-4.53186628323312,4.53186628323312
"01","053","050","Escambia County",36757,36361,38762,-396,-1.07734581168213,1.07734581168213,2005,5.45474331419866,5.45474331419866
"01","055","050","Etowah County",103436,102482,105433,-954,-0.922309447387757,0.922309447387757,1997,1.93066243860938,1.93066243860938
"01","057","050","Fayette County",16321,16246,17439,-75,-0.459530666013112,0.459530666013112,1118,6.85007046136879,6.85007046136879
"01","059","050","Franklin County",32113,31541,31950,-572,-1.78121010182792,1.78121010182792,-163,-0.507582598947467,0.507582598947467
"01","061","050","Geneva County",26659,26402,27408,-257,-0.96402715780787,0.96402715780787,749,2.80955774785251,2.80955774785251
"01","063","050","Greene County",7730,8034,9362,304,3.93272962483829,3.93272962483829,1632,21.1125485122898,21.1125485122898
"01","065","050","Hale County",14785,14673,16328,-112,-0.757524518092661,0.757524518092661,1543,10.4362529590801,10.4362529590801
"01","067","050","Henry County",17146,17203,18074,57,0.332439052840313,0.332439052840313,928,5.41234107080369,5.41234107080369
"01","069","050","Houston County",107202,106542,108396,-660,-0.615660155594112,0.615660155594112,1194,1.1137851905748,1.1137851905748
"01","071","050","Jackson County",52579,51642,54283,-937,-1.78208029821792,1.78208029821792,1704,3.24083759675916,3.24083759675916
"01","073","050","Jefferson County",674721,656529,679740,-18192,-2.69622555100553,2.69622555100553,5019,0.743863018936716,0.743863018936716
"01","075","050","Lamar County",13972,13790,14722,-182,-1.30260521042084,1.30260521042084,750,5.3678786143716,5.3678786143716
"01","077","050","Lauderdale County",93564,93331,96744,-233,-0.249027403702279,0.249027403702279,3180,3.39874310632294,3.39874310632294
"01","079","050","Lawrence County",33073,32863,34732,-210,-0.634959030024491,0.634959030024491,1659,5.01617633719348,5.01617633719348
"01","081","050","Lee County",174241,166460,163773,-7781,-4.46565389317095,4.46565389317095,-10468,-6.00777084612692,6.00777084612692
"01","083","050","Limestone County",103570,101485,87047,-2085,-2.01313121560297,2.01313121560297,-16523,-15.9534614270542,15.9534614270542
"01","085","050","Lowndes County",10311,9653,11649,-658,-6.38153428377461,6.38153428377461,1338,12.9764329356997,12.9764329356997
"01","087","050","Macon County",19532,17942,21647,-1590,-8.14048740528364,8.14048740528364,2115,10.8283841900471,10.8283841900471
"01","089","050","Madison County",388153,377894,385877,-10259,-2.643029939225,2.643029939225,-2276,-0.586366716217574,0.586366716217574
"01","091","050","Marengo County",19323,18793,21435,-530,-2.74284531387466,2.74284531387466,2112,10.9299798167986,10.9299798167986
"01","093","050","Marion County",29341,29749,30987,408,1.39054565284073,1.39054565284073,1646,5.6098974131761,5.6098974131761
"01","095","050","Marshall County",97612,96951,94181,-661,-0.677170839650863,0.677170839650863,-3431,-3.51493668811212,3.51493668811212
"01","097","050","Mobile County",414809,413119,429859,-1690,-0.407416425390963,0.407416425390963,15050,3.62817585925088,3.62817585925088
"01","099","050","Monroe County",19772,20520,23381,748,3.78312765527008,3.78312765527008,3609,18.2530851709488,18.2530851709488
"01","101","050","Montgomery County",228954,225131,238089,-3823,-1.66976772626816,1.66976772626816,9135,3.98988443093372,3.98988443093372
"01","103","050","Morgan County",123421,119862,122609,-3559,-2.88362596316672,2.88362596316672,-812,-0.65791072832014,0.65791072832014
"01","105","050","Perry County",8511,8754,10673,243,2.85512865703208,2.85512865703208,2162,25.4024203971331,25.4024203971331
"01","107","050","Pickens County",19123,19821,20167,698,3.65005490770277,3.65005490770277,1044,5.45939444647806,5.45939444647806
"01","109","050","Pike County",33009,32976,35329,-33,-0.0999727347087158,0.0999727347087158,2320,7.02838619770366,7.02838619770366
"01","111","050","Randolph County",21967,22882,23342,915,4.16533891746711,4.16533891746711,1375,6.25938908362544,6.25938908362544
"01","113","050","Russell County",59183,58196,60763,-987,-1.66770863254651,1.66770863254651,1580,2.66968555159421,2.66968555159421
"01","115","050","St. Clair County",91103,90488,88310,-615,-0.675060096813497,0.675060096813497,-2793,-3.06576073235788,3.06576073235788
"01","117","050","Shelby County",223024,220664,216814,-2360,-1.05818207905876,1.05818207905876,-6210,-2.78445369108257,2.78445369108257
"01","119","050","Sumter County",12345,12263,14126,-82,-0.664236533009316,0.664236533009316,1781,14.4268934791414,14.4268934791414
"01","121","050","Talladega County",82149,80075,84986,-2074,-2.52468076300381,2.52468076300381,2837,3.45348087012623,3.45348087012623
"01","123","050","Tallapoosa County",41311,40192,42895,-1119,-2.70872164798722,2.70872164798722,1584,3.83432983951006,3.83432983951006
"01","125","050","Tuscaloosa County",227036,210736,215294,-16300,-7.17947814443524,7.17947814443524,-11742,-5.17186701668458,5.17186701668458
"01","127","050","Walker County",65342,63277,68400,-2065,-3.16029506289982,3.16029506289982,3058,4.6799914297083,4.6799914297083
"01","129","050","Washington County",15388,16050,18103,662,4.30205354821939,4.30205354821939,2715,17.6436184039511,17.6436184039511
"01","131","050","Wilcox County",10600,10252,12116,-348,-3.28301886792453,3.28301886792453,1516,14.3018867924528,14.3018867924528
"01","133","050","Winston County",23540,23552,25059,12,0.0509770603228547,0.0509770603228547,1519,6.45284621920136,6.45284621920136
"02","013","050","Aleutians East Borough",3420,3419,3175,-1,-0.0292397660818713,0.0292397660818713,-245,-7.16374269005848,7.16374269005848
"02","016","050","Aleutians West Census Area",5232,5719,5676,487,9.30810397553517,9.30810397553517,444,8.48623853211009,8.48623853211009
"02","020","050","Anchorage Municipality",291247,287706,310337,-3541,-1.21580651474522,1.21580651474522,19090,6.55457395269308,6.55457395269308
"02","050","050","Bethel Census Area",18666,18487,17372,-179,-0.958962820100718,0.958962820100718,-1294,-6.9323904425158,6.9323904425158
"02","060","050","Bristol Bay Borough",844,823,1012,-21,-2.48815165876777,2.48815165876777,168,19.9052132701422,19.9052132701422
"02","063","050","Chugach Census Area",7102,6464,6908,-638,-8.98338496198254,8.98338496198254,-194,-2.73162489439594,2.73162489439594
"02","066","050","Copper River Census Area",2617,2921,2951,304,11.616354604509,11.616354604509,334,12.7627053878487,12.7627053878487
"02","068","050","Denali Borough",1619,2099,1822,480,29.6479308214948,29.6479308214948,203,12.5386040765905,12.5386040765905
"02","070","050","Dillingham Census Area",4857,4867,4907,10,0.205888408482602,0.205888408482602,50,1.02944204241301,1.02944204241301
"02","090","050","Fairbanks North Star Borough",95655,96053,103480,398,0.416078615859077,0.416078615859077,7825,8.18044012335999,8.18044012335999
"02","100","050","Haines Borough",2080,2589,2603,509,24.4711538461538,24.4711538461538,523,25.1442307692308,25.1442307692308
"02","105","050","Hoonah-Angoon Census Area",2365,2157,2126,-208,-8.79492600422833,8.79492600422833,-239,-10.1057082452431,10.1057082452431
"02","110","050","Juneau City and Borough",32255,31924,33501,-331,-1.02619748876143,1.02619748876143,1246,3.86296698186328,3.86296698186328
"02","122","050","Kenai Peninsula Borough",58799,59300,57106,501,0.852055307063045,0.852055307063045,-1693,-2.87930066837871,2.87930066837871
"02","130","050","Ketchikan Gateway Borough",13948,13795,14203,-153,-1.09693145970748,1.09693145970748,255,1.82821909951247,1.82821909951247
"02","150","050","Kodiak Island Borough",13101,13051,14163,-50,-0.381650255705671,0.381650255705671,1062,8.10625143118846,8.10625143118846
"02","158","050","Kusilvak Census Area",8368,8355,7644,-13,-0.155353728489484,0.155353728489484,-724,-8.65200764818356,8.65200764818356
"02","164","050","Lake and Peninsula Borough",1476,1508,1639,32,2.1680216802168,2.1680216802168,163,11.0433604336043,11.0433604336043
"02","170","050","Matanuska-Susitna Borough",107081,109794,90848,2713,2.53359606279359,2.53359606279359,-16233,-15.1595521147543,15.1595521147543
"02","180","050","Nome Census Area",10046,9941,9717,-105,-1.04519211626518,1.04519211626518,-329,-3.2749352976309,3.2749352976309
"02","185","050","North Slope Borough",11031,9305,9487,-1726,-15.646813525519,15.646813525519,-1544,-13.9969177771734,13.9969177771734
"02","188","050","Northwest Arctic Borough",7793,7642,7673,-151,-1.9376363403054,1.9376363403054,-120,-1.53984344924933,1.53984344924933
"02","195","050","Petersburg Borough",3398,3282,3353,-116,-3.41377280753384,3.41377280753384,-45,-1.32430841671572,1.32430841671572
"02","198","050","Prince of Wales-Hyder Census Area",5753,6158,6352,405,7.03980531896402,7.03980531896402,599,10.4119589779246,10.4119589779246
"02","220","050","Sitka City and Borough",8458,8413,9225,-45,-0.532040671553559,0.532040671553559,767,9.06833766847955,9.06833766847955
"02","230","050","Skagway Municipality",1240,1173,1111,-67,-5.40322580645161,5.40322580645161,-129,-10.4032258064516,10.4032258064516
"02","240","050","Southeast Fairbanks Census Area",6808,6906,7009,98,1.43948296122209,1.43948296122209,201,2.9524089306698,2.9524089306698
"02","275","050","Wrangell City and Borough",2127,2498,2442,371,17.4424071462153,17.4424071462153,315,14.8095909732017,14.8095909732017
"02","282","050","Yakutat City and Borough",662,609,699,-53,-8.00604229607251,8.00604229607251,37,5.58912386706949,5.58912386706949
"02","290","050","Yukon-Koyukuk Census Area",5343,5116,5644,-227,-4.24854950402396,4.24854950402396,301,5.63353921018155,5.63353921018155
"04","001","050","Apache County",66021,71929,72770,5908,8.94866784810893,8.94866784810893,6749,10.2225049605429,10.2225049605429
"04","003","050","Cochise County",125447,127515,137686,2068,1.64850494631199,1.64850494631199,12239,9.75631143032516,9.75631143032516
"04","005","050","Coconino County",145101,142929,144664,-2172,-1.49688837430479,1.49688837430479,-437,-0.301169530189316,0.301169530189316
"04","007","050","Gila County",53272,54299,55718,1027,1.92784201832107,1.92784201832107,2446,4.59153025979877,4.59153025979877
"04","009","050","Graham County",38533,39140,39876,607,1.57527314250123,1.57527314250123,1343,3.48532426751096,3.48532426751096
"04","011","050","Greenlee County",9563,9363,8658,-200,-2.09139391404371,2.09139391404371,-905,-9.46355746104779,9.46355746104779
"04","012","050","La Paz County",16557,21444,20900,4887,29.516216705925,29.516216705925,4343,26.2305973304343,26.2305973304343
"04","013","050","Maricopa County",4420568,4560260,4216035,139692,3.16004640127694,3.16004640127694,-204533,-4.6268488574319,4.6268488574319
"04","015","050","Mohave County",213267,216539,211708,3272,1.53422704872296,1.53422704872296,-1559,-0.731008547970385,0.731008547970385
"04","017","050","Navajo County",106717,111886,111073,5169,4.84365190175886,4.84365190175886,4356,4.08182388935221,4.08182388935221
"04","019","050","Pima County",1043433,1059005,1043943,15572,1.49238139870984,1.49238139870984,510,0.0488771200450819,0.0488771200450819
"04","021","050","Pinal County",425264,476349,437393,51085,12.012538093984,12.012538093984,12129,2.85211068888972,2.85211068888972
"04","023","050","Santa Cruz County",47669,46824,48934,-845,-1.77264050011538,1.77264050011538,1265,2.65371625165202,2.65371625165202
"04","025","050","Yavapai County",236209,239344,233245,3135,1.3272144583822,1.3272144583822,-2964,-1.25482094247044,1.25482094247044
"04","027","050","Yuma County",203881,217074,213035,13193,6.47093157282925,6.47093157282925,9154,4.48987399512461,4.48987399512461
"05","001","050","Arkansas County",17149,17436,19168,287,1.67356697183509,1.67356697183509,2019,11.7732812408887,11.7732812408887
"05","003","050","Ashley County",19062,19479,21959,417,2.18759836323576,2.18759836323576,2897,15.1977756793621,15.1977756793621
"05","005","050","Baxter County",41627,42249,42368,622,1.49422249981983,1.49422249981983,741,1.7800946501069,1.7800946501069
"05","007","050","Benton County",284333,286700,273532,2367,0.832474598446188,0.832474598446188,-10801,-3.79871488712179,3.79871488712179
"05","009","050","Boone County",37373,37669,37444,296,0.792015626254248,0.792015626254248,71,0.189976721162336,0.189976721162336
"05","011","050","Bradley County",10545,10691,11395,146,1.38454243717402,1.38454243717402,850,8.06069227121859,8.06069227121859
"05","013","050","Calhoun County",4739,5126,5450,387,8.16627980586622,8.16627980586622,711,15.003165224731,15.003165224731
"05","015","050","Carroll County",28260,28355,28095,95,0.336164189667374,0.336164189667374,-165,-0.583864118895966,0.583864118895966
"05","017","050","Chicot County",10208,10008,11815,-200,-1.95924764890282,1.95924764890282,1607,15.7425548589342,15.7425548589342
"05","019","050","Clark County",21446,22196,23470,750,3.49715564674065,3.49715564674065,2024,9.4376573720041,9.4376573720041
"05","021","050","Clay County",14552,14419,16073,-133,-0.913963716327652,0.913963716327652,1521,10.4521715228147,10.4521715228147
"05","023","050","Cleburne County",24711,24987,26576,276,1.11691149690421,1.11691149690421,1865,7.54724616567521,7.54724616567521
"05","025","050","Cleveland County",7550,7964,8848,414,5.48344370860927,5.48344370860927,1298,17.1920529801324,17.1920529801324
"05","027","050","Columbia County",22801,23391,24810,590,2.58760580676286,2.58760580676286,2009,8.81101706065523,8.81101706065523
"05","029","050","Conway County",20715,21029,21670,314,1.51580979966208,1.51580979966208,955,4.61018585566015,4.61018585566015
"05","031","050","Craighead County",111231,111931,113191,700,0.629320962681267,0.629320962681267,1960,1.76209869550755,1.76209869550755
"05","033","050","Crawford County",60133,63460,64433,3327,5.53273576904528,5.53273576904528,4300,7.15081569188299,7.15081569188299
"05","035","050","Crittenden County",48163,47736,51694,-427,-0.886572680273239,0.886572680273239,3531,7.33135394389884,7.33135394389884
"05","037","050","Cross County",16833,16204,18160,-629,-3.73670765757738,3.73670765757738,1327,7.88332442226579,7.88332442226579
"05","039","050","Dallas County",6482,6844,8205,362,5.58469608145634,5.58469608145634,1723,26.5813020672632,26.5813020672632
"05","041","050","Desha County",11395,11191,13096,-204,-1.79025888547609,1.79025888547609,1701,14.9275998244844,14.9275998244844
"05","043","050","Drew County",17350,18028,19107,678,3.90778097982709,3.90778097982709,1757,10.1268011527378,10.1268011527378
"05","045","050","Faulkner County",123498,126699,123688,3201,2.59194480882281,2.59194480882281,190,0.153848645322191,0.153848645322191
"05","047","050","Franklin County",17097,17867,18169,770,4.50371410188922,4.50371410188922,1072,6.27010586652629,6.27010586652629
"05","049","050","Fulton County",12075,12436,12404,361,2.98964803312629,2.98964803312629,329,2.72463768115942,2.72463768115942
"05","051","050","Garland County",100180,99786,97101,-394,-0.393292074266321,0.393292074266321,-3079,-3.07346775803554,3.07346775803554
"05","053","050","Grant County",17958,18421,18675,463,2.57823811114823,2.57823811114823,717,3.99264951553625,3.99264951553625
"05","055","050","Greene County",45736,45563,45899,-173,-0.378257827531922,0.378257827531922,163,0.356393213223719,0.356393213223719
"05","057","050","Hempstead County",20065,21356,22918,1291,6.43408921006728,6.43408921006728,2853,14.2187889359581,14.2187889359581
"05","059","050","Hot Spring County",33040,33817,33374,777,2.35169491525424,2.35169491525424,334,1.01089588377724,1.01089588377724
"05","061","050","Howard County",12785,13145,13849,360,2.81579976535002,2.81579976535002,1064,8.32225263981228,8.32225263981228
"05","063","050","Independence County",37938,37814,37805,-124,-0.326849069534504,0.326849069534504,-133,-0.350571985871685,0.350571985871685
"05","065","050","Izard County",13577,13612,13858,35,0.257788907711571,0.257788907711571,281,2.06967665905576,2.06967665905576
"05","067","050","Jackson County",16755,16686,18062,-69,-0.411817367949866,0.411817367949866,1307,7.80065652044166,7.80065652044166
"05","069","050","Jefferson County",67260,65873,78325,-1387,-2.06214689265537,2.06214689265537,11065,16.4510853404698,16.4510853404698
"05","071","050","Johnson County",25749,26554,26201,805,3.1263350033011,3.1263350033011,452,1.75540797700882,1.75540797700882
"05","073","050","Lafayette County",6308,6610,7732,302,4.78757133798351,4.78757133798351,1424,22.574508560558,22.574508560558
"05","075","050","Lawrence County",16216,16431,17593,215,1.32585101134682,1.32585101134682,1377,8.49161322150962,8.49161322150962
"05","077","050","Lee County",8600,8607,10428,7,0.0813953488372093,0.0813953488372093,1828,21.2558139534884,21.2558139534884
"05","079","050","Lincoln County",12941,12977,14490,36,0.278185611621977,0.278185611621977,1549,11.9697086778456,11.9697086778456
"05","081","050","Little River County",12026,12226,13356,200,1.66306336271412,1.66306336271412,1330,11.0593713620489,11.0593713620489
"05","083","050","Logan County",21131,21426,22511,295,1.39605319199281,1.39605319199281,1380,6.53068950830533,6.53068950830533
"05","085","050","Lonoke County",74015,73896,76231,-119,-0.160778220630953,0.160778220630953,2216,2.99398770519489,2.99398770519489
"05","087","050","Madison County",16521,16620,16030,99,0.599237334301798,0.599237334301798,-491,-2.97197506204225,2.97197506204225
"05","089","050","Marion County",16826,16756,17190,-70,-0.416022821823369,0.416022821823369,364,2.16331867348152,2.16331867348152
"05","091","050","Miller County",42600,43228,44181,628,1.47417840375587,1.47417840375587,1581,3.7112676056338,3.7112676056338
"05","093","050","Mississippi County",40685,40244,46755,-441,-1.08393756912867,1.08393756912867,6070,14.9195035025194,14.9195035025194
"05","095","050","Monroe County",6799,6625,8113,-174,-2.55919988233564,2.55919988233564,1314,19.3263715252243,19.3263715252243
"05","097","050","Montgomery County",8484,9004,9727,520,6.12918434700613,6.12918434700613,1243,14.6511079679396,14.6511079679396
"05","099","050","Nevada County",8310,8129,9076,-181,-2.17809867629362,2.17809867629362,766,9.21780986762936,9.21780986762936
"05","101","050","Newton County",7225,7638,8410,413,5.71626297577855,5.71626297577855,1185,16.401384083045,16.401384083045
"05","103","050","Ouachita County",22650,23233,26074,583,2.57395143487859,2.57395143487859,3424,15.1169977924945,15.1169977924945
"05","105","050","Perry County",10019,10352,10627,333,3.32368499850284,3.32368499850284,608,6.06846990717637,6.06846990717637
"05","107","050","Phillips County",16568,17426,22140,858,5.17865765330758,5.17865765330758,5572,33.631096088846,33.631096088846
"05","109","050","Pike County",10171,10670,11424,499,4.90610559433684,4.90610559433684,1253,12.3193392980041,12.3193392980041
"05","111","050","Poinsett County",22965,23334,24854,369,1.60679294578707,1.60679294578707,1889,8.22556063575005,8.22556063575005
"05","113","050","Polk County",19221,19763,20972,542,2.81983247489725,2.81983247489725,1751,9.1098277925186,9.1098277925186
"05","115","050","Pope County",63381,64295,64224,914,1.44207254540004,1.44207254540004,843,1.33005159274862,1.33005159274862
"05","117","050","Prairie County",8282,8004,8848,-278,-3.35667713112775,3.35667713112775,566,6.83409804395074,6.83409804395074
"05","119","050","Pulaski County",399125,393018,408964,-6107,-1.53009708737864,1.53009708737864,9839,2.46514249921704,2.46514249921704
"05","121","050","Randolph County",18571,18233,18271,-338,-1.82004200096925,1.82004200096925,-300,-1.61542189435141,1.61542189435141
"05","123","050","St. Francis County",23090,24754,28378,1664,7.20658293633608,7.20658293633608,5288,22.9016890428757,22.9016890428757
"05","125","050","Saline County",123416,123638,119185,222,0.179879432164387,0.179879432164387,-4231,-3.42824269138523,3.42824269138523
"05","127","050","Scott County",9836,10150,11440,314,3.19235461569744,3.19235461569744,1604,16.3074420496137,16.3074420496137
"05","129","050","Searcy County",7828,7838,8290,10,0.127746550843127,0.127746550843127,462,5.90189064895248,5.90189064895248
"05","131","050","Sebastian County",127799,127650,132572,-149,-0.116589331684911,0.116589331684911,4773,3.73477100759787,3.73477100759787
"05","133","050","Sevier County",15839,16764,17338,925,5.84001515247175,5.84001515247175,1499,9.46398131195151,9.46398131195151
"05","135","050","Sharp County",17271,17372,17413,101,0.584795321637427,0.584795321637427,142,0.822187481906085,0.822187481906085
"05","137","050","Stone County",12359,12655,12872,296,2.39501577797556,2.39501577797556,513,4.1508212638563,4.1508212638563
"05","139","050","Union County",39054,38320,42649,-734,-1.87944896809546,1.87944896809546,3595,9.20520305218415,9.20520305218415
"05","141","050","Van Buren County",15796,16534,17630,738,4.67206887819701,4.67206887819701,1834,11.6105343124842,11.6105343124842
"05","143","050","Washington County",245871,242313,227695,-3558,-1.44710030869846,1.44710030869846,-18176,-7.39249443814033,7.39249443814033
"05","145","050","White County",76822,78701,80999,1879,2.44591393090521,2.44591393090521,4177,5.43724453932467,5.43724453932467
"05","147","050","Woodruff County",6269,6305,7234,36,0.574254267028234,0.574254267028234,965,15.3932046578402,15.3932046578402
"05","149","050","Yell County",20263,21211,22535,948,4.6784780141144,4.6784780141144,2272,11.2125549030252,11.2125549030252
"06","001","050","Alameda County",1682353,1665644,1593687,-16709,-0.993192272965305,0.993192272965305,-88666,-5.27035645907845,5.27035645907845
"06","003","050","Alpine County",1204,1110,1193,-94,-7.80730897009967,7.80730897009967,-11,-0.913621262458472,0.913621262458472
"06","005","050","Amador County",40474,40045,38761,-429,-1.05993971438454,1.05993971438454,-1713,-4.23234669170332,4.23234669170332
"06","007","050","Butte County",211632,214384,198181,2752,1.30037045437363,1.30037045437363,-13451,-6.35584410675134,6.35584410675134
"06","009","050","Calaveras County",45292,46296,46140,1004,2.21672701580853,2.21672701580853,848,1.87229532809326,1.87229532809326
"06","011","050","Colusa County",21839,21548,22377,-291,-1.33247859334219,1.33247859334219,538,2.46348276019964,2.46348276019964
"06","013","050","Contra Costa County",1165927,1153445,1097802,-12482,-1.07056445214838,1.07056445214838,-68125,-5.84299017005353,5.84299017005353
"06","015","050","Del Norte County",27743,27973,29211,230,0.829037955520311,0.829037955520311,1468,5.29142486392964,5.29142486392964
"06","017","050","El Dorado County",191185,193078,190095,1893,0.990140439888067,0.990140439888067,-1090,-0.570128409655569,0.570128409655569
"06","019","050","Fresno County",1008654,1000999,995837,-7655,-0.758932200734841,0.758932200734841,-12817,-1.27070333335316,1.27070333335316
"06","021","050","Glenn County",28917,28342,29580,-575,-1.988449700868,1.988449700868,663,2.29276895943563,2.29276895943563
"06","023","050","Humboldt County",136463,135268,138667,-1195,-0.87569524339931,0.87569524339931,2204,1.61508980456241,1.61508980456241
"06","025","050","Imperial County",179702,180476,181760,774,0.43071306941492,0.43071306941492,2058,1.14522932410324,1.14522932410324
"06","027","050","Inyo County",19016,18062,18666,-954,-5.01682793437106,5.01682793437106,-350,-1.84055532183424,1.84055532183424
"06","029","050","Kern County",909235,901373,893260,-7862,-0.864682947752781,0.864682947752781,-15975,-1.75697152001408,1.75697152001408
"06","031","050","Kings County",152486,152804,163442,318,0.208543735162572,0.208543735162572,10956,7.184921894469,7.184921894469
"06","033","050","Lake County",68163,64521,62774,-3642,-5.34307468861406,5.34307468861406,-5389,-7.90604873611784,7.90604873611784
"06","035","050","Lassen County",32730,30193,35071,-2537,-7.75129850290254,7.75129850290254,2341,7.15245951726245,7.15245951726245
"06","037","050","Los Angeles County",10014009,9968969,10246007,-45040,-0.449769917322822,0.449769917322822,231998,2.31673448665764,2.31673448665764
"06","039","050","Madera County",156255,157606,156446,1351,0.864612332405363,0.864612332405363,191,0.12223608844517,0.12223608844517
"06","041","050","Marin County",262321,257948,255582,-4373,-1.66704152545927,1.66704152545927,-6739,-2.56898990168534,2.56898990168534
"06","043","050","Mariposa County",17131,17182,18945,51,0.297705913256669,0.297705913256669,1814,10.5889907185804,10.5889907185804
"06","045","050","Mendocino County",91601,86349,89312,-5252,-5.73356186067838,5.73356186067838,-2289,-2.49888101658279,2.49888101658279
"06","047","050","Merced County",281202,278938,271487,-2264,-0.805115184102531,0.805115184102531,-9715,-3.4548118434435,3.4548118434435
"06","049","050","Modoc County",8700,8798,9826,98,1.1264367816092,1.1264367816092,1126,12.9425287356322,12.9425287356322
"06","051","050","Mono County",13195,14512,14471,1317,9.98105342932929,9.98105342932929,1276,9.67032967032967,9.67032967032967
"06","053","050","Monterey County",439035,431854,426825,-7181,-1.63563269443211,1.63563269443211,-12210,-2.78109945676313,2.78109945676313
"06","055","050","Napa County",138019,136493,137819,-1526,-1.10564487498098,1.10564487498098,-200,-0.144907585187547,0.144907585187547
"06","057","050","Nevada County",102241,99675,102146,-2566,-2.50975635997301,2.50975635997301,-95,-0.0929177140286186,0.0929177140286186
"06","059","050","Orange County",3186989,3170769,3202954,-16220,-0.508944335860588,0.508944335860588,15965,0.500943053145147,0.500943053145147
"06","061","050","Placer County",404739,402221,388265,-2518,-0.622129322847564,0.622129322847564,-16474,-4.07027738863811,4.07027738863811
"06","063","050","Plumas County",19790,18991,20483,-799,-4.03739262253664,4.03739262253664,693,3.50176856998484,3.50176856998484
"06","065","050","Riverside County",2418185,2485219,2346160,67034,2.77207905929447,2.77207905929447,-72025,-2.97847352456491,2.97847352456491
"06","067","050","Sacramento County",1585055,1558550,1479802,-26505,-1.6721817224008,1.6721817224008,-105253,-6.64033740154127,6.64033740154127
"06","069","050","San Benito County",64209,63808,61785,-401,-0.624523041941161,0.624523041941161,-2424,-3.77517170490118,3.77517170490118
"06","071","050","San Bernardino County",2181654,2187894,2116370,6240,0.286021523119615,0.286021523119615,-65284,-2.99240851207387,2.99240851207387
"06","073","050","San Diego County",3298634,3334413,3270459,35779,1.08466110517263,1.08466110517263,-28175,-0.854141441578544,0.854141441578544
"06","075","050","San Francisco County",873965,870561,864233,-3404,-0.389489281607387,0.389489281607387,-9732,-1.11354573695743,1.11354573695743
"06","077","050","San Joaquin County",779233,767048,733337,-12185,-1.56371714236948,1.56371714236948,-45896,-5.88989429349116,5.88989429349116
"06","079","050","San Luis Obispo County",282424,282577,284551,153,0.054173866243662,0.054173866243662,2127,0.753122964054046,0.753122964054046
"06","081","050","San Mateo County",764442,760706,744533,-3736,-0.488722493007972,0.488722493007972,-19909,-2.60438332796994,2.60438332796994
"06","083","050","Santa Barbara County",448229,445285,447942,-2944,-0.656807123144643,0.656807123144643,-287,-0.0640297704967773,0.0640297704967773
"06","085","050","Santa Clara County",1936259,1913192,1906615,-23067,-1.19131789703753,1.19131789703753,-29644,-1.53099352927475,1.53099352927475
"06","087","050","Santa Cruz County",270861,270819,266672,-42,-0.0155061082990907,0.0155061082990907,-4189,-1.54654970630692,1.54654970630692
"06","089","050","Shasta County",182155,179278,179354,-2877,-1.57942411682358,1.57942411682358,-2801,-1.53770140814142,1.53770140814142
"06","091","050","Sierra County",3236,2933,3275,-303,-9.36341161928306,9.36341161928306,39,1.20519159456119,1.20519159456119
"06","093","050","Siskiyou County",44076,43381,45553,-695,-1.57682185316272,1.57682185316272,1477,3.3510300390235,3.3510300390235
"06","095","050","Solano County",453491,447406,435218,-6085,-1.34181273718773,1.34181273718773,-18273,-4.02940741933137,4.02940741933137
"06","097","050","Sonoma County",488863,490747,487771,1884,0.385384044200522,0.385384044200522,-1092,-0.223375465109857,0.223375465109857
"06","099","050","Stanislaus County",552878,550391,525511,-2487,-0.449827990985353,0.449827990985353,-27367,-4.94991661813275,4.94991661813275
"06","101","050","Sutter County",99633,96593,96637,-3040,-3.05119789627935,3.05119789627935,-2996,-3.00703582146478,3.00703582146478
"06","103","050","Tehama County",65829,64698,65136,-1131,-1.71808777286606,1.71808777286606,-693,-1.0527275213052,1.0527275213052
"06","105","050","Trinity County",16112,12252,14241,-3860,-23.9572989076465,23.9572989076465,-1871,-11.6124627606753,11.6124627606753
"06","107","050","Tulare County",473117,468274,475838,-4843,-1.02363685938151,1.02363685938151,2721,0.575122009989072,0.575122009989072
"06","109","050","Tuolumne County",55620,54501,56159,-1119,-2.01186623516721,2.01186623516721,539,0.969075871988493,0.969075871988493
"06","111","050","Ventura County",843843,842692,851358,-1151,-0.136399780527894,0.136399780527894,7515,0.890568506226869,0.890568506226869
"06","113","050","Yolo County",216403,220010,213285,3607,1.66679759522742,1.66679759522742,-3118,-1.44083030272224,1.44083030272224
"06","115","050","Yuba County",81575,79800,76267,-1775,-2.17591173766473,2.17591173766473,-5308,-6.5068954949433,6.5068954949433
"08","001","050","Adams County",519572,519385,481273,-187,-0.0359911619563795,0.0359911619563795,-38299,-7.37125942121592,7.37125942121592
"08","003","050","Alamosa County",16376,16226,16486,-150,-0.915974596971177,0.915974596971177,110,0.67171470444553,0.67171470444553
"08","005","050","Arapahoe County",655070,657478,620715,2408,0.367594302898927,0.367594302898927,-34355,-5.24447768940724,5.24447768940724
"08","007","050","Archuleta County",13359,14188,13322,829,6.20555430795718,6.20555430795718,-37,-0.276966838835242,0.276966838835242
"08","009","050","Baca County",3506,3583,3811,77,2.19623502567028,2.19623502567028,305,8.69937250427838,8.69937250427838
"08","011","050","Bent County",5650,5421,6580,-229,-4.05309734513274,4.05309734513274,930,16.4601769911504,16.4601769911504
"08","013","050","Boulder County",330758,327069,320183,-3689,-1.11531693866815,1.11531693866815,-10575,-3.19720157940246,3.19720157940246
"08","014","050","Broomfield County",74112,71878,71992,-2234,-3.01435664939551,3.01435664939551,-2120,-2.86053540587219,2.86053540587219
"08","015","050","Chaffee County",19476,20622,20094,1146,5.8841651263093,5.8841651263093,618,3.17313616759088,3.17313616759088
"08","017","050","Cheyenne County",1748,1802,1874,54,3.08924485125858,3.08924485125858,126,7.20823798627002,7.20823798627002
"08","019","050","Clear Creek County",9397,9596,9287,199,2.11769713738427,2.11769713738427,-110,-1.17058635734809,1.17058635734809
"08","021","050","Conejos County",7461,8165,8458,704,9.43573247553947,9.43573247553947,997,13.3628199973194,13.3628199973194
"08","023","050","Costilla County",3499,3935,3675,436,12.4607030580166,12.4607030580166,176,5.03000857387825,5.03000857387825
"08","025","050","Crowley County",5922,5775,5984,-147,-2.4822695035461,2.4822695035461,62,1.04694360013509,1.04694360013509
"08","027","050","Custer County",4704,5176,4448,472,10.0340136054422,10.0340136054422,-256,-5.4421768707483,5.4421768707483
"08","029","050","Delta County",31196,31103,31808,-93,-0.298115142967047,0.298115142967047,612,1.96178997307347,1.96178997307347
"08","031","050","Denver County",715522,733428,667871,17906,2.50250865801471,2.50250865801471,-47651,-6.65961354088344,6.65961354088344
"08","033","050","Dolores County",2326,2088,2160,-238,-10.2321582115219,10.2321582115219,-166,-7.13671539122958,7.13671539122958
"08","035","050","Douglas County",357978,358691,352762,713,0.199174250931621,0.199174250931621,-5216,-1.45707278100889,1.45707278100889
"08","037","050","Eagle County",55731,55036,54790,-695,-1.24706177890223,1.24706177890223,-941,-1.68846781862877,1.68846781862877
"08","039","050","Elbert County",26062,27187,24471,1125,4.31662957562735,4.31662957562735,-1591,-6.10467347095388,6.10467347095388
"08","041","050","El Paso County",730395,727064,700742,-3331,-0.45605460059283,0.45605460059283,-29653,-4.05985802202918,4.05985802202918
"08","043","050","Fremont County",48939,47921,49385,-1018,-2.08014058317497,2.08014058317497,446,0.911338605202395,0.911338605202395
"08","045","050","Garfield County",61685,60329,58867,-1356,-2.19826538056254,2.19826538056254,-2818,-4.56837156521034,4.56837156521034
"08","047","050","Gilpin County",5808,6244,5608,436,7.5068870523416,7.5068870523416,-200,-3.4435261707989,3.4435261707989
"08","049","050","Grand County",15717,15804,15920,87,0.553540752051918,0.553540752051918,203,1.29159508812114,1.29159508812114
"08","051","050","Gunnison County",16918,17567,16212,649,3.83615084525358,3.83615084525358,-706,-4.17307010284904,4.17307010284904
"08","053","050","Hinsdale County",788,801,878,13,1.6497461928934,1.6497461928934,90,11.4213197969543,11.4213197969543
"08","055","050","Huerfano County",6820,6899,7097,79,1.158357771261,1.158357771261,277,4.06158357771261,4.06158357771261
"08","057","050","Jackson County",1379,1390,1430,11,0.797679477882524,0.797679477882524,51,3.69833212472806,3.69833212472806
"08","059","050","Jefferson County",582910,583411,558722,501,0.0859480880410355,0.0859480880410355,-24188,-4.14952565576161,4.14952565576161
"08","061","050","Kiowa County",1446,1445,1410,-1,-0.0691562932226833,0.0691562932226833,-36,-2.4896265560166,2.4896265560166
"08","063","050","Kit Carson County",7087,7130,8381,43,0.606744743897277,0.606744743897277,1294,18.2587836884436,18.2587836884436
"08","065","050","Lake County",7436,8006,7743,570,7.66541151156536,7.66541151156536,307,4.12856374394836,4.12856374394836
"08","067","050","La Plata County",55638,56551,54245,913,1.64096480822459,1.64096480822459,-1393,-2.50368453215428,2.50368453215428
"08","069","050","Larimer County",359066,359793,334874,727,0.202469740938992,0.202469740938992,-24192,-6.73748001760122,6.73748001760122
"08","071","050","Las Animas County",14555,14415,16311,-140,-0.961868773617314,0.961868773617314,1756,12.0645826176572,12.0645826176572
"08","073","050","Lincoln County",5675,5694,5693,19,0.334801762114537,0.334801762114537,18,0.317180616740088,0.317180616740088
"08","075","050","Logan County",21528,22094,22914,566,2.62913415087328,2.62913415087328,1386,6.438127090301,6.438127090301
"08","077","050","Mesa County",155703,155396,153561,-307,-0.197170253623887,0.197170253623887,-2142,-1.37569603668523,1.37569603668523
"08","079","050","Mineral County",865,775,784,-90,-10.4046242774566,10.4046242774566,-81,-9.36416184971098,9.36416184971098
"08","081","050","Moffat County",13292,13153,13887,-139,-1.04574179957869,1.04574179957869,595,4.47637676798074,4.47637676798074
"08","083","050","Montezuma County",25849,26404,26092,555,2.14708499361677,2.14708499361677,243,0.940075051259236,0.940075051259236
"08","085","050","Montrose County",42679,43191,45099,512,1.19965322523958,1.19965322523958,2420,5.67023594742145,5.67023594742145
"08","087","050","Morgan County",29111,28946,29399,-165,-0.566796056473498,0.566796056473498,288,0.989316753117378,0.989316753117378
"08","089","050","Otero County",18690,18212,18781,-478,-2.55751738897806,2.55751738897806,91,0.48689138576779,0.48689138576779
"08","091","050","Ouray County",4874,4995,4921,121,2.48256052523595,2.48256052523595,47,0.964300369306525,0.964300369306525
"08","093","050","Park County",17390,18915,16595,1525,8.76940770557792,8.76940770557792,-795,-4.57159286946521,4.57159286946521
"08","095","050","Phillips County",4530,4369,4553,-161,-3.55408388520971,3.55408388520971,23,0.507726269315673,0.507726269315673
"08","097","050","Pitkin County",17358,17889,18527,531,3.05910819218804,3.05910819218804,1169,6.73464684871529,6.73464684871529
"08","099","050","Prowers County",11999,12091,12538,92,0.766730560880073,0.766730560880073,539,4.49204100341695,4.49204100341695
"08","101","050","Pueblo County",168162,169551,164527,1389,0.825989224676205,0.825989224676205,-3635,-2.16160607033694,2.16160607033694
"08","103","050","Rio Blanco County",6529,6339,6776,-190,-2.91009342931536,2.91009342931536,247,3.78312145810997,3.78312145810997
"08","105","050","Rio Grande County",11539,11280,12447,-259,-2.24456192044371,2.24456192044371,908,7.86896611491464,7.86896611491464
"08","107","050","Routt County",24829,25549,24935,720,2.89983487051432,2.89983487051432,106,0.426920133714608,0.426920133714608
"08","109","050","Saguache County",6368,6897,6551,529,8.3071608040201,8.3071608040201,183,2.87374371859296,2.87374371859296
"08","111","050","San Juan County",705,746,729,41,5.81560283687943,5.81560283687943,24,3.40425531914894,3.40425531914894
"08","113","050","San Miguel County",8072,8109,7573,37,0.458374628344896,0.458374628344896,-499,-6.1818632309217,6.1818632309217
"08","115","050","Sedgwick County",2404,2255,2401,-149,-6.19800332778702,6.19800332778702,-3,-0.124792013311148,0.124792013311148
"08","117","050","Summit County",31055,30673,29734,-382,-1.23007567219449,1.23007567219449,-1321,-4.2537433585574,4.2537433585574
"08","119","050","Teller County",24710,25460,24818,750,3.03520841764468,3.03520841764468,108,0.437070012140834,0.437070012140834
"08","121","050","Washington County",4817,4867,4922,50,1.03799045048786,1.03799045048786,105,2.1797799460245,2.1797799460245
"08","123","050","Weld County",328981,331780,295281,2799,0.850809013286482,0.850809013286482,-33700,-10.2437526787261,10.2437526787261
"08","125","050","Yuma County",9988,10034,10188,46,0.460552663195835,0.460552663195835,200,2.00240288346015,2.00240288346015
"09","001","050","Fairfield County",957419,943542,956802,-13877,-1.44941765308606,1.44941765308606,-617,-0.0644440939651292,0.0644440939651292
"09","003","050","Hartford County",899498,890395,912167,-9103,-1.01200892053123,1.01200892053123,12669,1.40845227004396,1.40845227004396
"09","005","050","Litchfield County",185186,179937,191952,-5249,-2.83444752843087,2.83444752843087,6766,3.65362392405473,3.65362392405473
"09","007","050","Middlesex County",164245,161950,169842,-2295,-1.39730280982678,1.39730280982678,5597,3.40771408566471,3.40771408566471
"09","009","050","New Haven County",864835,852944,880654,-11891,-1.37494435354721,1.37494435354721,15819,1.82913503731926,1.82913503731926
"09","011","050","New London County",268555,265329,282260,-3226,-1.20124369309825,1.20124369309825,13705,5.10323769805068,5.10323769805068
"09","013","050","Tolland County",149788,150731,159414,943,0.629556439768206,0.629556439768206,9626,6.42641600128181,6.42641600128181
"09","015","050","Windham County",116418,116666,120763,248,0.213025477159889,0.213025477159889,4345,3.73224071878919,3.73224071878919
"10","001","050","Kent County",181851,183244,187386,1393,0.766011734881854,0.766011734881854,5535,3.04370061203953,3.04370061203953
"10","003","050","New Castle County",570719,561505,559744,-9214,-1.6144547491848,1.6144547491848,-10975,-1.92301290127015,1.92301290127015
"10","005","050","Sussex County",237378,240150,234842,2772,1.16775775345651,1.16775775345651,-2536,-1.06833826218099,1.06833826218099
"12","001","050","Alachua County",278468,270997,267185,-7471,-2.68289354611661,2.68289354611661,-11283,-4.05181205739977,4.05181205739977
"12","003","050","Baker County",28259,29531,28920,1272,4.50122084999469,4.50122084999469,661,2.33907781591705,2.33907781591705
"12","005","050","Bay County",175216,172083,179637,-3133,-1.78807871427267,1.78807871427267,4421,2.52317139987216,2.52317139987216
"12","007","050","Bradford County",28303,28555,28742,252,0.890364978977494,0.890364978977494,439,1.55107232448857,1.55107232448857
"12","009","050","Brevard County",606612,607008,575273,396,0.0652806077031117,0.0652806077031117,-31339,-5.1662347596157,5.1662347596157
"12","011","050","Broward County",1944375,1958891,1792934,14516,0.746563805850209,0.746563805850209,-151441,-7.78867245258759,7.78867245258759
"12","013","050","Calhoun County",13648,14107,14556,459,3.36313012895662,3.36313012895662,908,6.65298944900352,6.65298944900352
"12","015","050","Charlotte County",186847,193654,173002,6807,3.64308765995708,3.64308765995708,-13845,-7.40980588395853,7.40980588395853
"12","017","050","Citrus County",153843,152445,147517,-1398,-0.908718628731889,0.908718628731889,-6326,-4.11198429567806,4.11198429567806
"12","019","050","Clay County",218245,221205,211369,2960,1.35627391234622,1.35627391234622,-6876,-3.15058764232858,3.15058764232858
"12","021","050","Collier County",375752,391598,366910,15846,4.21714322212523,4.21714322212523,-8842,-2.35314782090315,2.35314782090315
"12","023","050","Columbia County",69698,72490,69434,2792,4.00585382650865,4.00585382650865,-264,-0.37877700938334,0.37877700938334
"12","027","050","DeSoto County",33976,38395,36938,4419,13.0062396986108,13.0062396986108,2962,8.71791853072757,8.71791853072757
"12","029","050","Dixie County",16759,17043,16871,284,1.69461185034907,1.69461185034907,112,0.668297631123575,0.668297631123575
"12","031","050","Duval County",995567,965591,941719,-29976,-3.01094753040227,3.01094753040227,-53848,-5.40877710892386,5.40877710892386
"12","033","050","Escambia County",321905,321818,314109,-87,-0.0270266072288408,0.0270266072288408,-7796,-2.42183252823038,2.42183252823038
"12","035","050","Flagler County",115378,117821,108564,2443,2.11738806358231,2.11738806358231,-6814,-5.90580526616859,5.90580526616859
"12","037","050","Franklin County",12451,12198,11849,-253,-2.03196530399165,2.03196530399165,-602,-4.83495301582202,4.83495301582202
"12","039","050","Gadsden County",43826,45423,53301,1597,3.64395564276913,3.64395564276913,9475,21.6195865467987,21.6195865467987
"12","041","050","Gilchrist County",17864,18821,17922,957,5.35714285714286,5.35714285714286,58,0.324675324675325,0.324675324675325
"12","043","050","Glades County",12126,14158,13235,2032,16.7573808345703,16.7573808345703,1109,9.14563747319809,9.14563747319809
"12","045","050","Gulf County",14192,13530,17161,-662,-4.66459977452086,4.66459977452086,2969,20.9202367531003,20.9202367531003
"12","047","050","Hamilton County",14004,14529,14996,525,3.74892887746358,3.74892887746358,992,7.08369037417881,7.08369037417881
"12","049","050","Hardee County",25327,26845,28062,1518,5.99360366407391,5.99360366407391,2735,10.7987523196589,10.7987523196589
"12","051","050","Hendry County",39619,42663,40762,3044,7.6831823115172,7.6831823115172,1143,2.88497942906181,2.88497942906181
"12","053","050","Hernando County",194515,197792,183071,3277,1.68470297920469,1.68470297920469,-11444,-5.8833508983883,5.8833508983883
"12","055","050","Highlands County",101235,106575,100352,5340,5.27485553415321,5.27485553415321,-883,-0.87222798439275,0.87222798439275
"12","057","050","Hillsborough County",1459762,1493476,1397654,33714,2.30955457122462,2.30955457122462,-62108,-4.2546661716088,4.2546661716088
"12","059","050","Holmes County",19653,19621,20157,-32,-0.162825013992775,0.162825013992775,504,2.5644939703862,2.5644939703862
"12","061","050","Indian River County",159788,161998,150557,2210,1.38308258442436,1.38308258442436,-9231,-5.77702956417253,5.77702956417253
"12","063","050","Jackson County",47319,46156,50116,-1163,-2.45778651281726,2.45778651281726,2797,5.91094486358545,5.91094486358545
"12","065","050","Jefferson County",14510,14492,15357,-18,-0.124052377670572,0.124052377670572,847,5.83735354927636,5.83735354927636
"12","067","050","Lafayette County",8226,8454,9103,228,2.77169948942378,2.77169948942378,877,10.6613177729151,10.6613177729151
"12","069","050","Lake County",383956,373635,340407,-10321,-2.68806842450697,2.68806842450697,-43549,-11.3421850420361,11.3421850420361
"12","071","050","Lee County",760822,786766,692283,25944,3.409996030609,3.409996030609,-68539,-9.00854601996262,9.00854601996262
"12","073","050","Leon County",292198,295239,297679,3041,1.04073265388538,1.04073265388538,5481,1.87578285956783,1.87578285956783
"12","075","050","Levy County",42915,42087,42790,-828,-1.92939531632296,1.92939531632296,-125,-0.291273447512525,0.291273447512525
"12","077","050","Liberty County",7974,8366,8666,392,4.91597692500627,4.91597692500627,692,8.67820416353148,8.67820416353148
"12","079","050","Madison County",17968,18696,19804,728,4.05164737310775,4.05164737310775,1836,10.2181656277827,10.2181656277827
"12","081","050","Manatee County",399710,409491,378206,9781,2.44702409246704,2.44702409246704,-21504,-5.37990042781016,5.37990042781016
"12","083","050","Marion County",375908,371919,353315,-3989,-1.06116390180576,1.06116390180576,-22593,-6.01024718814178,6.01024718814178
"12","085","050","Martin County",158431,161993,152254,3562,2.24829736604579,2.24829736604579,-6177,-3.89885817800809,3.89885817800809
"12","086","050","Miami-Dade County",2701767,2710533,2641307,8766,0.324454329333358,0.324454329333358,-60460,-2.23779474691933,2.23779474691933
"12","087","050","Monroe County",82874,73938,75226,-8936,-10.7826338779352,10.7826338779352,-7648,-9.22846731182277,9.22846731182277
"12","089","050","Nassau County",90352,90503,88635,151,0.167124136709757,0.167124136709757,-1717,-1.90034531609704,1.90034531609704
"12","091","050","Okaloosa County",211668,212541,194062,873,0.412438346845059,0.412438346845059,-17606,-8.31774288035981,8.31774288035981
"12","093","050","Okeechobee County",39644,42276,40702,2632,6.63908788215115,6.63908788215115,1058,2.66875189183735,2.66875189183735
"12","095","050","Orange County",1429908,1403003,1325536,-26905,-1.88158958478448,1.88158958478448,-104372,-7.29921085832096,7.29921085832096
"12","097","050","Osceola County",388656,382803,353339,-5853,-1.50595899715944,1.50595899715944,-35317,-9.08695607426619,9.08695607426619
"12","099","050","Palm Beach County",1492191,1506359,1383235,14168,0.94947630698751,0.94947630698751,-108956,-7.3017462241764,7.3017462241764
"12","101","050","Pasco County",561891,566648,515541,4757,0.84660548042236,0.84660548042236,-46350,-8.24893084245877,8.24893084245877
"12","103","050","Pinellas County",959107,977106,934830,17999,1.87664150089615,1.87664150089615,-24277,-2.53120871810966,2.53120871810966
"12","105","050","Polk County",725046,740123,665628,15077,2.07945426910844,2.07945426910844,-59418,-8.19506624407279,8.19506624407279
"12","107","050","Putnam County",73321,74708,75071,1387,1.8916817828453,1.8916817828453,1750,2.38676504684879,2.38676504684879
"12","109","050","St. Johns County",273425,275439,253853,2014,0.736582243759715,0.736582243759715,-19572,-7.15808722684466,7.15808722684466
"12","111","050","St. Lucie County",329226,335119,301265,5893,1.78995583580884,1.78995583580884,-27961,-8.4929501315206,8.4929501315206
"12","113","050","Santa Rosa County",188000,188045,176611,45,0.023936170212766,0.023936170212766,-11389,-6.05797872340426,6.05797872340426
"12","115","050","Sarasota County",434006,441731,420447,7725,1.77992930973305,1.77992930973305,-13559,-3.12415035736833,3.12415035736833
"12","117","050","Seminole County",470856,473837,455928,2981,0.633102264811322,0.633102264811322,-14928,-3.17039604465059,3.17039604465059
"12","119","050","Sumter County",129752,137843,134651,8091,6.23574203095135,6.23574203095135,4899,3.77566434428756,3.77566434428756
"12","121","050","Suwannee County",43474,44750,42569,1276,2.93508763858858,2.93508763858858,-905,-2.08170400699269,2.08170400699269
"12","123","050","Taylor County",21796,21592,22980,-204,-0.935951550743256,0.935951550743256,1184,5.43218939254909,5.43218939254909
"12","125","050","Union County",16147,15191,16233,-956,-5.92060444664644,5.92060444664644,86,0.532606676162755,0.532606676162755
"12","127","050","Volusia County",553543,559967,517630,6424,1.16052411465776,1.16052411465776,-35913,-6.48784285954298,6.48784285954298
"12","129","050","Wakulla County",33764,34146,33909,382,1.13138253761403,1.13138253761403,145,0.429451486790665,0.429451486790665
"12","131","050","Walton County",75305,76029,69239,724,0.96142354425337,0.96142354425337,-6066,-8.0552420158024,8.0552420158024
"12","133","050","Washington County",25318,25854,25459,536,2.11707085867762,2.11707085867762,141,0.556916028122285,0.556916028122285
"13","001","050","Appling County",18444,18393,18477,-51,-0.2765126870527,0.2765126870527,33,0.178919973975277,0.178919973975277
"13","003","050","Atkinson County",8286,8401,8351,115,1.38788317644219,1.38788317644219,65,0.784455708423847,0.784455708423847
"13","005","050","Bacon County",11140,11069,11164,-71,-0.637342908438061,0.637342908438061,24,0.215439856373429,0.215439856373429
"13","007","050","Baker County",2876,2998,3476,122,4.24200278164117,4.24200278164117,600,20.8623087621697,20.8623087621697
"13","009","050","Baldwin County",43799,45140,47180,1341,3.06171373775657,3.06171373775657,3381,7.71935432315806,7.71935432315806
"13","011","050","Banks County",18035,19353,19114,1318,7.30801219850291,7.30801219850291,1079,5.98281120044358,5.98281120044358
"13","013","050","Barrow County",83505,85159,79746,1654,1.98071971738219,1.98071971738219,-3759,-4.50152685467936,4.50152685467936
"13","015","050","Bartow County",108901,109089,107882,188,0.172633860111477,0.172633860111477,-1019,-0.935712252412742,0.935712252412742
"13","017","050","Ben Hill County",17194,16677,17900,-517,-3.00686285913691,3.00686285913691,706,4.10608351750611,4.10608351750611
"13","019","050","Berrien County",18160,19420,19637,1260,6.93832599118943,6.93832599118943,1477,8.13325991189427,8.13325991189427
"13","021","050","Bibb County",157346,152985,156219,-4361,-2.77159889669899,2.77159889669899,-1127,-0.716255894652549,0.716255894652549
"13","023","050","Bleckley County",12583,12970,13134,387,3.07557816101089,3.07557816101089,551,4.37892394500517,4.37892394500517
"13","025","050","Brantley County",18021,19224,18739,1203,6.67554519726985,6.67554519726985,718,3.98424060817935,3.98424060817935
"13","027","050","Brooks County",16301,15425,16664,-876,-5.37390344150666,5.37390344150666,363,2.22685724802159,2.22685724802159
"13","029","050","Bryan County",44738,40509,40124,-4229,-9.45281416245697,9.45281416245697,-4614,-10.3133801242791,10.3133801242791
"13","031","050","Bulloch County",81099,80632,78553,-467,-0.575839406157906,0.575839406157906,-2546,-3.13937286526344,3.13937286526344
"13","033","050","Burke County",24596,22657,24128,-1939,-7.88339567409335,7.88339567409335,-468,-1.90274841437632,1.90274841437632
"13","035","050","Butts County",25434,25322,24216,-112,-0.440355429739718,0.440355429739718,-1218,-4.78886529841944,4.78886529841944
"13","037","050","Calhoun County",5573,6220,6680,647,11.60954602548,11.60954602548,1107,19.8636282074287,19.8636282074287
"13","039","050","Camden County",54768,55294,54576,526,0.960414840782939,0.960414840782939,-192,-0.35056967572305,0.35056967572305
"13","043","050","Candler County",10981,10962,11100,-19,-0.173026136053183,0.173026136053183,119,1.0836900100173,1.0836900100173
"13","045","050","Carroll County",119148,121327,115110,2179,1.82881794071239,1.82881794071239,-4038,-3.38906234263269,3.38906234263269
"13","047","050","Catoosa County",67872,67958,67184,86,0.126709099481377,0.126709099481377,-688,-1.01367279585101,1.01367279585101
"13","049","050","Charlton County",12518,13410,12453,892,7.12573893593226,7.12573893593226,-65,-0.519252276721521,0.519252276721521
"13","051","050","Chatham County",295291,289846,284861,-5445,-1.84394377072109,1.84394377072109,-10430,-3.53210900433809,3.53210900433809
"13","053","050","Chattahoochee County",9565,10696,11113,1131,11.8243596445374,11.8243596445374,1548,16.1840041819132,16.1840041819132
"13","055","050","Chattooga County",24965,24872,26188,-93,-0.372521530142199,0.372521530142199,1223,4.89885840176247,4.89885840176247
"13","057","050","Cherokee County",266620,263935,258355,-2685,-1.00705123396594,1.00705123396594,-8265,-3.09991748555997,3.09991748555997
"13","059","050","Clarke County",128671,127996,124589,-675,-0.524593731299205,0.524593731299205,-4082,-3.1724320165383,3.1724320165383
"13","061","050","Clay County",2848,2881,3231,33,1.15870786516854,1.15870786516854,383,13.4480337078652,13.4480337078652
"13","063","050","Clayton County",297595,292796,264742,-4799,-1.61259429761925,1.61259429761925,-32853,-11.0394999915993,11.0394999915993
"13","065","050","Clinch County",6749,6595,6826,-154,-2.28181952881908,2.28181952881908,77,1.14090976440954,1.14090976440954
"13","067","050","Cobb County",766149,762910,737685,-3239,-0.422763718284563,0.422763718284563,-28464,-3.71520422267731,3.71520422267731
"13","069","050","Coffee County",43092,43277,43361,185,0.429314025805254,0.429314025805254,269,0.624245799684396,0.624245799684396
"13","071","050","Colquitt County",45898,45589,46756,-309,-0.673231949104536,0.673231949104536,858,1.86936249945531,1.86936249945531
"13","073","050","Columbia County",156010,159669,155511,3659,2.34536247676431,2.34536247676431,-499,-0.319851291583873,0.319851291583873
"13","075","050","Cook County",17229,17302,17779,73,0.423704219629694,0.423704219629694,550,3.19229206570318,3.19229206570318
"13","077","050","Coweta County",146158,150338,145839,4180,2.85991871809959,2.85991871809959,-319,-0.218256954802337,0.218256954802337
"13","079","050","Crawford County",12130,12288,13001,158,1.30255564715581,1.30255564715581,871,7.1805441055235,7.1805441055235
"13","081","050","Crisp County",20128,22129,23629,2001,9.94137519872814,9.94137519872814,3501,17.393680445151,17.393680445151
"13","083","050","Dade County",16251,16089,16731,-162,-0.996861731585749,0.996861731585749,480,2.9536643898837,2.9536643898837
"13","085","050","Dawson County",26798,26889,26732,91,0.339577580416449,0.339577580416449,-66,-0.246287036345996,0.246287036345996
"13","087","050","Decatur County",29367,26485,28149,-2882,-9.8137365069636,9.8137365069636,-1218,-4.14751251404638,4.14751251404638
"13","089","050","DeKalb County",764382,762044,723365,-2338,-0.305868008404175,0.305868008404175,-41017,-5.36603426035673,5.36603426035673
"13","091","050","Dodge County",19925,20528,21907,603,3.02634880803011,3.02634880803011,1982,9.94730238393977,9.94730238393977
"13","093","050","Dooly County",11208,13246,14675,2038,18.1834403997145,18.1834403997145,3467,30.9332619557459,30.9332619557459
"13","095","050","Dougherty County",85790,86899,94112,1109,1.29269145588064,1.29269145588064,8322,9.70043128569763,9.70043128569763
"13","097","050","Douglas County",144237,147753,137692,3516,2.43765469331725,2.43765469331725,-6545,-4.53767063929505,4.53767063929505
"13","099","050","Early County",10854,10079,11026,-775,-7.14022480191634,7.14022480191634,172,1.58466924636079,1.58466924636079
"13","101","050","Echols County",3697,3986,4189,289,7.81714903976197,7.81714903976197,492,13.3080876386259,13.3080876386259
"13","103","050","Effingham County",64769,65432,64543,663,1.02363785144128,1.02363785144128,-226,-0.348932359616483,0.348932359616483
"13","105","050","Elbert County",19637,19330,20375,-307,-1.56337526098691,1.56337526098691,738,3.75821153944085,3.75821153944085
"13","107","050","Emanuel County",22768,22537,22542,-231,-1.01458186929023,1.01458186929023,-226,-0.992621222768798,0.992621222768798
"13","109","050","Evans County",10774,10658,11310,-116,-1.07666604789308,1.07666604789308,536,4.9749396695749,4.9749396695749
"13","111","050","Fannin County",25319,26423,26244,1104,4.36036178364074,4.36036178364074,925,3.65338283502508,3.65338283502508
"13","113","050","Fayette County",119194,115609,114483,-3585,-3.00770172995285,3.00770172995285,-4711,-3.95238015336342,3.95238015336342
"13","115","050","Floyd County",98584,98605,97190,21,0.0213016310963239,0.0213016310963239,-1394,-1.41402255944169,1.41402255944169
"13","117","050","Forsyth County",251283,249437,243656,-1846,-0.734629879458618,0.734629879458618,-7627,-3.03522323436126,3.03522323436126
"13","119","050","Franklin County",23424,23479,22675,55,0.234801912568306,0.234801912568306,-749,-3.19757513661202,3.19757513661202
"13","121","050","Fulton County",1066710,1074999,1037608,8289,0.777062181848862,0.777062181848862,-29102,-2.72820166680729,2.72820166680729
"13","123","050","Gilmer County",31353,31904,30076,551,1.75740758460115,1.75740758460115,-1277,-4.07297547284151,4.07297547284151
"13","125","050","Glascock County",2884,2978,3120,94,3.25936199722607,3.25936199722607,236,8.18307905686546,8.18307905686546
"13","127","050","Glynn County",84499,85583,86536,1084,1.28285541840732,1.28285541840732,2037,2.41067941632445,2.41067941632445
"13","129","050","Gordon County",57544,58630,57062,1086,1.88725149450855,1.88725149450855,-482,-0.837619908244126,0.837619908244126
"13","131","050","Grady County",26236,24541,25493,-1695,-6.46058850434517,6.46058850434517,-743,-2.83198658332063,2.83198658332063
"13","133","050","Greene County",18915,18749,19943,-166,-0.877610362146445,0.877610362146445,1028,5.43484007401533,5.43484007401533
"13","135","050","Gwinnett County",957062,941951,882080,-15111,-1.57889457527308,1.57889457527308,-74982,-7.83460214698734,7.83460214698734
"13","137","050","Habersham County",46031,45949,44764,-82,-0.178140818144294,0.178140818144294,-1267,-2.75249288522952,2.75249288522952
"13","139","050","Hall County",203136,206130,201803,2994,1.47388941398866,1.47388941398866,-1333,-0.656210617517328,0.656210617517328
"13","141","050","Hancock County",8735,8500,9602,-235,-2.69032627361191,2.69032627361191,867,9.92558672009159,9.92558672009159
"13","143","050","Haralson County",29919,30262,29623,343,1.14642869079849,1.14642869079849,-296,-0.989337878939804,0.989337878939804
"13","145","050","Harris County",34668,35886,35110,1218,3.51332641052267,3.51332641052267,442,1.27495096342448,1.27495096342448
"13","147","050","Hart County",25828,26387,25969,559,2.16431779464147,2.16431779464147,141,0.545919157503485,0.545919157503485
"13","149","050","Heard County",11412,11936,12124,524,4.59165790396074,4.59165790396074,712,6.23904661759551,6.23904661759551
"13","151","050","Henry County",240712,238157,228757,-2555,-1.06143441124663,1.06143441124663,-11955,-4.96651600252584,4.96651600252584
"13","153","050","Houston County",163633,159504,157885,-4129,-2.52332964622051,2.52332964622051,-5748,-3.51273887296572,3.51273887296572
"13","155","050","Irwin County",9666,9396,9747,-270,-2.79329608938547,2.79329608938547,81,0.837988826815642,0.837988826815642
"13","157","050","Jackson County",75907,75436,69867,-471,-0.62049613342643,0.62049613342643,-6040,-7.95710540529859,7.95710540529859
"13","159","050","Jasper County",14588,14427,14956,-161,-1.10364683301344,1.10364683301344,368,2.52262133260214,2.52262133260214
"13","161","050","Jeff Davis County",14779,15194,15199,415,2.80803843291156,2.80803843291156,420,2.8418702212599,2.8418702212599
"13","163","050","Jefferson County",15709,15301,16888,-408,-2.5972372525304,2.5972372525304,1179,7.50525176650328,7.50525176650328
"13","165","050","Jenkins County",8674,8745,8453,71,0.818538160018446,0.818538160018446,-221,-2.5478441318884,2.5478441318884
"13","167","050","Johnson County",9189,9692,10007,503,5.47393622809881,5.47393622809881,818,8.90194798128197,8.90194798128197
"13","169","050","Jones County",28347,28765,29492,418,1.47458284827319,1.47458284827319,1145,4.03922813701626,4.03922813701626
"13","171","050","Lamar County",18500,19204,18941,704,3.80540540540541,3.80540540540541,441,2.38378378378378,2.38378378378378
"13","173","050","Lanier County",9877,10676,10633,799,8.0895008605852,8.0895008605852,756,7.6541459957477,7.6541459957477
"13","175","050","Laurens County",49570,47541,49114,-2029,-4.09320153318539,4.09320153318539,-456,-0.919911236635062,0.919911236635062
"13","177","050","Lee County",33163,30203,32026,-2960,-8.92560986641739,8.92560986641739,-1137,-3.42851973585019,3.42851973585019
"13","179","050","Liberty County",65256,62969,69584,-2287,-3.50465857545666,3.50465857545666,4328,6.63234032119652,6.63234032119652
"13","181","050","Lincoln County",7690,8008,8270,318,4.13524057217165,4.13524057217165,580,7.54226267880364,7.54226267880364
"13","183","050","Long County",16168,20048,17544,3880,23.9980207817912,23.9980207817912,1376,8.51063829787234,8.51063829787234
"13","185","050","Lowndes County",118251,118154,125151,-97,-0.0820289046181428,0.0820289046181428,6900,5.83504579242459,5.83504579242459
"13","187","050","Lumpkin County",33488,34064,32498,576,1.72001911132346,1.72001911132346,-990,-2.9562828475872,2.9562828475872
"13","189","050","McDuffie County",21632,21195,22081,-437,-2.02015532544379,2.02015532544379,449,2.07562869822485,2.07562869822485
"13","191","050","McIntosh County",10975,14376,15154,3401,30.9886104783599,30.9886104783599,4179,38.0774487471526,38.0774487471526
"13","193","050","Macon County",12082,12766,14676,684,5.66131435192849,5.66131435192849,2594,21.469955305413,21.469955305413
"13","195","050","Madison County",30120,30319,28759,199,0.660690571049137,0.660690571049137,-1361,-4.51859229747676,4.51859229747676
"13","197","050","Marion County",7498,8486,8944,988,13.1768471592425,13.1768471592425,1446,19.2851427047213,19.2851427047213
"13","199","050","Meriwether County",20613,21166,22356,553,2.68277300732547,2.68277300732547,1743,8.45582884587396,8.45582884587396
"13","201","050","Miller County",6000,5641,6039,-359,-5.98333333333333,5.98333333333333,39,0.65,0.65
"13","205","050","Mitchell County",21755,21676,23743,-79,-0.363134911514594,0.363134911514594,1988,9.13812916570903,9.13812916570903
"13","207","050","Monroe County",27957,27943,28371,-14,-0.0500769038165755,0.0500769038165755,414,1.48084558429016,1.48084558429016
"13","209","050","Montgomery County",8610,9052,9352,442,5.1335656213705,5.1335656213705,742,8.61788617886179,8.61788617886179
"13","211","050","Morgan County",20097,19538,19333,-559,-2.7815096780614,2.7815096780614,-764,-3.80156242225208,3.80156242225208
"13","213","050","Murray County",39973,40015,40474,42,0.105070922872939,0.105070922872939,501,1.25334600855578,1.25334600855578
"13","215","050","Muscogee County",206922,196455,197184,-10467,-5.05842781337895,5.05842781337895,-9738,-4.70612114709891,4.70612114709891
"13","217","050","Newton County",112483,112995,106085,512,0.455179893850626,0.455179893850626,-6398,-5.68797062667247,5.68797062667247
"13","219","050","Oconee County",41799,40921,40073,-878,-2.10052872078279,2.10052872078279,-1726,-4.12928538960262,4.12928538960262
"13","221","050","Oglethorpe County",14825,15341,15595,516,3.48060708263069,3.48060708263069,770,5.19392917369309,5.19392917369309
"13","223","050","Paulding County",168661,172398,166097,3737,2.21568708830139,2.21568708830139,-2564,-1.52020917698816,1.52020917698816
"13","225","050","Peach County",27981,27884,29746,-97,-0.346663807583718,0.346663807583718,1765,6.30785175654909,6.30785175654909
"13","227","050","Pickens County",33216,32998,30813,-218,-0.65631021194605,0.65631021194605,-2403,-7.23446531791908,7.23446531791908
"13","229","050","Pierce County",19716,19494,19575,-222,-1.12598904443092,1.12598904443092,-141,-0.715155203895313,0.715155203895313
"13","231","050","Pike County",18889,19089,19027,200,1.0588173010747,1.0588173010747,138,0.730583937741543,0.730583937741543
"13","233","050","Polk County",42853,42779,42154,-74,-0.172683359391408,0.172683359391408,-699,-1.6311576785756,1.6311576785756
"13","235","050","Pulaski County",9855,11170,12082,1315,13.3434804667681,13.3434804667681,2227,22.59766615931,22.59766615931
"13","237","050","Putnam County",22047,22424,22305,377,1.70998321767134,1.70998321767134,258,1.17022724180161,1.17022724180161
"13","239","050","Quitman County",2235,2279,2553,44,1.96868008948546,1.96868008948546,318,14.2281879194631,14.2281879194631
"13","241","050","Rabun County",16883,17231,16890,348,2.06124503938873,2.06124503938873,7,0.0414618255049458,0.0414618255049458
"13","243","050","Randolph County",6425,6719,7617,294,4.57587548638132,4.57587548638132,1192,18.5525291828794,18.5525291828794
"13","245","050","Richmond County",206607,202314,208259,-4293,-2.07785796221812,2.07785796221812,1652,0.799585686835393,0.799585686835393
"13","247","050","Rockdale County",93570,90897,87770,-2673,-2.85668483488298,2.85668483488298,-5800,-6.19856791706744,6.19856791706744
"13","249","050","Schley County",4547,5214,5074,667,14.6690125357378,14.6690125357378,527,11.5900593798109,11.5900593798109
"13","251","050","Screven County",14067,13985,14822,-82,-0.582924575247032,0.582924575247032,755,5.3671713940428,5.3671713940428
"13","253","050","Seminole County",9147,8064,8805,-1083,-11.8399475237783,11.8399475237783,-342,-3.73893079698262,3.73893079698262
"13","255","050","Spalding County",67306,67299,67129,-7,-0.0104002614922889,0.0104002614922889,-177,-0.262978040590735,0.262978040590735
"13","257","050","Stephens County",26784,26076,26088,-708,-2.64336917562724,2.64336917562724,-696,-2.59856630824373,2.59856630824373
"13","259","050","Stewart County",5314,6678,5951,1364,25.6680466691758,25.6680466691758,637,11.9872036130975,11.9872036130975
"13","261","050","Sumter County",29616,29318,32678,-298,-1.00621285791464,1.00621285791464,3062,10.3390059427337,10.3390059427337
"13","263","050","Talbot County",5733,6152,6969,419,7.30856445142159,7.30856445142159,1236,21.5593929879644,21.5593929879644
"13","265","050","Taliaferro County",1559,1556,1734,-3,-0.192431045542014,0.192431045542014,175,11.2251443232842,11.2251443232842
"13","267","050","Tattnall County",22842,25354,25870,2512,10.9972857017774,10.9972857017774,3028,13.2562822870151,13.2562822870151
"13","269","050","Taylor County",7816,8068,9124,252,3.22415557830092,3.22415557830092,1308,16.7349027635619,16.7349027635619
"13","271","050","Telfair County",12477,15783,16524,3306,26.4967540274104,26.4967540274104,4047,32.4356816542438,32.4356816542438
"13","273","050","Terrell County",9185,8541,9512,-644,-7.01143168209036,7.01143168209036,327,3.56015242242787,3.56015242242787
"13","275","050","Thomas County",45798,44381,46397,-1417,-3.09402157299445,3.09402157299445,599,1.30791737630464,1.30791737630464
"13","277","050","Tift County",41344,40687,41719,-657,-1.5891060371517,1.5891060371517,375,0.90702399380805,0.90702399380805
"13","279","050","Toombs County",27030,26923,27483,-107,-0.395856455789863,0.395856455789863,453,1.67591564927858,1.67591564927858
"13","281","050","Towns County",12493,12192,11384,-301,-2.40934923557192,2.40934923557192,-1109,-8.87697110381814,8.87697110381814
"13","283","050","Treutlen County",6406,6837,6980,431,6.72806743677802,6.72806743677802,574,8.96034967218233,8.96034967218233
"13","285","050","Troup County",69426,70198,69351,772,1.11197534065048,1.11197534065048,-75,-0.108028692420707,0.108028692420707
"13","287","050","Turner County",9006,7891,9163,-1115,-12.3806351321341,12.3806351321341,157,1.7432822562736,1.7432822562736
"13","289","050","Twiggs County",8022,8109,9120,87,1.08451757666417,1.08451757666417,1098,13.6873597606582,13.6873597606582
"13","291","050","Union County",24632,25170,23064,538,2.18415069827866,2.18415069827866,-1568,-6.3657031503735,6.3657031503735
"13","293","050","Upson County",27700,26491,27156,-1209,-4.36462093862816,4.36462093862816,-544,-1.96389891696751,1.96389891696751
"13","295","050","Walker County",67654,70029,70055,2375,3.51050935643125,3.51050935643125,2401,3.54894019570166,3.54894019570166
"13","297","050","Walton County",96673,96389,91275,-284,-0.293773856195629,0.293773856195629,-5398,-5.58377209769015,5.58377209769015
"13","299","050","Ware County",36251,35806,37606,-445,-1.22755234338363,1.22755234338363,1355,3.73782792198836,3.73782792198836
"13","301","050","Warren County",5215,5223,5848,8,0.153403643336529,0.153403643336529,633,12.1380632790029,12.1380632790029
"13","303","050","Washington County",19988,20202,22399,214,1.07064238543126,1.07064238543126,2411,12.0622373424054,12.0622373424054
"13","305","050","Wayne County",30144,30001,30563,-143,-0.474389596602972,0.474389596602972,419,1.38999469214437,1.38999469214437
"13","307","050","Webster County",2348,2585,2849,237,10.0936967632027,10.0936967632027,501,21.3373083475298,21.3373083475298
"13","309","050","Wheeler County",7471,7773,7451,302,4.04229688127426,4.04229688127426,-20,-0.267701780216838,0.267701780216838
"13","311","050","White County",28003,30972,27918,2969,10.6024354533443,10.6024354533443,-85,-0.303538906545727,0.303538906545727
"13","313","050","Whitfield County",102864,103975,104284,1111,1.08006688442993,1.08006688442993,1420,1.38046352465391,1.38046352465391
"13","315","050","Wilcox County",8766,8526,9333,-240,-2.7378507871321,2.7378507871321,567,6.46817248459959,6.46817248459959
"13","317","050","Wilkes County",9565,9700,10624,135,1.41139571353894,1.41139571353894,1059,11.0716152639833,11.0716152639833
"13","319","050","Wilkinson County",8877,8846,9595,-31,-0.349217077841613,0.349217077841613,718,8.08831812549285,8.08831812549285
"13","321","050","Worth County",20784,20017,22007,-767,-3.69033872209392,3.69033872209392,1223,5.88433410315627,5.88433410315627
"15","001","050","Hawaii County",200629,203242,202403,2613,1.30240393960993,1.30240393960993,1774,0.884219130833529,0.884219130833529
"15","003","050","Honolulu County",1016508,967285,1008007,-49223,-4.84236228342522,4.84236228342522,-8501,-0.836294451199597,0.836294451199597
"15","005","050","Kalawao County",82,90,89,8,9.75609756097561,9.75609756097561,7,8.53658536585366,8.53658536585366
"15","007","050","Kauai County",73298,71994,71394,-1304,-1.77903899151409,1.77903899151409,-1904,-2.5976152146034,2.5976152146034
"15","009","050","Maui County",164754,167976,165059,3222,1.95564295859281,1.95564295859281,305,0.185124488631535,0.185124488631535
"16","001","050","Ada County",494967,491505,486890,-3462,-0.69944056876519,0.69944056876519,-8077,-1.63182596011451,1.63182596011451
"16","003","050","Adams County",4379,4416,4082,37,0.844941767526833,0.844941767526833,-297,-6.78237040420187,6.78237040420187
"16","005","050","Bannock County",87018,88632,87579,1614,1.85478866441426,1.85478866441426,561,0.644694201199752,0.644694201199752
"16","007","050","Bear Lake County",6372,6155,6495,-217,-3.40552416823603,3.40552416823603,123,1.93032015065913,1.93032015065913
"16","009","050","Benewah County",9530,9424,9672,-106,-1.11227701993704,1.11227701993704,142,1.4900314795383,1.4900314795383
"16","011","050","Bingham County",47992,47151,48583,-841,-1.75237539589932,1.75237539589932,591,1.23145524254042,1.23145524254042
"16","013","050","Blaine County",24272,23357,22268,-915,-3.76977587343441,3.76977587343441,-2004,-8.25642715886618,8.25642715886618
"16","015","050","Boise County",7610,8048,7643,438,5.75558475689882,5.75558475689882,33,0.433639947437582,0.433639947437582
"16","017","050","Bonner County",47110,46609,42179,-501,-1.06346847803014,1.06346847803014,-4931,-10.4669921460412,10.4669921460412
"16","019","050","Bonneville County",123964,121481,118635,-2483,-2.00300087122068,2.00300087122068,-5329,-4.29882869220096,4.29882869220096
"16","021","050","Boundary County",12056,12609,11964,553,4.58692767086928,4.58692767086928,-92,-0.763105507631055,0.763105507631055
"16","023","050","Butte County",2574,2636,2951,62,2.40870240870241,2.40870240870241,377,14.6464646464646,14.6464646464646
"16","025","050","Camas County",1077,1122,1183,45,4.17827298050139,4.17827298050139,106,9.84215413184772,9.84215413184772
"16","027","050","Canyon County",231105,235471,224668,4366,1.8891845697843,1.8891845697843,-6437,-2.78531403474611,2.78531403474611
"16","029","050","Caribou County",7027,7139,7215,112,1.59385228404725,1.59385228404725,188,2.67539490536502,2.67539490536502
"16","031","050","Cassia County",24655,24259,24637,-396,-1.60616507807747,1.60616507807747,-18,-0.0730075035489759,0.0730075035489759
"16","033","050","Clark County",790,837,1045,47,5.94936708860759,5.94936708860759,255,32.2784810126582,32.2784810126582
"16","035","050","Clearwater County",8734,8838,9229,104,1.19074879780169,1.19074879780169,495,5.66750629722922,5.66750629722922
"16","037","050","Custer County",4275,4259,4480,-16,-0.374269005847953,0.374269005847953,205,4.7953216374269,4.7953216374269
"16","039","050","Elmore County",28666,27459,28087,-1207,-4.21056303634968,4.21056303634968,-579,-2.0198144142887,2.0198144142887
"16","041","050","Franklin County",14194,14139,14153,-55,-0.387487670846837,0.387487670846837,-41,-0.288854445540369,0.288854445540369
"16","043","050","Fremont County",13388,13200,14419,-188,-1.4042426053182,1.4042426053182,1031,7.70092620256947,7.70092620256947
"16","045","050","Gem County",19123,18580,17932,-543,-2.83951262877164,2.83951262877164,-1191,-6.2281022852063,6.2281022852063
"16","047","050","Gooding County",15598,15542,16050,-56,-0.359020387229132,0.359020387229132,452,2.89780741120656,2.89780741120656
"16","049","050","Idaho County",16541,16784,16349,243,1.46907683936884,1.46907683936884,-192,-1.16075207061242,1.16075207061242
"16","051","050","Jefferson County",30891,30422,29863,-469,-1.51824155903014,1.51824155903014,-1028,-3.32783011233045,3.32783011233045
"16","053","050","Jerome County",24237,24573,24106,336,1.38631018690432,1.38631018690432,-131,-0.540495935965672,0.540495935965672
"16","055","050","Kootenai County",171362,169445,167739,-1917,-1.11868442245072,1.11868442245072,-3623,-2.11423769563847,2.11423769563847
"16","057","050","Latah County",39517,40732,40656,1215,3.07462611028165,3.07462611028165,1139,2.88230381860971,2.88230381860971
"16","059","050","Lemhi County",7974,8062,8367,88,1.10358665663406,1.10358665663406,393,4.92851768246802,4.92851768246802
"16","061","050","Lewis County",3533,3836,4051,303,8.57628078120577,8.57628078120577,518,14.6617605434475,14.6617605434475
"16","063","050","Lincoln County",5127,5341,5352,214,4.17398088550809,4.17398088550809,225,4.38853130485664,4.38853130485664
"16","065","050","Madison County",52913,40266,52020,-12647,-23.9014986865232,23.9014986865232,-893,-1.687675996447,1.687675996447
"16","067","050","Minidoka County",21613,21133,22369,-480,-2.22088557812428,2.22088557812428,756,3.49789478554574,3.49789478554574
"16","069","050","Nez Perce County",42090,40710,40693,-1380,-3.27868852459016,3.27868852459016,-1397,-3.31907816583512,3.31907816583512
"16","071","050","Oneida County",4564,4512,4569,-52,-1.13935144609991,1.13935144609991,5,0.109553023663453,0.109553023663453
"16","073","050","Owyhee County",11913,12047,12138,134,1.12482162343658,1.12482162343658,225,1.8886930244271,1.8886930244271
"16","075","050","Payette County",25386,24559,24468,-827,-3.25770109509178,3.25770109509178,-918,-3.61616639092413,3.61616639092413
"16","077","050","Power County",7878,7640,8130,-238,-3.02107133790302,3.02107133790302,252,3.1987814166032,3.1987814166032
"16","079","050","Shoshone County",13169,12869,13006,-300,-2.27807730275647,2.27807730275647,-163,-1.23775533449768,1.23775533449768
"16","081","050","Teton County",11630,12387,11663,757,6.50902837489252,6.50902837489252,33,0.283748925193465,0.283748925193465
"16","083","050","Twin Falls County",90046,88083,86398,-1963,-2.1799968904782,2.1799968904782,-3648,-4.05126268795949,4.05126268795949
"16","085","050","Valley County",11746,11693,10754,-53,-0.451217435722799,0.451217435722799,-992,-8.44542823088711,8.44542823088711
"16","087","050","Washington County",10500,10276,10637,-224,-2.13333333333333,2.13333333333333,137,1.3047619047619,1.3047619047619
"17","001","050","Adams County",65737,65003,68033,-734,-1.11657057669197,1.11657057669197,2296,3.49270578213183,3.49270578213183
"17","003","050","Alexander County",5240,5585,8139,345,6.58396946564886,6.58396946564886,2899,55.324427480916,55.324427480916
"17","005","050","Bond County",16725,16344,18261,-381,-2.2780269058296,2.2780269058296,1536,9.18385650224215,9.18385650224215
"17","007","050","Boone County",53448,52957,54554,-491,-0.918649902709175,0.918649902709175,1106,2.06930100284389,2.06930100284389
"17","009","050","Brown County",6244,6562,6912,318,5.09288917360666,5.09288917360666,668,10.6982703395259,10.6982703395259
"17","011","050","Bureau County",33244,32425,34838,-819,-2.46360245457827,2.46360245457827,1594,4.79485019853207,4.79485019853207
"17","013","050","Calhoun County",4437,4653,5214,216,4.86815415821501,4.86815415821501,777,17.5118323191346,17.5118323191346
"17","015","050","Carroll County",15702,14287,15463,-1415,-9.01159088014266,9.01159088014266,-239,-1.5220990956566,1.5220990956566
"17","017","050","Cass County",13042,12001,13611,-1041,-7.98190461585646,7.98190461585646,569,4.36282778714921,4.36282778714921
"17","019","050","Champaign County",205865,209481,219301,3616,1.75649090423336,1.75649090423336,13436,6.52660724261045,6.52660724261045
"17","021","050","Christian County",34032,32196,34875,-1836,-5.39492242595205,5.39492242595205,843,2.47708039492243,2.47708039492243
"17","023","050","Clark County",15455,15336,16442,-119,-0.769977353607247,0.769977353607247,987,6.38628275638952,6.38628275638952
"17","025","050","Clay County",13288,13124,13967,-164,-1.23419626730885,1.23419626730885,679,5.10987357013847,5.10987357013847
"17","027","050","Clinton County",36899,37444,39641,545,1.47700479687796,1.47700479687796,2742,7.43109569365023,7.43109569365023
"17","029","050","Coles County",46863,50516,53915,3653,7.79506220259053,7.79506220259053,7052,15.0481189851269,15.0481189851269
"17","031","050","Cook County",5275541,5121283,5260833,-154258,-2.92402238936253,2.92402238936253,-14708,-0.278796051438137,0.278796051438137
"17","033","050","Crawford County",18679,18583,19887,-96,-0.513946142727127,0.513946142727127,1208,6.46715562931634,6.46715562931634
"17","035","050","Cumberland County",10450,10682,11034,232,2.2200956937799,2.2200956937799,584,5.58851674641148,5.58851674641148
"17","037","050","DeKalb County",100420,104743,105843,4323,4.30491933877714,4.30491933877714,5423,5.40031866162119,5.40031866162119
"17","039","050","De Witt County",15516,15453,16699,-63,-0.406032482598608,0.406032482598608,1183,7.62438772879608,7.62438772879608
"17","041","050","Douglas County",19740,19507,20202,-233,-1.18034447821682,1.18034447821682,462,2.34042553191489,2.34042553191489
"17","043","050","DuPage County",932877,919381,933534,-13496,-1.44670733655134,1.44670733655134,657,0.0704272910576635,0.0704272910576635
"17","045","050","Edgar County",16866,16948,18597,82,0.486185224712439,0.486185224712439,1731,10.2632515119175,10.2632515119175
"17","047","050","Edwards County",6245,6378,6743,133,2.12970376301041,2.12970376301041,498,7.97437950360288,7.97437950360288
"17","049","050","Effingham County",34668,34094,35302,-574,-1.65570554978655,1.65570554978655,634,1.82877581631476,1.82877581631476
"17","051","050","Fayette County",21488,21293,22142,-195,-0.907483246463142,0.907483246463142,654,3.04355919583023,3.04355919583023
"17","053","050","Ford County",13534,12968,14241,-566,-4.18205999704448,4.18205999704448,707,5.22388059701492,5.22388059701492
"17","055","050","Franklin County",37804,38202,39827,398,1.05279864564596,1.05279864564596,2023,5.35128557824569,5.35128557824569
"17","057","050","Fulton County",33609,33849,37480,240,0.714094438989556,0.714094438989556,3871,11.5177482222024,11.5177482222024
"17","059","050","Gallatin County",4946,4803,5607,-143,-2.89122523251112,2.89122523251112,661,13.3643348160129,13.3643348160129
"17","061","050","Greene County",11985,12766,13958,781,6.51647893199833,6.51647893199833,1973,16.462244472257,16.462244472257
"17","063","050","Grundy County",52533,51023,53775,-1510,-2.87438372070889,2.87438372070889,1242,2.36422819941751,2.36422819941751
"17","065","050","Hamilton County",7993,8098,8478,105,1.31364944326285,1.31364944326285,485,6.06780933316652,6.06780933316652
"17","067","050","Hancock County",17620,17511,19003,-109,-0.618615209988649,0.618615209988649,1383,7.84903518728717,7.84903518728717
"17","069","050","Hardin County",3649,3818,4310,169,4.63140586462044,4.63140586462044,661,18.1145519320362,18.1145519320362
"17","071","050","Henderson County",6387,6575,7408,188,2.94347894160013,2.94347894160013,1021,15.9855957413496,15.9855957413496
"17","073","050","Henry County",49284,48583,50482,-701,-1.42236831426021,1.42236831426021,1198,2.43080918756594,2.43080918756594
"17","075","050","Iroquois County",27077,26813,29838,-264,-0.974997230121505,0.974997230121505,2761,10.1968460316874,10.1968460316874
"17","077","050","Jackson County",52974,56767,60948,3793,7.16011628345981,7.16011628345981,7974,15.0526673462453,15.0526673462453
"17","079","050","Jasper County",9287,9505,9699,218,2.34736728760633,2.34736728760633,412,4.43630881877894,4.43630881877894
"17","081","050","Jefferson County",37113,37357,39063,244,0.657451566836418,0.657451566836418,1950,5.2542235874222,5.2542235874222
"17","083","050","Jersey County",21512,21635,23851,123,0.571773893640759,0.571773893640759,2339,10.8730011156564,10.8730011156564
"17","085","050","Jo Daviess County",22035,21246,22957,-789,-3.58066712049013,3.58066712049013,922,4.18425232584525,4.18425232584525
"17","087","050","Johnson County",13308,12367,12656,-941,-7.07093477607454,7.07093477607454,-652,-4.89930868650436,4.89930868650436
"17","089","050","Kane County",516522,531666,542508,15144,2.93191771115267,2.93191771115267,25986,5.03095705507219,5.03095705507219
"17","091","050","Kankakee County",107502,108894,114751,1392,1.2948596305185,1.2948596305185,7249,6.74313036036539,6.74313036036539
"17","093","050","Kendall County",131869,130278,122837,-1591,-1.2065003905391,1.2065003905391,-9032,-6.84922157595796,6.84922157595796
"17","095","050","Knox County",49967,49249,52442,-718,-1.43694838593472,1.43694838593472,2475,4.95326915764405,4.95326915764405
"17","097","050","Lake County",714342,694897,718214,-19445,-2.72208549966263,2.72208549966263,3872,0.542037287461748,0.542037287461748
"17","099","050","LaSalle County",109658,107865,114387,-1793,-1.63508362362983,1.63508362362983,4729,4.31249886009229,4.31249886009229
"17","101","050","Lawrence County",15280,15523,17690,243,1.59031413612565,1.59031413612565,2410,15.7722513089005,15.7722513089005
"17","103","050","Lee County",34145,33784,36144,-361,-1.05725582076439,1.05725582076439,1999,5.85444428173964,5.85444428173964
"17","105","050","Livingston County",35815,35468,38998,-347,-0.968867792824236,0.968867792824236,3183,8.88733770766439,8.88733770766439
"17","107","050","Logan County",27987,28448,30092,461,1.64719333976489,1.64719333976489,2105,7.52134919784185,7.52134919784185
"17","109","050","McDonough County",27238,29419,32501,2181,8.00719582935605,8.00719582935605,5263,19.3222703575887,19.3222703575887
"17","111","050","McHenry County",310229,306389,317840,-3840,-1.23779530604811,1.23779530604811,7611,2.45334897769067,2.45334897769067
"17","113","050","McLean County",170954,171347,177336,393,0.229886402190063,0.229886402190063,6382,3.73316798670988,3.73316798670988
"17","115","050","Macon County",103998,103303,110294,-695,-0.668282082347737,0.668282082347737,6296,6.05396257620339,6.05396257620339
"17","117","050","Macoupin County",44967,44717,48324,-250,-0.55596326194765,0.55596326194765,3357,7.46547468143305,7.46547468143305
"17","119","050","Madison County",265859,263013,276515,-2846,-1.07049225341252,1.07049225341252,10656,4.00813965297394,4.00813965297394
"17","121","050","Marion County",37729,37124,39422,-605,-1.60354104269925,1.60354104269925,1693,4.48726443849559,4.48726443849559
"17","123","050","Marshall County",11742,11352,12645,-390,-3.32141032192131,3.32141032192131,903,7.69034236075626,7.69034236075626
"17","125","050","Mason County",13086,13248,14569,162,1.23796423658872,1.23796423658872,1483,11.3327219929696,11.3327219929696
"17","127","050","Massac County",14169,13690,15412,-479,-3.3806196626438,3.3806196626438,1243,8.7726727362552,8.7726727362552
"17","129","050","Menard County",12297,12101,12916,-196,-1.59388468732211,1.59388468732211,619,5.03374806863463,5.03374806863463
"17","131","050","Mercer County",15699,15301,16550,-398,-2.53519332441557,2.53519332441557,851,5.42072743486846,5.42072743486846
"17","133","050","Monroe County",34962,34742,35909,-220,-0.629254619300955,0.629254619300955,947,2.70865511126366,2.70865511126366
"17","135","050","Montgomery County",28288,28132,30246,-156,-0.551470588235294,0.551470588235294,1958,6.9216628959276,6.9216628959276
"17","137","050","Morgan County",32915,33469,35411,554,1.6831231961112,1.6831231961112,2496,7.58316876803889,7.58316876803889
"17","139","050","Moultrie County",14526,14373,15660,-153,-1.05328376703841,1.05328376703841,1134,7.80669144981413,7.80669144981413
"17","141","050","Ogle County",51788,50406,53897,-1382,-2.66857186993126,2.66857186993126,2109,4.07237197806442,4.07237197806442
"17","143","050","Peoria County",181830,178182,187693,-3648,-2.00626959247649,2.00626959247649,5863,3.22444041137326,3.22444041137326
"17","145","050","Perry County",20945,20735,22970,-210,-1.00262592504178,1.00262592504178,2025,9.66817856290284,9.66817856290284
"17","147","050","Piatt County",16673,16357,17185,-316,-1.8952797936784,1.8952797936784,512,3.0708330834283,3.0708330834283
"17","149","050","Pike County",14739,15327,16566,588,3.98941583553837,3.98941583553837,1827,12.3956849175656,12.3956849175656
"17","151","050","Pope County",3763,4148,4500,385,10.2311985118257,10.2311985118257,737,19.5854371512091,19.5854371512091
"17","153","050","Pulaski County",5193,5220,6214,27,0.519930675909879,0.519930675909879,1021,19.6610822260736,19.6610822260736
"17","155","050","Putnam County",5637,5721,6227,84,1.49015433741352,1.49015433741352,590,10.4665602270711,10.4665602270711
"17","157","050","Randolph County",30163,31458,34074,1295,4.29333952193084,4.29333952193084,3911,12.9662168882406,12.9662168882406
"17","159","050","Richland County",15813,15505,16229,-308,-1.94776449756529,1.94776449756529,416,2.63074685385442,2.63074685385442
"17","161","050","Rock Island County",144672,141193,148417,-3479,-2.4047500552975,2.4047500552975,3745,2.58861424463614,2.58861424463614
"17","163","050","St. Clair County",257400,258637,281712,1237,0.480574980574981,0.480574980574981,24312,9.44522144522145,9.44522144522145
"17","165","050","Saline County",23768,23256,24907,-512,-2.15415684954561,2.15415684954561,1139,4.79215752271962,4.79215752271962
"17","167","050","Sangamon County",196343,194189,203000,-2154,-1.09705973729647,1.09705973729647,6657,3.39049520482014,3.39049520482014
"17","169","050","Schuyler County",6902,6763,7508,-139,-2.01390901188061,2.01390901188061,606,8.78006374963778,8.78006374963778
"17","171","050","Scott County",4949,4951,5338,2,0.0404122044857547,0.0404122044857547,389,7.86017377247929,7.86017377247929
"17","173","050","Shelby County",20990,21369,22927,379,1.80562172463078,1.80562172463078,1937,9.2282039066222,9.2282039066222
"17","175","050","Stark County",5400,5274,5947,-126,-2.33333333333333,2.33333333333333,547,10.1296296296296,10.1296296296296
"17","177","050","Stephenson County",44630,43969,47235,-661,-1.48106654716558,1.48106654716558,2605,5.83688102173426,5.83688102173426
"17","179","050","Tazewell County",131343,131075,138824,-268,-0.204045895099092,0.204045895099092,7481,5.6957736613295,5.6957736613295
"17","181","050","Union County",17244,16545,18018,-699,-4.053583855254,4.053583855254,774,4.48851774530271,4.48851774530271
"17","183","050","Vermilion County",74188,75093,81056,905,1.21987383404324,1.21987383404324,6868,9.25756186984418,9.25756186984418
"17","185","050","Wabash County",11361,11229,11956,-132,-1.16186955373647,1.16186955373647,595,5.23721503388786,5.23721503388786
"17","187","050","Warren County",16835,16724,17666,-111,-0.659340659340659,0.659340659340659,831,4.93614493614494,4.93614493614494
"17","189","050","Washington County",13761,13808,15045,47,0.341544945861493,0.341544945861493,1284,9.33071724438631,9.33071724438631
"17","191","050","Wayne County",16179,16061,16821,-118,-0.72934050312133,0.72934050312133,642,3.96810680511775,3.96810680511775
"17","193","050","White County",13877,13423,14626,-454,-3.27160049001946,3.27160049001946,749,5.39742019168408,5.39742019168408
"17","195","050","Whiteside County",55691,54821,58539,-870,-1.56219137742185,1.56219137742185,2848,5.11393223321542,5.11393223321542
"17","197","050","Will County",696355,689418,706680,-6937,-0.996187289529048,0.996187289529048,10325,1.48272073870368,1.48272073870368
"17","199","050","Williamson County",67153,66479,69276,-674,-1.00367816776615,1.00367816776615,2123,3.16143731478862,3.16143731478862
"17","201","050","Winnebago County",285350,281743,294750,-3607,-1.26406167864027,1.26406167864027,9400,3.29420010513405,3.29420010513405
"17","203","050","Woodford County",38467,38146,40014,-321,-0.834481503626485,0.834481503626485,1547,4.02162892869213,4.02162892869213
"18","001","050","Adams County",35809,35859,35491,50,0.139629702030216,0.139629702030216,-318,-0.888044904912173,0.888044904912173
"18","003","050","Allen County",385410,381615,378087,-3795,-0.984665680703666,0.984665680703666,-7323,-1.90005448742897,1.90005448742897
"18","005","050","Bartholomew County",82208,84443,80673,2235,2.71871350720125,2.71871350720125,-1535,-1.86721486959907,1.86721486959907
"18","007","050","Benton County",8719,8746,8854,27,0.30966853997018,0.30966853997018,135,1.5483426998509,1.5483426998509
"18","009","050","Blackford County",12112,11806,12667,-306,-2.52642007926024,2.52642007926024,555,4.58223249669749,4.58223249669749
"18","011","050","Boone County",70812,69046,71042,-1766,-2.49392758289555,2.49392758289555,230,0.324803705586624,0.324803705586624
"18","013","050","Brown County",15475,15119,16307,-356,-2.30048465266559,2.30048465266559,832,5.37641357027464,5.37641357027464
"18","015","050","Carroll County",20306,20257,20692,-49,-0.241307987786861,0.241307987786861,386,1.90091598542303,1.90091598542303
"18","017","050","Cass County",37870,37515,38684,-355,-0.937417480855558,0.937417480855558,814,2.14945867441246,2.14945867441246
"18","019","050","Clark County",121093,119083,120796,-2010,-1.65988124829676,1.65988124829676,-297,-0.245266035196089,0.245266035196089
"18","021","050","Clay County",26466,26288,27071,-178,-0.672561021688204,0.672561021688204,605,2.28595178719867,2.28595178719867
"18","023","050","Clinton County",33190,32277,33536,-913,-2.75082856282013,2.75082856282013,346,1.04248267550467,1.04248267550467
"18","025","050","Crawford County",10526,10629,10849,103,0.978529355880676,0.978529355880676,323,3.06859205776173,3.06859205776173
"18","027","050","Daviess County",33381,33539,31926,158,0.473323147898505,0.473323147898505,-1455,-4.35876696324256,4.35876696324256
"18","029","050","Dearborn County",50679,49791,51558,-888,-1.75220505534837,1.75220505534837,879,1.73444622032795,1.73444622032795
"18","031","050","Decatur County",26472,26579,26423,107,0.40420066485343,0.40420066485343,-49,-0.185101239045029,0.185101239045029
"18","033","050","DeKalb County",43265,43682,44203,417,0.963827574251705,0.963827574251705,938,2.16803420778921,2.16803420778921
"18","035","050","Delaware County",111903,113601,118452,1698,1.51738559287955,1.51738559287955,6549,5.85239001635345,5.85239001635345
"18","037","050","Dubois County",43637,42592,43602,-1045,-2.39475674313083,2.39475674313083,-35,-0.0802071636455302,0.0802071636455302
"18","039","050","Elkhart County",207047,206292,203260,-755,-0.364651504247828,0.364651504247828,-3787,-1.82905330673712,1.82905330673712
"18","041","050","Fayette County",23398,22947,24115,-451,-1.92751517223694,1.92751517223694,717,3.0643644755962,3.0643644755962
"18","043","050","Floyd County",80484,78883,77650,-1601,-1.98921524775111,1.98921524775111,-2834,-3.52119675960439,3.52119675960439
"18","045","050","Fountain County",16479,16505,17601,26,0.1577765641119,0.1577765641119,1122,6.80866557436738,6.80866557436738
"18","047","050","Franklin County",22785,22782,24005,-3,-0.0131665569453588,0.0131665569453588,1220,5.35439982444591,5.35439982444591
"18","049","050","Fulton County",20480,20058,20942,-422,-2.060546875,2.060546875,462,2.255859375,2.255859375
"18","051","050","Gibson County",33011,33826,35626,815,2.46887401169307,2.46887401169307,2615,7.921601890279,7.921601890279
"18","053","050","Grant County",66674,65416,70293,-1258,-1.88679245283019,1.88679245283019,3619,5.42790293067763,5.42790293067763
"18","055","050","Greene County",30803,32193,33397,1390,4.51254747914164,4.51254747914164,2594,8.4212576697075,8.4212576697075
"18","057","050","Hamilton County",347467,342823,346242,-4644,-1.33652979995223,1.33652979995223,-1225,-0.352551465319009,0.352551465319009
"18","059","050","Hancock County",79840,79246,78618,-594,-0.743987975951904,0.743987975951904,-1222,-1.53056112224449,1.53056112224449
"18","061","050","Harrison County",39654,40686,41365,1032,2.60251172643365,2.60251172643365,1711,4.31482322086044,4.31482322086044
"18","063","050","Hendricks County",174788,172509,169753,-2279,-1.30386525390759,1.30386525390759,-5035,-2.88063253770282,2.88063253770282
"18","065","050","Henry County",48914,48044,49445,-870,-1.77863188453204,1.77863188453204,531,1.08557877090404,1.08557877090404
"18","067","050","Howard County",83658,82780,85548,-878,-1.04951110473595,1.04951110473595,1890,2.25919816395324,2.25919816395324
"18","069","050","Huntington County",36662,36459,38058,-203,-0.553706835415417,0.553706835415417,1396,3.80775735093557,3.80775735093557
"18","071","050","Jackson County",46428,44232,45559,-2196,-4.72990436805376,4.72990436805376,-869,-1.87171534418885,1.87171534418885
"18","073","050","Jasper County",32918,33474,35057,556,1.68904550701744,1.68904550701744,2139,6.49796463940701,6.49796463940701
"18","075","050","Jay County",20478,20433,21345,-45,-0.2197480222678,0.2197480222678,867,4.23381189569294,4.23381189569294
"18","077","050","Jefferson County",33147,32163,33032,-984,-2.96859444293601,2.96859444293601,-115,-0.34693939119679,0.34693939119679
"18","079","050","Jennings County",27613,27579,29524,-34,-0.123130409589686,0.123130409589686,1911,6.92065331546735,6.92065331546735
"18","081","050","Johnson County",161765,160103,155833,-1662,-1.02741631378852,1.02741631378852,-5932,-3.66704787809477,3.66704787809477
"18","083","050","Knox County",36282,36578,38763,296,0.815831541811366,0.815831541811366,2481,6.8381015379527,6.8381015379527
"18","085","050","Kosciusko County",80240,79137,82090,-1103,-1.37462612163509,1.37462612163509,1850,2.30558325024925,2.30558325024925
"18","087","050","LaGrange County",40446,40058,39923,-388,-0.959303763042081,0.959303763042081,-523,-1.29308213420363,1.29308213420363
"18","089","050","Lake County",498700,487517,511769,-11183,-2.24243031882896,2.24243031882896,13069,2.6206135953479,2.6206135953479
"18","091","050","LaPorte County",112417,109800,113525,-2617,-2.3279397244189,2.3279397244189,1108,0.985616054511328,0.985616054511328
"18","093","050","Lawrence County",45011,45486,46443,475,1.05529759392149,1.05529759392149,1432,3.18144453578014,3.18144453578014
"18","095","050","Madison County",130129,129682,132218,-447,-0.343505290903642,0.343505290903642,2089,1.6053300955206,1.6053300955206
"18","097","050","Marion County",977203,966118,924089,-11085,-1.13436000503478,1.13436000503478,-53114,-5.43530873319054,5.43530873319054
"18","099","050","Marshall County",46095,46138,48475,43,0.0932856058140796,0.0932856058140796,2380,5.16324981017464,5.16324981017464
"18","101","050","Martin County",9812,10104,10456,292,2.97594781899715,2.97594781899715,644,6.56339176518549,6.56339176518549
"18","103","050","Miami County",35962,35378,36752,-584,-1.62393637728714,1.62393637728714,790,2.19676325009732,2.19676325009732
"18","105","050","Monroe County",139718,148278,146865,8560,6.1266264905023,6.1266264905023,7147,5.11530368313317,5.11530368313317
"18","107","050","Montgomery County",37936,38351,38661,415,1.09394770139182,1.09394770139182,725,1.91111345423872,1.91111345423872
"18","109","050","Morgan County",71780,70642,71580,-1138,-1.58539983282251,1.58539983282251,-200,-0.278629144608526,0.278629144608526
"18","111","050","Newton County",13830,13928,14447,98,0.708604483007954,0.708604483007954,617,4.46131597975416,4.46131597975416
"18","113","050","Noble County",47457,47859,49295,402,0.847082622163221,0.847082622163221,1838,3.87297975008955,3.87297975008955
"18","115","050","Ohio County",5940,5896,6399,-44,-0.740740740740741,0.740740740740741,459,7.72727272727273,7.72727272727273
"18","117","050","Orange County",19867,19638,20084,-229,-1.15266522373786,1.15266522373786,217,1.09226355262496,1.09226355262496
"18","119","050","Owen County",21321,20845,22071,-476,-2.23254068758501,2.23254068758501,750,3.51765864640495,3.51765864640495
"18","121","050","Parke County",16156,16882,17847,726,4.49368655607824,4.49368655607824,1691,10.4666996781382,10.4666996781382
"18","123","050","Perry County",19170,19160,19969,-10,-0.0521648408972353,0.0521648408972353,799,4.1679707876891,4.1679707876891
"18","125","050","Pike County",12250,12372,13018,122,0.995918367346939,0.995918367346939,768,6.26938775510204,6.26938775510204
"18","127","050","Porter County",173215,170947,174462,-2268,-1.30935542533845,1.30935542533845,1247,0.719914557053373,0.719914557053373
"18","129","050","Posey County",25222,25313,26853,91,0.360796130362382,0.360796130362382,1631,6.46657679803346,6.46657679803346
"18","131","050","Pulaski County",12514,12372,13589,-142,-1.13472910340419,1.13472910340419,1075,8.59037877577114,8.59037877577114
"18","133","050","Putnam County",36726,37488,39823,762,2.07482437510211,2.07482437510211,3097,8.43271796547405,8.43271796547405
"18","135","050","Randolph County",24502,24280,26072,-222,-0.906048485837891,0.906048485837891,1570,6.40764019263734,6.40764019263734
"18","137","050","Ripley County",28995,28437,30311,-558,-1.92446973616141,1.92446973616141,1316,4.5387135713054,4.5387135713054
"18","139","050","Rush County",16752,16629,17412,-123,-0.734240687679083,0.734240687679083,660,3.93982808022923,3.93982808022923
"18","141","050","St. Joseph County",272912,271650,273370,-1262,-0.462420120771531,0.462420120771531,458,0.167819663481269,0.167819663481269
"18","143","050","Scott County",24384,23804,24841,-580,-2.37860892388451,2.37860892388451,457,1.87417979002625,1.87417979002625
"18","145","050","Shelby County",45055,44860,45431,-195,-0.432804350238597,0.432804350238597,376,0.834535567639552,0.834535567639552
"18","147","050","Spencer County",19810,20234,21774,424,2.14033316506815,2.14033316506815,1964,9.91418475517415,9.91418475517415
"18","149","050","Starke County",23371,23041,23999,-330,-1.41200633263446,1.41200633263446,628,2.68709083907407,2.68709083907407
"18","151","050","Steuben County",34435,34816,35964,381,1.10643240888631,1.10643240888631,1529,4.44024974589807,4.44024974589807
"18","153","050","Sullivan County",20817,20578,21636,-239,-1.14810011048662,1.14810011048662,819,3.93428447903156,3.93428447903156
"18","155","050","Switzerland County",9737,10748,11794,1011,10.3830748690562,10.3830748690562,2057,21.125603368594,21.125603368594
"18","157","050","Tippecanoe County",186251,195897,192556,9646,5.17903259579814,5.17903259579814,6305,3.3852167236686,3.3852167236686
"18","159","050","Tipton County",15359,15188,16043,-171,-1.11335373396706,1.11335373396706,684,4.45341493586822,4.45341493586822
"18","161","050","Union County",7087,7117,7618,30,0.42331028643996,0.42331028643996,531,7.4925920699873,7.4925920699873
"18","163","050","Vanderburgh County",180136,182262,183552,2126,1.18021938979438,1.18021938979438,3416,1.89634498379003,1.89634498379003
"18","165","050","Vermillion County",15439,15368,16242,-71,-0.459874344193277,0.459874344193277,803,5.20111406179157,5.20111406179157
"18","167","050","Vigo County",106153,106698,111326,545,0.513409889499119,0.513409889499119,5173,4.87315478601641,4.87315478601641
"18","169","050","Wabash County",30976,30835,32946,-141,-0.455191115702479,0.455191115702479,1970,6.35976239669421,6.35976239669421
"18","171","050","Warren County",8440,8195,8754,-245,-2.90284360189573,2.90284360189573,314,3.72037914691943,3.72037914691943
"18","173","050","Warrick County",63898,63178,66469,-720,-1.12679583085543,1.12679583085543,2571,4.02360011267958,4.02360011267958
"18","175","050","Washington County",28182,28164,29021,-18,-0.0638705556738344,0.0638705556738344,839,2.9770775672415,2.9770775672415
"18","177","050","Wayne County",66553,65823,69590,-730,-1.09687016362899,1.09687016362899,3037,4.56328039307019,4.56328039307019
"18","179","050","Wells County",28180,28112,28433,-68,-0.241305890702626,0.241305890702626,253,0.897799858055358,0.897799858055358
"18","181","050","White County",24688,24164,25095,-524,-2.12248865845755,2.12248865845755,407,1.64857420609203,1.64857420609203
"18","183","050","Whitley County",34191,34238,35259,47,0.137463075078237,0.137463075078237,1068,3.12362902518207,3.12362902518207
"19","001","050","Adair County",7496,7084,7728,-412,-5.49626467449306,5.49626467449306,232,3.09498399146211,3.09498399146211
"19","003","050","Adams County",3704,3595,4031,-109,-2.94276457883369,2.94276457883369,327,8.82829373650108,8.82829373650108
"19","005","050","Allamakee County",14061,13676,14836,-385,-2.73806983856056,2.73806983856056,775,5.51169902567385,5.51169902567385
"19","007","050","Appanoose County",12317,12482,12921,165,1.33961191848664,1.33961191848664,604,4.90379150767232,4.90379150767232
"19","009","050","Audubon County",5674,5495,6204,-179,-3.15474092351075,3.15474092351075,530,9.34085301374692,9.34085301374692
"19","011","050","Benton County",25575,25485,26334,-90,-0.351906158357771,0.351906158357771,759,2.96774193548387,2.96774193548387
"19","013","050","Black Hawk County",131144,130962,137738,-182,-0.13877874702617,0.13877874702617,6594,5.02806075764046,5.02806075764046
"19","015","050","Boone County",26715,26320,27062,-395,-1.47857009170878,1.47857009170878,347,1.2988957514505,1.2988957514505
"19","017","050","Bremer County",24988,25323,26048,335,1.34064350888426,1.34064350888426,1060,4.24203617736514,4.24203617736514
"19","019","050","Buchanan County",20565,21285,21390,720,3.50109409190372,3.50109409190372,825,4.01167031363968,4.01167031363968
"19","021","050","Buena Vista County",20823,19791,20390,-1032,-4.95605820486962,4.95605820486962,-433,-2.07943139797339,2.07943139797339
"19","023","050","Butler County",14334,14378,15189,44,0.306962466862006,0.306962466862006,855,5.9648388447049,5.9648388447049
"19","025","050","Calhoun County",9927,9527,10265,-400,-4.02941472751083,4.02941472751083,338,3.40485544474665,3.40485544474665
"19","027","050","Carroll County",20760,19998,21258,-762,-3.67052023121387,3.67052023121387,498,2.39884393063584,2.39884393063584
"19","029","050","Cass County",13127,12840,13922,-287,-2.18633351108403,2.18633351108403,795,6.05622000457073,6.05622000457073
"19","031","050","Cedar County",18505,18517,19041,12,0.0648473385571467,0.0648473385571467,536,2.89651445555255,2.89651445555255
"19","033","050","Cerro Gordo County",43127,42247,44543,-880,-2.04048507895286,2.04048507895286,1416,3.28332599067869,3.28332599067869
"19","035","050","Cherokee County",11658,11218,12069,-440,-3.77423228684165,3.77423228684165,411,3.52547606793618,3.52547606793618
"19","037","050","Chickasaw County",12012,11872,12488,-140,-1.16550116550117,1.16550116550117,476,3.96270396270396,3.96270396270396
"19","039","050","Clarke County",9748,9386,10184,-362,-3.71358227328683,3.71358227328683,436,4.47271235125154,4.47271235125154
"19","041","050","Clay County",16384,16030,17339,-354,-2.16064453125,2.16064453125,955,5.828857421875,5.828857421875
"19","043","050","Clayton County",17043,17379,18485,336,1.97148389368069,1.97148389368069,1442,8.46095171037963,8.46095171037963
"19","045","050","Clinton County",46460,46491,50311,31,0.0667240637107189,0.0667240637107189,3851,8.28885062419285,8.28885062419285
"19","047","050","Crawford County",16525,16893,17396,368,2.22692889561271,2.22692889561271,871,5.27080181543116,5.27080181543116
"19","049","050","Dallas County",99678,96181,96256,-3497,-3.50829671542366,3.50829671542366,-3422,-3.43305443528161,3.43305443528161
"19","051","050","Davis County",9110,9050,8746,-60,-0.658616904500549,0.658616904500549,-364,-3.99560922063666,3.99560922063666
"19","053","050","Decatur County",7645,7807,8487,162,2.1190320470896,2.1190320470896,842,11.0137344669719,11.0137344669719
"19","055","050","Delaware County",17488,16977,17996,-511,-2.92200365965233,2.92200365965233,508,2.90484903934126,2.90484903934126
"19","057","050","Des Moines County",38910,38845,40527,-65,-0.167052171678232,0.167052171678232,1617,4.15574402467232,4.15574402467232
"19","059","050","Dickinson County",17703,17518,18704,-185,-1.04502061797435,1.04502061797435,1001,5.65440885725583,5.65440885725583
"19","061","050","Dubuque County",99266,97601,100774,-1665,-1.67731146616163,1.67731146616163,1508,1.51915056514819,1.51915056514819
"19","063","050","Emmet County",9388,9134,10441,-254,-2.70558159352365,2.70558159352365,1053,11.2164465274819,11.2164465274819
"19","065","050","Fayette County",19509,19362,20976,-147,-0.753498385360603,0.753498385360603,1467,7.51960633553744,7.51960633553744
"19","067","050","Floyd County",15627,15540,16423,-87,-0.556728738721444,0.556728738721444,796,5.09374800025597,5.09374800025597
"19","069","050","Franklin County",10019,10014,10569,-5,-0.0499051801577004,0.0499051801577004,550,5.48956981734704,5.48956981734704
"19","071","050","Fremont County",6605,6782,7445,177,2.67978803936412,2.67978803936412,840,12.7176381529145,12.7176381529145
"19","073","050","Greene County",8771,8827,9351,56,0.638467677573823,0.638467677573823,580,6.61270094630031,6.61270094630031
"19","075","050","Grundy County",12329,12230,12608,-99,-0.802984832508719,0.802984832508719,279,2.26295725525185,2.26295725525185
"19","077","050","Guthrie County",10623,10745,11113,122,1.14845147321849,1.14845147321849,490,4.6126329662054,4.6126329662054
"19","079","050","Hamilton County",15039,14751,15701,-288,-1.91502094554159,1.91502094554159,662,4.40188842343241,4.40188842343241
"19","081","050","Hancock County",10795,10548,11395,-247,-2.28809634089856,2.28809634089856,600,5.55812876331635,5.55812876331635
"19","083","050","Hardin County",16878,16653,17406,-225,-1.33309633842872,1.33309633842872,528,3.12833274084607,3.12833274084607
"19","085","050","Harrison County",14582,13955,15301,-627,-4.29982169798382,4.29982169798382,719,4.93073652448224,4.93073652448224
"19","087","050","Henry County",20482,19746,20598,-736,-3.59339908212089,3.59339908212089,116,0.566350942290792,0.566350942290792
"19","089","050","Howard County",9469,9180,9568,-289,-3.05206463195691,3.05206463195691,99,1.04551695004752,1.04551695004752
"19","091","050","Humboldt County",9597,9500,9965,-97,-1.01073252057935,1.01073252057935,368,3.83453162446598,3.83453162446598
"19","093","050","Ida County",7005,6840,7145,-165,-2.35546038543897,2.35546038543897,140,1.99857244825125,1.99857244825125
"19","095","050","Iowa County",16662,16145,16613,-517,-3.10286880326491,3.10286880326491,-49,-0.294082343056056,0.294082343056056
"19","097","050","Jackson County",19485,19266,20346,-219,-1.12394149345651,1.12394149345651,861,4.41878367975366,4.41878367975366
"19","099","050","Jasper County",37813,37166,37411,-647,-1.71105175468754,1.71105175468754,-402,-1.06312643799751,1.06312643799751
"19","101","050","Jefferson County",15663,18333,17160,2670,17.0465428078912,17.0465428078912,1497,9.55755602375024,9.55755602375024
"19","103","050","Johnson County",152854,153507,156921,653,0.427205045337381,0.427205045337381,4067,2.66070891177202,2.66070891177202
"19","105","050","Jones County",20646,20639,20859,-7,-0.03390487261455,0.03390487261455,213,1.03167683812845,1.03167683812845
"19","107","050","Keokuk County",10033,10111,10376,78,0.777434466261337,0.777434466261337,343,3.41871822984152,3.41871822984152
"19","109","050","Kossuth County",14828,14705,15607,-123,-0.829511734556245,0.829511734556245,779,5.25357431885622,5.25357431885622
"19","111","050","Lee County",33555,33541,35893,-14,-0.0417225450752496,0.0417225450752496,2338,6.96766502756668,6.96766502756668
"19","113","050","Linn County",230299,227797,227391,-2502,-1.08641374908271,1.08641374908271,-2908,-1.2627063078867,1.2627063078867
"19","115","050","Louisa County",10837,11030,11544,193,1.78093568330719,1.78093568330719,707,6.52394574144136,6.52394574144136
"19","117","050","Lucas County",8634,8531,8827,-103,-1.1929580727357,1.1929580727357,193,2.23534862172805,2.23534862172805
"19","119","050","Lyon County",11934,11766,12236,-168,-1.40774258421317,1.40774258421317,302,2.53058488352606,2.53058488352606
"19","121","050","Madison County",16548,16466,17377,-82,-0.49552816050278,0.49552816050278,829,5.00966884215615,5.00966884215615
"19","123","050","Mahaska County",22190,22391,22696,201,0.905813429472735,0.905813429472735,506,2.2803064443443,2.2803064443443
"19","125","050","Marion County",33414,33201,34581,-213,-0.637457353205243,0.637457353205243,1167,3.4925480337583,3.4925480337583
"19","127","050","Marshall County",40105,39486,40812,-619,-1.54344844782446,1.54344844782446,707,1.76287245979304,1.76287245979304
"19","129","050","Mills County",14484,14844,14948,360,2.48550124275062,2.48550124275062,464,3.2035349351008,3.2035349351008
"19","131","050","Mitchell County",10565,10625,11178,60,0.56791292001893,0.56791292001893,613,5.80217699952674,5.80217699952674
"19","133","050","Monona County",8751,8599,9304,-152,-1.73694434921723,1.73694434921723,553,6.31927779682322,6.31927779682322
"19","135","050","Monroe County",7577,7745,8264,168,2.21723637323479,2.21723637323479,687,9.06691302626369,9.06691302626369
"19","137","050","Montgomery County",10330,9931,10713,-399,-3.86253630203291,3.86253630203291,383,3.70764762826718,3.70764762826718
"19","139","050","Muscatine County",43235,42459,43639,-776,-1.79484214178328,1.79484214178328,404,0.934428125361397,0.934428125361397
"19","141","050","O'Brien County",14182,13721,14543,-461,-3.25059935129037,3.25059935129037,361,2.54548018615146,2.54548018615146
"19","143","050","Osceola County",6192,5986,6386,-206,-3.32687338501292,3.32687338501292,194,3.13307493540052,3.13307493540052
"19","145","050","Page County",15211,15079,15944,-132,-0.867793044507264,0.867793044507264,733,4.81888107290776,4.81888107290776
"19","147","050","Palo Alto County",8996,8844,9352,-152,-1.68963983992886,1.68963983992886,356,3.95731436193864,3.95731436193864
"19","149","050","Plymouth County",25698,25213,26201,-485,-1.88730640516772,1.88730640516772,503,1.95735076659662,1.95735076659662
"19","151","050","Pocahontas County",7078,6607,7212,-471,-6.65442215315061,6.65442215315061,134,1.89319016671376,1.89319016671376
"19","153","050","Polk County",492401,493699,497291,1298,0.263606288370657,0.263606288370657,4890,0.993093027837068,0.993093027837068
"19","155","050","Pottawattamie County",93667,93361,95186,-306,-0.326689228863954,0.326689228863954,1519,1.62170241387041,1.62170241387041
"19","157","050","Poweshiek County",18662,18382,19450,-280,-1.50037509377344,1.50037509377344,788,4.22248419247669,4.22248419247669
"19","159","050","Ringgold County",4663,4813,5120,150,3.21681321037958,3.21681321037958,457,9.80055758095647,9.80055758095647
"19","161","050","Sac County",9814,9607,10289,-207,-2.10923170980232,2.10923170980232,475,4.8400244548604,4.8400244548604
"19","163","050","Scott County",174669,173301,173661,-1368,-0.783195644332995,0.783195644332995,-1008,-0.57709152740326,0.57709152740326
"19","165","050","Shelby County",11746,11435,12352,-311,-2.64770985867529,2.64770985867529,606,5.15920313298144,5.15920313298144
"19","167","050","Sioux County",35872,35022,36262,-850,-2.36953612845674,2.36953612845674,390,1.08719892952721,1.08719892952721
"19","169","050","Story County",98537,98081,101553,-456,-0.46277032992683,0.46277032992683,3016,3.06077919969149,3.06077919969149
"19","171","050","Tama County",17135,16807,17806,-328,-1.91421067989495,1.91421067989495,671,3.91596148234608,3.91596148234608
"19","173","050","Taylor County",5896,6121,6321,225,3.81614654002714,3.81614654002714,425,7.20827679782904,7.20827679782904
"19","175","050","Union County",12138,12144,12540,6,0.0494315373208107,0.0494315373208107,402,3.31191300049432,3.31191300049432
"19","177","050","Van Buren County",7203,7053,7530,-150,-2.08246563931695,2.08246563931695,327,4.53977509371095,4.53977509371095
"19","179","050","Wapello County",35437,35008,35598,-429,-1.2105990913452,1.2105990913452,161,0.454327397917431,0.454327397917431
"19","181","050","Warren County",52403,52079,52625,-324,-0.618285212678663,0.618285212678663,222,0.423639867946492,0.423639867946492
"19","183","050","Washington County",22565,21992,22483,-573,-2.53933082206958,2.53933082206958,-82,-0.363394637713273,0.363394637713273
"19","185","050","Wayne County",6497,6420,6361,-77,-1.18516238263814,1.18516238263814,-136,-2.09327381868555,2.09327381868555
"19","187","050","Webster County",36999,35914,38094,-1085,-2.93251168950512,2.93251168950512,1095,2.95953944701208,2.95953944701208
"19","189","050","Winnebago County",10679,10278,10866,-401,-3.755033242813,3.755033242813,187,1.75110029028935,1.75110029028935
"19","191","050","Winneshiek County",20070,19886,21947,-184,-0.916791230692576,0.916791230692576,1877,9.35226706527155,9.35226706527155
"19","193","050","Woodbury County",105941,103123,105296,-2818,-2.65997111599853,2.65997111599853,-645,-0.60882944280307,0.60882944280307
"19","195","050","Worth County",7443,7361,7512,-82,-1.10170630122263,1.10170630122263,69,0.927045546150746,0.927045546150746
"19","197","050","Wright County",12943,12434,13209,-509,-3.93262767519122,3.93262767519122,266,2.0551649540292,2.0551649540292
"20","001","050","Allen County",12526,12419,13628,-107,-0.85422321571132,0.85422321571132,1102,8.79770078237267,8.79770078237267
"20","003","050","Anderson County",7836,7969,8198,133,1.69729453802961,1.69729453802961,362,4.61970393057682,4.61970393057682
"20","005","050","Atchison County",16348,16075,16812,-273,-1.66992904330805,1.66992904330805,464,2.83826767800343,2.83826767800343
"20","007","050","Barber County",4228,4383,4802,155,3.66603595080416,3.66603595080416,574,13.5761589403974,13.5761589403974
"20","009","050","Barton County",25493,25762,27805,269,1.05519162122936,1.05519162122936,2312,9.06915623896756,9.06915623896756
"20","011","050","Bourbon County",14360,14499,15040,139,0.967966573816156,0.967966573816156,680,4.73537604456824,4.73537604456824
"20","013","050","Brown County",9508,9521,9880,13,0.13672696676483,0.13672696676483,372,3.91249474127051,3.91249474127051
"20","015","050","Butler County",67380,67023,69219,-357,-0.529830810329475,0.529830810329475,1839,2.72929652715939,2.72929652715939
"20","017","050","Chase County",2572,2588,2766,16,0.622083981337481,0.622083981337481,194,7.54276827371695,7.54276827371695
"20","019","050","Chautauqua County",3379,3256,3649,-123,-3.64013021604025,3.64013021604025,270,7.99052974252738,7.99052974252738
"20","021","050","Cherokee County",19362,19772,21612,410,2.11754983989257,2.11754983989257,2250,11.6207003408739,11.6207003408739
"20","023","050","Cheyenne County",2616,2616,2690,0,0,0,74,2.82874617737003,2.82874617737003
"20","025","050","Clark County",1991,1979,2209,-12,-0.60271220492215,0.60271220492215,218,10.9492717227524,10.9492717227524
"20","027","050","Clay County",8117,8048,8721,-69,-0.85006775902427,0.85006775902427,604,7.441172847111,7.441172847111
"20","029","050","Cloud County",9032,8701,9386,-331,-3.66474756421612,3.66474756421612,354,3.91939769707706,3.91939769707706
"20","031","050","Coffey County",8360,8180,9038,-180,-2.15311004784689,2.15311004784689,678,8.11004784688995,8.11004784688995
"20","033","050","Comanche County",1689,1701,1858,12,0.710479573712256,0.710479573712256,169,10.0059206631143,10.0059206631143
"20","035","050","Cowley County",34549,34734,36862,185,0.535471359518365,0.535471359518365,2313,6.69483921387016,6.69483921387016
"20","037","050","Crawford County",38972,38769,40195,-203,-0.520886790516268,0.520886790516268,1223,3.13815046700195,3.13815046700195
"20","039","050","Decatur County",2764,2787,2921,23,0.832127351664255,0.832127351664255,157,5.68017366136035,5.68017366136035
"20","041","050","Dickinson County",18402,18330,20251,-72,-0.39126181936746,0.39126181936746,1849,10.0478208890338,10.0478208890338
"20","043","050","Doniphan County",7510,7530,7952,20,0.266311584553928,0.266311584553928,442,5.88548601864181,5.88548601864181
"20","045","050","Douglas County",118785,122546,123516,3761,3.16622469166982,3.16622469166982,4731,3.98282611440838,3.98282611440838
"20","047","050","Edwards County",2907,2757,3002,-150,-5.15995872033024,5.15995872033024,95,3.26797385620915,3.26797385620915
"20","049","050","Elk County",2483,2507,2875,24,0.966572694321385,0.966572694321385,392,15.7873540072493,15.7873540072493
"20","051","050","Ellis County",28934,28696,29493,-238,-0.82256169212691,0.82256169212691,559,1.93198313402917,1.93198313402917
"20","053","050","Ellsworth County",6376,6053,6471,-323,-5.06587202007528,5.06587202007528,95,1.48996235884567,1.48996235884567
"20","055","050","Finney County",38470,36086,37926,-2384,-6.19703665193657,6.19703665193657,-544,-1.4140889004419,1.4140889004419
"20","057","050","Ford County",34287,33195,34865,-1092,-3.18488056697874,3.18488056697874,578,1.68577011695395,1.68577011695395
"20","059","050","Franklin County",25996,25706,26521,-290,-1.11555623942145,1.11555623942145,525,2.01954146791814,2.01954146791814
"20","061","050","Geary County",36739,32184,36312,-4555,-12.3982688695936,12.3982688695936,-427,-1.16225264705082,1.16225264705082
"20","063","050","Gove County",2718,2638,2958,-80,-2.94334069168506,2.94334069168506,240,8.83002207505519,8.83002207505519
"20","065","050","Graham County",2415,2404,2579,-11,-0.455486542443064,0.455486542443064,164,6.79089026915114,6.79089026915114
"20","067","050","Grant County",7352,7104,7898,-248,-3.37323177366703,3.37323177366703,546,7.42655059847661,7.42655059847661
"20","069","050","Gray County",5653,5982,6291,329,5.81991862727755,5.81991862727755,638,11.2860428091279,11.2860428091279
"20","071","050","Greeley County",1284,1202,1262,-82,-6.38629283489097,6.38629283489097,-22,-1.71339563862928,1.71339563862928
"20","073","050","Greenwood County",6016,5913,6628,-103,-1.71210106382979,1.71210106382979,612,10.1728723404255,10.1728723404255
"20","075","050","Hamilton County",2518,2459,2683,-59,-2.34312946783161,2.34312946783161,165,6.55281969817315,6.55281969817315
"20","077","050","Harper County",5485,5367,6108,-118,-2.15132178669098,2.15132178669098,623,11.3582497721057,11.3582497721057
"20","079","050","Harvey County",34024,34350,35567,326,0.958147190218669,0.958147190218669,1543,4.535034093581,4.535034093581
"20","081","050","Haskell County",3780,3949,4320,169,4.47089947089947,4.47089947089947,540,14.2857142857143,14.2857142857143
"20","083","050","Hodgeman County",1723,1781,1904,58,3.36622170632618,3.36622170632618,181,10.5049332559489,10.5049332559489
"20","085","050","Jackson County",13232,13154,13756,-78,-0.589480048367594,0.589480048367594,524,3.96009673518742,3.96009673518742
"20","087","050","Jefferson County",18368,19066,19921,698,3.80008710801394,3.80008710801394,1553,8.45492160278746,8.45492160278746
"20","089","050","Jewell County",2932,2838,3047,-94,-3.20600272851296,3.20600272851296,115,3.92223738062756,3.92223738062756
"20","091","050","Johnson County",609863,606439,601851,-3424,-0.561437568765444,0.561437568765444,-8012,-1.31373767551073,1.31373767551073
"20","093","050","Kearny County",3983,3772,4031,-211,-5.29751443635451,5.29751443635451,48,1.20512176751193,1.20512176751193
"20","095","050","Kingman County",7470,6998,7957,-472,-6.3186077643909,6.3186077643909,487,6.5194109772423,6.5194109772423
"20","097","050","Kiowa County",2460,2461,2597,1,0.040650406504065,0.040650406504065,137,5.56910569105691,5.56910569105691
"20","099","050","Labette County",20184,19624,21463,-560,-2.77447483154974,2.77447483154974,1279,6.33670233848593,6.33670233848593
"20","101","050","Lane County",1574,1516,1722,-58,-3.6848792884371,3.6848792884371,148,9.40279542566709,9.40279542566709
"20","103","050","Leavenworth County",81881,82201,80781,320,0.39081105506772,0.39081105506772,-1100,-1.34341300179529,1.34341300179529
"20","105","050","Lincoln County",2939,2979,3199,40,1.36100714528751,1.36100714528751,260,8.84654644436883,8.84654644436883
"20","107","050","Linn County",9591,9677,10151,86,0.896673965175685,0.896673965175685,560,5.83880721509749,5.83880721509749
"20","109","050","Logan County",2762,2735,2763,-27,-0.977552498189718,0.977552498189718,1,0.0362056480811006,0.0362056480811006
"20","111","050","Lyon County",32179,33120,34165,941,2.92426737934678,2.92426737934678,1986,6.17172690263837,6.17172690263837
"20","113","050","McPherson County",30223,28494,30870,-1729,-5.7208086556596,5.7208086556596,647,2.14075373060252,2.14075373060252
"20","115","050","Marion County",11823,11688,12805,-135,-1.14184217203755,1.14184217203755,982,8.3058445403028,8.3058445403028
"20","117","050","Marshall County",10038,9660,10229,-378,-3.76569037656904,3.76569037656904,191,1.90276947599123,1.90276947599123
"20","119","050","Meade County",4055,4039,4582,-16,-0.394574599260173,0.394574599260173,527,12.9963008631319,12.9963008631319
"20","121","050","Miami County",34191,34306,35227,115,0.336345821999942,0.336345821999942,1036,3.03003714427773,3.03003714427773
"20","123","050","Mitchell County",5796,5901,6385,105,1.81159420289855,1.81159420289855,589,10.1621808143547,10.1621808143547
"20","125","050","Montgomery County",31486,31576,35156,90,0.285841326303754,0.285841326303754,3670,11.6559740837197,11.6559740837197
"20","127","050","Morris County",5386,5565,5929,179,3.32343111771259,3.32343111771259,543,10.0816932788711,10.0816932788711
"20","129","050","Morton County",2701,2545,3200,-156,-5.77563865235098,5.77563865235098,499,18.4746390225842,18.4746390225842
"20","131","050","Nemaha County",10273,10135,10321,-138,-1.34332716830527,1.34332716830527,48,0.467244232454006,0.467244232454006
"20","133","050","Neosho County",15904,15933,16986,29,0.182344064386318,0.182344064386318,1082,6.8033199195171,6.8033199195171
"20","135","050","Ness County",2687,2770,3078,83,3.08894678079643,3.08894678079643,391,14.5515444733904,14.5515444733904
"20","137","050","Norton County",5459,5351,5671,-108,-1.97838431947243,1.97838431947243,212,3.88349514563107,3.88349514563107
"20","139","050","Osage County",15766,15804,16678,38,0.241024990485856,0.241024990485856,912,5.78459977166054,5.78459977166054
"20","141","050","Osborne County",3500,3433,3803,-67,-1.91428571428571,1.91428571428571,303,8.65714285714286,8.65714285714286
"20","143","050","Ottawa County",5735,5710,6117,-25,-0.4359197907585,0.4359197907585,382,6.66085440278989,6.66085440278989
"20","145","050","Pawnee County",6253,6370,6953,117,1.87110187110187,1.87110187110187,700,11.194626579242,11.194626579242
"20","147","050","Phillips County",4981,5193,5707,212,4.25617345914475,4.25617345914475,726,14.5753864685806,14.5753864685806
"20","149","050","Pottawatomie County",25348,24669,25340,-679,-2.67871232444374,2.67871232444374,-8,-0.0315606753984535,0.0315606753984535
"20","151","050","Pratt County",9157,9114,9542,-43,-0.46958610898766,0.46958610898766,385,4.20443376651742,4.20443376651742
"20","153","050","Rawlins County",2561,2519,2519,-42,-1.63998438110113,1.63998438110113,-42,-1.63998438110113,1.63998438110113
"20","155","050","Reno County",61898,61856,65104,-42,-0.0678535655433132,0.0678535655433132,3206,5.17948883647291,5.17948883647291
"20","157","050","Republic County",4674,4544,4970,-130,-2.78134360290971,2.78134360290971,296,6.3329054343175,6.3329054343175
"20","159","050","Rice County",9427,9410,10197,-17,-0.180333085817333,0.180333085817333,770,8.16802800466744,8.16802800466744
"20","161","050","Riley County",71959,73097,79376,1138,1.58145610694979,1.58145610694979,7417,10.3072582998652,10.3072582998652
"20","163","050","Rooks County",4919,4854,5134,-65,-1.32140678999797,1.32140678999797,215,4.37080707460866,4.37080707460866
"20","165","050","Rush County",2956,2956,3257,0,0,0,301,10.1826792963464,10.1826792963464
"20","167","050","Russell County",6691,6812,6940,121,1.80839934240024,1.80839934240024,249,3.7214168285757,3.7214168285757
"20","169","050","Saline County",54303,53965,56382,-338,-0.622433383054343,0.622433383054343,2079,3.82851776144964,3.82851776144964
"20","171","050","Scott County",5151,4798,5051,-353,-6.85303824500097,6.85303824500097,-100,-1.941370607649,1.941370607649
"20","173","050","Sedgwick County",523824,519337,526158,-4487,-0.856585418002993,0.856585418002993,2334,0.445569504260973,0.445569504260973
"20","175","050","Seward County",21964,21080,23622,-884,-4.02476780185759,4.02476780185759,1658,7.54871608085959,7.54871608085959
"20","177","050","Shawnee County",178909,176250,180538,-2659,-1.48623042999514,1.48623042999514,1629,0.910518755344896,0.910518755344896
"20","179","050","Sheridan County",2447,2517,2520,70,2.86064568859828,2.86064568859828,73,2.98324478953821,2.98324478953821
"20","181","050","Sherman County",5927,5795,5932,-132,-2.22709633878859,2.22709633878859,5,0.0843597098025983,0.0843597098025983
"20","183","050","Smith County",3570,3539,3848,-31,-0.868347338935574,0.868347338935574,278,7.78711484593838,7.78711484593838
"20","185","050","Stafford County",4072,4051,4516,-21,-0.515717092337918,0.515717092337918,444,10.9037328094303,10.9037328094303
"20","187","050","Stanton County",2084,1969,2254,-115,-5.51823416506718,5.51823416506718,170,8.1573896353167,8.1573896353167
"20","189","050","Stevens County",5250,5383,5793,133,2.53333333333333,2.53333333333333,543,10.3428571428571,10.3428571428571
"20","191","050","Sumner County",22382,22614,24557,232,1.03654722544902,1.03654722544902,2175,9.71763023858458,9.71763023858458
"20","193","050","Thomas County",7930,7698,8070,-232,-2.92559899117276,2.92559899117276,140,1.76544766708701,1.76544766708701
"20","195","050","Trego County",2808,2766,2963,-42,-1.4957264957265,1.4957264957265,155,5.51994301994302,5.51994301994302
"20","197","050","Wabaunsee County",6877,6893,7278,16,0.232659589937473,0.232659589937473,401,5.83103097280791,5.83103097280791
"20","199","050","Wallace County",1512,1524,1470,12,0.793650793650794,0.793650793650794,-42,-2.77777777777778,2.77777777777778
"20","201","050","Washington County",5530,5432,5743,-98,-1.77215189873418,1.77215189873418,213,3.85171790235081,3.85171790235081
"20","203","050","Wichita County",2152,2086,2230,-66,-3.06691449814126,3.06691449814126,78,3.62453531598513,3.62453531598513
"20","205","050","Wilson County",8624,8388,9378,-236,-2.73654916512059,2.73654916512059,754,8.7430426716141,8.7430426716141
"20","207","050","Woodson County",3115,3028,3316,-87,-2.79293739967897,2.79293739967897,201,6.45264847512039,6.45264847512039
"20","209","050","Wyandotte County",169245,165506,161615,-3739,-2.20922331531212,2.20922331531212,-7630,-4.50825726018494,4.50825726018494
"21","001","050","Adair County",18903,19559,18835,656,3.47034862191187,3.47034862191187,-68,-0.359731259588425,0.359731259588425
"21","003","050","Allen County",20588,21344,20449,756,3.6720419661939,3.6720419661939,-139,-0.675150573149407,0.675150573149407
"21","005","050","Anderson County",23852,22836,22504,-1016,-4.25960087204427,4.25960087204427,-1348,-5.65151769243669,5.65151769243669
"21","007","050","Ballard County",7728,7795,8333,67,0.866977225672878,0.866977225672878,605,7.82867494824017,7.82867494824017
"21","009","050","Barren County",44485,44327,44025,-158,-0.355175901989435,0.355175901989435,-460,-1.03405642351354,1.03405642351354
"21","011","050","Bath County",12750,12510,11899,-240,-1.88235294117647,1.88235294117647,-851,-6.67450980392157,6.67450980392157
"21","013","050","Bell County",24097,25649,28956,1552,6.44063576378802,6.44063576378802,4859,20.1643358094369,20.1643358094369
"21","015","050","Boone County",135968,135048,131123,-920,-0.67662979524594,0.67662979524594,-4845,-3.56333843257237,3.56333843257237
"21","017","050","Bourbon County",20252,19902,20447,-350,-1.72822437290144,1.72822437290144,195,0.962867864902232,0.962867864902232
"21","019","050","Boyd County",48261,46640,49131,-1621,-3.35881975093761,3.35881975093761,870,1.8026978305464,1.8026978305464
"21","021","050","Boyle County",30614,30318,28923,-296,-0.966877899000457,0.966877899000457,-1691,-5.52361664597896,5.52361664597896
"21","023","050","Bracken County",8400,8317,8567,-83,-0.988095238095238,0.988095238095238,167,1.98809523809524,1.98809523809524
"21","025","050","Breathitt County",13718,12585,14316,-1133,-8.25922146085435,8.25922146085435,598,4.3592360402391,4.3592360402391
"21","027","050","Breckinridge County",20432,20556,20524,124,0.606891151135474,0.606891151135474,92,0.450274079874706,0.450274079874706
"21","029","050","Bullitt County",82217,82140,82399,-77,-0.0936545969811596,0.0936545969811596,182,0.221365411046377,0.221365411046377
"21","031","050","Butler County",12371,12754,12974,383,3.09595020612723,3.09595020612723,603,4.87430280494705,4.87430280494705
"21","033","050","Caldwell County",12649,12715,12972,66,0.521780377895486,0.521780377895486,323,2.5535615463673,2.5535615463673
"21","035","050","Calloway County",37103,39280,39242,2177,5.8674500714228,5.8674500714228,2139,5.76503247715818,5.76503247715818
"21","037","050","Campbell County",93076,94035,93547,959,1.03034079676823,1.03034079676823,471,0.506038076410675,0.506038076410675
"21","039","050","Carlisle County",4826,4703,5185,-123,-2.54869457107335,2.54869457107335,359,7.43887277248239,7.43887277248239
"21","041","050","Carroll County",10810,10731,10934,-79,-0.730804810360777,0.730804810360777,124,1.14708603145236,1.14708603145236
"21","043","050","Carter County",26627,26627,28344,0,0,0,1717,6.44834190858903,6.44834190858903
"21","045","050","Casey County",15941,16124,16112,183,1.14798318800577,1.14798318800577,171,1.07270560190703,1.07270560190703
"21","047","050","Christian County",72748,71568,75492,-1180,-1.62203771925001,1.62203771925001,2744,3.77192500137461,3.77192500137461
"21","049","050","Clark County",36972,36469,36397,-503,-1.36048901871687,1.36048901871687,-575,-1.55523098561073,1.55523098561073
"21","051","050","Clay County",20345,19720,22302,-625,-3.07200786434013,3.07200786434013,1957,9.61907102482182,9.61907102482182
"21","053","050","Clinton County",9253,10138,10302,885,9.56446557873122,9.56446557873122,1049,11.3368637198746,11.3368637198746
"21","055","050","Crittenden County",8990,8848,9366,-142,-1.57953281423804,1.57953281423804,376,4.18242491657397,4.18242491657397
"21","057","050","Cumberland County",5888,6559,6841,671,11.3960597826087,11.3960597826087,953,16.1854619565217,16.1854619565217
"21","059","050","Daviess County",103312,101937,101791,-1375,-1.3309199318569,1.3309199318569,-1521,-1.47223943007589,1.47223943007589
"21","061","050","Edmonson County",12126,12224,12488,98,0.808180768596404,0.808180768596404,362,2.98532079828468,2.98532079828468
"21","063","050","Elliott County",7354,7405,8132,51,0.693500135980419,0.693500135980419,778,10.5792765841719,10.5792765841719
"21","065","050","Estill County",14163,14141,14844,-22,-0.155334321824472,0.155334321824472,681,4.80830332556662,4.80830332556662
"21","067","050","Fayette County",322570,324708,317127,2138,0.662801872461791,0.662801872461791,-5443,-1.68738568372756,1.68738568372756
"21","069","050","Fleming County",15082,14600,14675,-482,-3.19586261768996,3.19586261768996,-407,-2.69858109004111,2.69858109004111
"21","071","050","Floyd County",35942,35130,40518,-812,-2.25919537031885,2.25919537031885,4576,12.7316231706638,12.7316231706638
"21","073","050","Franklin County",51541,51101,49636,-440,-0.853689295900351,0.853689295900351,-1905,-3.69608661065947,3.69608661065947
"21","075","050","Fulton County",6515,5962,6712,-553,-8.48810437452034,8.48810437452034,197,3.02379125095932,3.02379125095932
"21","077","050","Gallatin County",8690,8799,9019,109,1.25431530494822,1.25431530494822,329,3.78596087456847,3.78596087456847
"21","079","050","Garrard County",16953,17741,17009,788,4.64814487111426,4.64814487111426,56,0.330325016221318,0.330325016221318
"21","081","050","Grant County",24941,25353,25754,412,1.65189848041378,1.65189848041378,813,3.25969287518544,3.25969287518544
"21","083","050","Graves County",36649,36934,37363,285,0.777647411934841,0.777647411934841,714,1.94821141095255,1.94821141095255
"21","085","050","Grayson County",26420,26479,26138,59,0.22331566994701,0.22331566994701,-282,-1.06737320211961,1.06737320211961
"21","087","050","Green County",11107,10996,11283,-111,-0.999369766813721,0.999369766813721,176,1.58458629692986,1.58458629692986
"21","089","050","Greenup County",35962,34975,36835,-987,-2.74456370613425,2.74456370613425,873,2.42756242700628,2.42756242700628
"21","091","050","Hancock County",9095,8740,8638,-355,-3.90324354040682,3.90324354040682,-457,-5.02473886750962,5.02473886750962
"21","093","050","Hardin County",110702,111271,115872,569,0.513992520460335,0.513992520460335,5170,4.67019566042167,4.67019566042167
"21","095","050","Harlan County",26831,25675,29499,-1156,-4.30844918191644,4.30844918191644,2668,9.94372181431926,9.94372181431926
"21","097","050","Harrison County",18692,18914,19254,222,1.18767387117483,1.18767387117483,562,3.00663385405521,3.00663385405521
"21","099","050","Hart County",19288,19047,19821,-241,-1.24948154292825,1.24948154292825,533,2.76337619245127,2.76337619245127
"21","101","050","Henderson County",44793,44891,46902,98,0.218784185028911,0.218784185028911,2109,4.70832496148952,4.70832496148952
"21","103","050","Henry County",15678,16091,15882,413,2.63426457456308,2.63426457456308,204,1.30118637581324,1.30118637581324
"21","105","050","Hickman County",4521,4372,4963,-149,-3.29573103295731,3.29573103295731,442,9.77659809776598,9.77659809776598
"21","107","050","Hopkins County",45423,44681,47823,-742,-1.63353367236862,1.63353367236862,2400,5.28366686480417,5.28366686480417
"21","109","050","Jackson County",12955,13339,13794,384,2.96410652257816,2.96410652257816,839,6.47626399073717,6.47626399073717
"21","111","050","Jefferson County",782969,767935,770784,-15034,-1.92012710592629,1.92012710592629,-12185,-1.55625573937155,1.55625573937155
"21","113","050","Jessamine County",52991,54070,52583,1079,2.03619482553641,2.03619482553641,-408,-0.769942065633787,0.769942065633787
"21","115","050","Johnson County",22680,22053,23467,-627,-2.76455026455026,2.76455026455026,787,3.4700176366843,3.4700176366843
"21","117","050","Kenton County",169064,167846,162023,-1218,-0.720437230871149,0.720437230871149,-7041,-4.16469502673544,4.16469502673544
"21","119","050","Knott County",14251,14600,16873,349,2.44895095081047,2.44895095081047,2622,18.398708862536,18.398708862536
"21","121","050","Knox County",30193,31074,32723,881,2.91789487629583,2.91789487629583,2530,8.37942569469745,8.37942569469745
"21","123","050","Larue County",14867,14411,14859,-456,-3.06719580278469,3.06719580278469,-8,-0.0538104526804332,0.0538104526804332
"21","125","050","Laurel County",62613,61156,60302,-1457,-2.32699279702298,2.32699279702298,-2311,-3.69092680433776,3.69092680433776
"21","127","050","Lawrence County",16293,15430,16321,-863,-5.29675320689867,5.29675320689867,28,0.171852942981649,0.171852942981649
"21","129","050","Lee County",7395,7304,8039,-91,-1.23056118999324,1.23056118999324,644,8.70858688302907,8.70858688302907
"21","131","050","Leslie County",10513,9704,11687,-809,-7.69523447160658,7.69523447160658,1174,11.1671264149149,11.1671264149149
"21","133","050","Letcher County",21548,21300,25048,-248,-1.15091887878225,1.15091887878225,3500,16.2428067570076,16.2428067570076
"21","135","050","Lewis County",13080,13276,14132,196,1.49847094801223,1.49847094801223,1052,8.04281345565749,8.04281345565749
"21","137","050","Lincoln County",24275,24481,25457,206,0.848609680741504,0.848609680741504,1182,4.8692070030896,4.8692070030896
"21","139","050","Livingston County",8888,9062,9677,174,1.95769576957696,1.95769576957696,789,8.87713771377138,8.87713771377138
"21","141","050","Logan County",27432,27349,26855,-83,-0.302566345873433,0.302566345873433,-577,-2.10338291046952,2.10338291046952
"21","143","050","Lyon County",8680,8160,8555,-520,-5.99078341013825,5.99078341013825,-125,-1.44009216589862,1.44009216589862
"21","145","050","McCracken County",67875,65649,68287,-2226,-3.27955801104972,3.27955801104972,412,0.606998158379374,0.606998158379374
"21","147","050","McCreary County",16888,17122,18430,234,1.38559924206537,1.38559924206537,1542,9.13074372335386,9.13074372335386
"21","149","050","McLean County",9152,9104,9590,-48,-0.524475524475524,0.524475524475524,438,4.78583916083916,4.78583916083916
"21","151","050","Madison County",92701,93997,88802,1296,1.39804317105533,1.39804317105533,-3899,-4.20599562032772,4.20599562032772
"21","153","050","Magoffin County",11637,12060,13801,423,3.63495746326373,3.63495746326373,2164,18.5958580390135,18.5958580390135
"21","155","050","Marion County",19581,19287,20312,-294,-1.50145549256933,1.50145549256933,731,3.73321076553802,3.73321076553802
"21","157","050","Marshall County",31659,31149,32627,-510,-1.61091632711077,1.61091632711077,968,3.05758236204555,3.05758236204555
"21","159","050","Martin County",11287,11081,13367,-206,-1.8251085319394,1.8251085319394,2080,18.4282803224949,18.4282803224949
"21","161","050","Mason County",17120,17029,17602,-91,-0.531542056074766,0.531542056074766,482,2.81542056074766,2.81542056074766
"21","163","050","Meade County",30003,28609,30806,-1394,-4.64620204646202,4.64620204646202,803,2.67639902676399,2.67639902676399
"21","165","050","Menifee County",6113,6499,6431,386,6.31441190904629,6.31441190904629,318,5.20202846392933,5.20202846392933
"21","167","050","Mercer County",22641,21885,21957,-756,-3.33907512919041,3.33907512919041,-684,-3.02106797402942,3.02106797402942
"21","169","050","Metcalfe County",10286,10050,10297,-236,-2.2943807116469,2.2943807116469,11,0.106941473847949,0.106941473847949
"21","171","050","Monroe County",11338,10576,11110,-762,-6.72076203916035,6.72076203916035,-228,-2.01093667313459,2.01093667313459
"21","173","050","Montgomery County",28114,28172,27753,58,0.206302909582414,0.206302909582414,-361,-1.28405776481468,1.28405776481468
"21","175","050","Morgan County",13726,13182,14530,-544,-3.96328136383506,3.96328136383506,804,5.85749672155034,5.85749672155034
"21","177","050","Muhlenberg County",30928,30510,31901,-418,-1.351526125194,1.351526125194,973,3.14601655457838,3.14601655457838
"21","179","050","Nelson County",46738,46403,47070,-335,-0.716761521674013,0.716761521674013,332,0.710342761778424,0.710342761778424
"21","181","050","Nicholas County",7537,7230,7236,-307,-4.07323868913361,4.07323868913361,-301,-3.99363141833621,3.99363141833621
"21","183","050","Ohio County",23772,23936,24488,164,0.689887262325425,0.689887262325425,716,3.01194682820125,3.01194682820125
"21","185","050","Oldham County",67607,66961,66116,-646,-0.955522357152366,0.955522357152366,-1491,-2.20539293268449,2.20539293268449
"21","187","050","Owen County",11278,10972,11141,-306,-2.71324702961518,2.71324702961518,-137,-1.21475438907608,1.21475438907608
"21","189","050","Owsley County",4051,4348,4845,297,7.33152308072081,7.33152308072081,794,19.6000987410516,19.6000987410516
"21","191","050","Pendleton County",14644,14575,15029,-69,-0.471182736957116,0.471182736957116,385,2.62906309751434,2.62906309751434
"21","193","050","Perry County",28473,25538,29386,-2935,-10.3080110982334,10.3080110982334,913,3.20654655287465,3.20654655287465
"21","195","050","Pike County",58669,57266,67076,-1403,-2.39138216093678,2.39138216093678,8407,14.3295437113297,14.3295437113297
"21","197","050","Powell County",13129,12226,12850,-903,-6.8779038769137,6.8779038769137,-279,-2.1250666463554,2.1250666463554
"21","199","050","Pulaski County",65034,65458,63379,424,0.651966663591352,0.651966663591352,-1655,-2.54482270812191,2.54482270812191
"21","201","050","Robertson County",2193,2140,2304,-53,-2.41678066575467,2.41678066575467,111,5.06155950752394,5.06155950752394
"21","203","050","Rockcastle County",16037,16738,17556,701,4.37114173473842,4.37114173473842,1519,9.47184635530336,9.47184635530336
"21","205","050","Rowan County",24662,24646,24136,-16,-0.0648771389181737,0.0648771389181737,-526,-2.13283594193496,2.13283594193496
"21","207","050","Russell County",17991,17963,17972,-28,-0.155633372241676,0.155633372241676,-19,-0.105608359735423,0.105608359735423
"21","209","050","Scott County",57155,58116,57073,961,1.68139270405039,1.68139270405039,-82,-0.143469512728545,0.143469512728545
"21","211","050","Shelby County",48065,49452,47202,1387,2.88567564756059,2.88567564756059,-863,-1.79548528034953,1.79548528034953
"21","213","050","Simpson County",19594,18607,18985,-987,-5.03725630294988,5.03725630294988,-609,-3.1080943145861,3.1080943145861
"21","215","050","Spencer County",19490,19497,19357,7,0.0359158542842483,0.0359158542842483,-133,-0.682401231400718,0.682401231400718
"21","217","050","Taylor County",26023,25693,24733,-330,-1.26810898051723,1.26810898051723,-1290,-4.95715328747646,4.95715328747646
"21","219","050","Todd County",12243,12417,12680,174,1.42122028914482,1.42122028914482,437,3.56938658825451,3.56938658825451
"21","221","050","Trigg County",14061,14736,14689,675,4.80051205461916,4.80051205461916,628,4.46625417822345,4.46625417822345
"21","223","050","Trimble County",8474,8474,9032,0,0,0,558,6.58484776964834,6.58484776964834
"21","225","050","Union County",13668,14434,15233,766,5.60433128475271,5.60433128475271,1565,11.4501024290313,11.4501024290313
"21","227","050","Warren County",134554,134118,136087,-436,-0.324033473549653,0.324033473549653,1533,1.13931952970555,1.13931952970555
"21","229","050","Washington County",12027,12122,12154,95,0.789889415481832,0.789889415481832,127,1.05595742911782,1.05595742911782
"21","231","050","Wayne County",19555,20203,20840,648,3.31373050370749,3.31373050370749,1285,6.57120940935822,6.57120940935822
"21","233","050","Webster County",13017,12914,13744,-103,-0.791272950756703,0.791272950756703,727,5.58500422524391,5.58500422524391
"21","235","050","Whitley County",36712,36408,36581,-304,-0.828067117018958,0.828067117018958,-131,-0.356831553715406,0.356831553715406
"21","237","050","Wolfe County",6562,7112,7535,550,8.38159097836026,8.38159097836026,973,14.8277964035355,14.8277964035355
"21","239","050","Woodford County",26871,26721,26598,-150,-0.558222619180529,0.558222619180529,-273,-1.01596516690856,1.01596516690856
"22","001","050","Acadia Parish",57576,62032,64771,4456,7.73933583437543,7.73933583437543,7195,12.4965263304155,12.4965263304155
"22","003","050","Allen Parish",22750,25509,26623,2759,12.1274725274725,12.1274725274725,3873,17.0241758241758,17.0241758241758
"22","005","050","Ascension Parish",126500,128291,131783,1791,1.41581027667984,1.41581027667984,5283,4.17628458498024,4.17628458498024
"22","007","050","Assumption Parish",21039,21734,24874,695,3.30338894434146,3.30338894434146,3835,18.2280526641,18.2280526641
"22","009","050","Avoyelles Parish",39693,40053,43749,360,0.906960925100144,0.906960925100144,4056,10.218426422795,10.218426422795
"22","011","050","Beauregard Parish",36549,37866,38830,1317,3.6033817614709,3.6033817614709,2281,6.24093682453692,6.24093682453692
"22","013","050","Bienville Parish",12981,13053,14809,72,0.554656806101225,0.554656806101225,1828,14.08212002157,14.08212002157
"22","015","050","Bossier Parish",128746,127400,139044,-1346,-1.04546937380579,1.04546937380579,10298,7.99869510509064,7.99869510509064
"22","017","050","Caddo Parish",237848,238399,258632,551,0.231660556321684,0.231660556321684,20784,8.73835390669671,8.73835390669671
"22","019","050","Calcasieu Parish",216785,203623,221393,-13162,-6.07145328320686,6.07145328320686,4608,2.12560832160897,2.12560832160897
"22","021","050","Caldwell Parish",9645,9878,10794,233,2.41575946086055,2.41575946086055,1149,11.9129082426128,11.9129082426128
"22","023","050","Cameron Parish",5617,7008,8289,1391,24.7641089549582,24.7641089549582,2672,47.5698771586256,47.5698771586256
"22","025","050","Catahoula Parish",8906,9292,10804,386,4.3341567482596,4.3341567482596,1898,21.3114754098361,21.3114754098361
"22","027","050","Claiborne Parish",14170,15576,17558,1406,9.92237120677488,9.92237120677488,3388,23.909668313338,23.909668313338
"22","029","050","Concordia Parish",18687,19034,21683,347,1.85690587039118,1.85690587039118,2996,16.032535987585,16.032535987585
"22","031","050","De Soto Parish",26812,27643,29183,831,3.09935849619573,3.09935849619573,2371,8.84305534835148,8.84305534835148
"22","033","050","East Baton Rouge Parish",456781,440452,462455,-16329,-3.57479842637938,3.57479842637938,5674,1.24217075578888,1.24217075578888
"22","035","050","East Carroll Parish",7459,6646,7759,-813,-10.899584394691,10.899584394691,300,4.02198686150959,4.02198686150959
"22","037","050","East Feliciana Parish",19539,18966,21972,-573,-2.93259634577,2.93259634577,2433,12.4520190388454,12.4520190388454
"22","039","050","Evangeline Parish",32350,33325,35249,975,3.01391035548686,3.01391035548686,2899,8.96136012364761,8.96136012364761
"22","041","050","Franklin Parish",19774,19809,21664,35,0.177000101142915,0.177000101142915,1890,9.55800546171741,9.55800546171741
"22","043","050","Grant Parish",22169,22283,23988,114,0.514231584645225,0.514231584645225,1819,8.2051513374532,8.2051513374532
"22","045","050","Iberia Parish",69929,69204,75972,-725,-1.0367658625177,1.0367658625177,6043,8.64162221681992,8.64162221681992
"22","047","050","Iberville Parish",30241,32207,36104,1966,6.50110776760028,6.50110776760028,5863,19.387586389339,19.387586389339
"22","049","050","Jackson Parish",15031,15633,16918,602,4.00505621715122,4.00505621715122,1887,12.5540549530969,12.5540549530969
"22","051","050","Jefferson Parish",440781,433079,431599,-7702,-1.74735299389039,1.74735299389039,-9182,-2.08312064267743,2.08312064267743
"22","053","050","Jefferson Davis Parish",32250,31297,33849,-953,-2.95503875968992,2.95503875968992,1599,4.95813953488372,4.95813953488372
"22","055","050","Lafayette Parish",241753,246211,250669,4458,1.84403089103341,1.84403089103341,8916,3.68806178206682,3.68806178206682
"22","057","050","Lafourche Parish",97557,97659,105174,102,0.104554260586119,0.104554260586119,7617,7.80774316553399,7.80774316553399
"22","059","050","LaSalle Parish",14791,14990,15442,199,1.34541275099723,1.34541275099723,651,4.40132513014671,4.40132513014671
"22","061","050","Lincoln Parish",48396,46641,49888,-1755,-3.62633275477312,3.62633275477312,1492,3.08289941317464,3.08289941317464
"22","063","050","Livingston Parish",142282,143240,151328,958,0.673310749075779,0.673310749075779,9046,6.35779648866336,6.35779648866336
"22","065","050","Madison Parish",10017,10736,13345,719,7.17779774383548,7.17779774383548,3328,33.2235200159728,33.2235200159728
"22","067","050","Morehouse Parish",25629,24382,28709,-1247,-4.86558195793827,4.86558195793827,3080,12.0176362714113,12.0176362714113
"22","069","050","Natchitoches Parish",37515,37797,41370,282,0.751699320271891,0.751699320271891,3855,10.2758896441423,10.2758896441423
"22","071","050","Orleans Parish",383997,390153,348858,6156,1.60313752451191,1.60313752451191,-35139,-9.15085274103704,9.15085274103704
"22","073","050","Ouachita Parish",160368,152757,166464,-7611,-4.74595929362466,4.74595929362466,6096,3.8012571086501,3.8012571086501
"22","075","050","Plaquemines Parish",23515,23154,24970,-361,-1.53519030406124,1.53519030406124,1455,6.18753986816925,6.18753986816925
"22","077","050","Pointe Coupee Parish",20758,21593,24148,835,4.02254552461702,4.02254552461702,3390,16.3310530879661,16.3310530879661
"22","079","050","Rapides Parish",130023,128944,139491,-1079,-0.829853179822031,0.829853179822031,9468,7.28178860663113,7.28178860663113
"22","081","050","Red River Parish",7620,8313,9362,693,9.09448818897638,9.09448818897638,1742,22.8608923884514,22.8608923884514
"22","083","050","Richland Parish",20043,20052,21854,9,0.0449034575662326,0.0449034575662326,1811,9.03557351693858,9.03557351693858
"22","085","050","Sabine Parish",22155,23829,26496,1674,7.55585646580907,7.55585646580907,4341,19.5937711577522,19.5937711577522
"22","087","050","St. Bernard Parish",43764,47553,37194,3789,8.6578009322731,8.6578009322731,-6570,-15.0123389086921,15.0123389086921
"22","089","050","St. Charles Parish",52549,53014,55799,465,0.884888389883728,0.884888389883728,3250,6.18470380026261,6.18470380026261
"22","091","050","St. Helena Parish",10920,10090,11866,-830,-7.6007326007326,7.6007326007326,946,8.66300366300366,8.66300366300366
"22","093","050","St. James Parish",20192,20805,23598,613,3.0358557844691,3.0358557844691,3406,16.8680665610143,16.8680665610143
"22","095","050","St. John the Baptist Parish",42477,42591,47067,114,0.268380535348542,0.268380535348542,4590,10.8058478706123,10.8058478706123
"22","097","050","St. Landry Parish",82540,81649,87411,-891,-1.07947661739763,1.07947661739763,4871,5.90138114853404,5.90138114853404
"22","099","050","St. Martin Parish",51767,53102,57119,1335,2.57886298220874,2.57886298220874,5352,10.3386327196863,10.3386327196863
"22","101","050","St. Mary Parish",49406,48587,56035,-819,-1.65769339756305,1.65769339756305,6629,13.4173986965146,13.4173986965146
"22","103","050","St. Tammany Parish",264570,262999,261663,-1571,-0.593793702989757,0.593793702989757,-2907,-1.0987640322032,1.0987640322032
"22","105","050","Tangipahoa Parish",133157,136313,141386,3156,2.37013450288006,2.37013450288006,8229,6.17992294809886,6.17992294809886
"22","107","050","Tensas Parish",4147,4202,5389,55,1.3262599469496,1.3262599469496,1242,29.9493609838437,29.9493609838437
"22","109","050","Terrebonne Parish",109580,110086,116889,506,0.461763095455375,0.461763095455375,7309,6.67001277605402,6.67001277605402
"22","111","050","Union Parish",21107,22152,24249,1045,4.95096413512105,4.95096413512105,3142,14.8860567584214,14.8860567584214
"22","113","050","Vermilion Parish",57359,59431,62321,2072,3.61233633780226,3.61233633780226,4962,8.65077843058631,8.65077843058631
"22","115","050","Vernon Parish",48750,47996,54826,-754,-1.54666666666667,1.54666666666667,6076,12.4635897435897,12.4635897435897
"22","117","050","Washington Parish",45463,45864,49017,401,0.882035941314915,0.882035941314915,3554,7.8173459736489,7.8173459736489
"22","119","050","Webster Parish",36967,38017,42647,1050,2.8403711418292,2.8403711418292,5680,15.3650553196094,15.3650553196094
"22","121","050","West Baton Rouge Parish",27199,26737,30506,-462,-1.69859185999485,1.69859185999485,3307,12.1585352402662,12.1585352402662
"22","123","050","West Carroll Parish",9751,10702,12050,951,9.75284586196288,9.75284586196288,2299,23.5770690185622,23.5770690185622
"22","125","050","West Feliciana Parish",15310,15491,17116,181,1.18223383409536,1.18223383409536,1806,11.796211626388,11.796211626388
"22","127","050","Winn Parish",13755,13860,15512,105,0.763358778625954,0.763358778625954,1757,12.7735368956743,12.7735368956743
"23","001","050","Androscoggin County",111139,108597,110714,-2542,-2.28722590629752,2.28722590629752,-425,-0.382404016591835,0.382404016591835
"23","003","050","Aroostook County",67105,66945,72933,-160,-0.238432307577677,0.238432307577677,5828,8.68489680351688,8.68489680351688
"23","005","050","Cumberland County",303069,297753,301371,-5316,-1.7540560070479,1.7540560070479,-1698,-0.56026845371846,0.56026845371846
"23","007","050","Franklin County",29456,30021,31808,565,1.91811515480717,1.91811515480717,2352,7.98479087452472,7.98479087452472
"23","009","050","Hancock County",55478,55149,56642,-329,-0.593027866902195,0.593027866902195,1164,2.09812898806734,2.09812898806734
"23","011","050","Kennebec County",123642,122842,127113,-800,-0.647029326604228,0.647029326604228,3471,2.8072984908041,2.8072984908041
"23","013","050","Knox County",40607,39936,41264,-671,-1.65242445883715,1.65242445883715,657,1.61794764449479,1.61794764449479
"23","015","050","Lincoln County",35237,34791,35541,-446,-1.2657150154667,1.2657150154667,304,0.86272951726878,0.86272951726878
"23","017","050","Oxford County",57777,58084,60011,307,0.531353306679128,0.531353306679128,2234,3.86659051179535,3.86659051179535
"23","019","050","Penobscot County",152199,151730,159555,-469,-0.308149199403413,0.308149199403413,7356,4.83314607848935,4.83314607848935
"23","021","050","Piscataquis County",16800,16973,17764,173,1.0297619047619,1.0297619047619,964,5.73809523809524,5.73809523809524
"23","023","050","Sagadahoc County",36699,36054,36908,-645,-1.75754107741355,1.75754107741355,209,0.569497806479741,0.569497806479741
"23","025","050","Somerset County",50477,50658,53163,181,0.358579154862611,0.358579154862611,2686,5.32123541414902,5.32123541414902
"23","027","050","Waldo County",39607,39871,41127,264,0.666548842376348,0.666548842376348,1520,3.83770545610624,3.83770545610624
"23","029","050","Washington County",31095,31423,33501,328,1.05483196655411,1.05483196655411,2406,7.73757838880849,7.73757838880849
"23","031","050","York County",211972,208820,210113,-3152,-1.48698884758364,1.48698884758364,-1859,-0.877002622987942,0.877002622987942
"24","001","050","Allegany County",68106,70217,73692,2111,3.09958006636713,3.09958006636713,5586,8.20192053563563,8.20192053563563
"24","003","050","Anne Arundel County",588261,582384,580529,-5877,-0.999046341674869,0.999046341674869,-7732,-1.31438256148206,1.31438256148206
"24","005","050","Baltimore County",854535,827220,812244,-27315,-3.19647527602731,3.19647527602731,-42291,-4.94900735487721,4.94900735487721
"24","009","050","Calvert County",92783,93033,94015,250,0.26944591142774,0.26944591142774,1232,1.3278294515159,1.3278294515159
"24","011","050","Caroline County",33293,33521,33569,228,0.684828642657616,0.684828642657616,276,0.82900309374343,0.82900309374343
"24","013","050","Carroll County",172891,169105,171746,-3786,-2.18981901891943,2.18981901891943,-1145,-0.662266977459787,0.662266977459787
"24","015","050","Cecil County",103725,103409,105305,-316,-0.304651723306821,0.304651723306821,1580,1.5232586165341,1.5232586165341
"24","017","050","Charles County",166617,164382,166220,-2235,-1.34139973712166,1.34139973712166,-397,-0.238271004759418,0.238271004759418
"24","019","050","Dorchester County",32531,31886,33062,-645,-1.98272417079094,1.98272417079094,531,1.63228920106975,1.63228920106975
"24","021","050","Frederick County",271717,264158,265352,-7559,-2.78193856107641,2.78193856107641,-6365,-2.34251077407744,2.34251077407744
"24","023","050","Garrett County",28806,28916,31134,110,0.381864889259182,0.381864889259182,2328,8.0816496563216,8.0816496563216
"24","025","050","Harford County",260924,256602,261693,-4322,-1.65642102681241,1.65642102681241,769,0.29472183471049,0.29472183471049
"24","027","050","Howard County",332317,327874,323205,-4443,-1.33697644116912,1.33697644116912,-9112,-2.74196023676189,2.74196023676189
"24","029","050","Kent County",19198,19282,20461,84,0.43754557766434,0.43754557766434,1263,6.57881029273883,6.57881029273883
"24","031","050","Montgomery County",1062061,1052462,1016021,-9599,-0.903808726617398,0.903808726617398,-46040,-4.33496757719189,4.33496757719189
"24","033","050","Prince George's County",967201,910800,885773,-56401,-5.83136287079935,5.83136287079935,-81428,-8.41893256934184,8.41893256934184
"24","035","050","Queen Anne's County",49874,51045,51624,1171,2.34791675021053,2.34791675021053,1750,3.50884228255203,3.50884228255203
"24","037","050","St. Mary's County",113777,114489,120419,712,0.625785527830757,0.625785527830757,6642,5.8377352188931,5.8377352188931
"24","039","050","Somerset County",24620,25482,27290,862,3.50121852152721,3.50121852152721,2670,10.8448415922015,10.8448415922015
"24","041","050","Talbot County",37526,37060,39186,-466,-1.24180568139423,1.24180568139423,1660,4.42359963758461,4.42359963758461
"24","043","050","Washington County",154705,151158,149889,-3547,-2.29275071911057,2.29275071911057,-4816,-3.11302155715717,3.11302155715717
"24","045","050","Wicomico County",103588,104018,102238,430,0.41510599683361,0.41510599683361,-1350,-1.30323975750087,1.30323975750087
"24","047","050","Worcester County",52460,52377,52417,-83,-0.15821578345406,0.15821578345406,-43,-0.0819672131147541,0.0819672131147541
"24","510","050","Baltimore city",585708,588649,613761,2941,0.50212733990316,0.50212733990316,28053,4.78958798582229,4.78958798582229
"25","001","050","Barnstable County",228996,213296,222237,-15700,-6.85601495222624,6.85601495222624,-6759,-2.95157994026097,2.95157994026097
"25","003","050","Berkshire County",129026,124804,132983,-4222,-3.27220870212205,3.27220870212205,3957,3.06682374095144,3.06682374095144
"25","005","050","Bristol County",579200,566625,564426,-12575,-2.17109806629834,2.17109806629834,-14774,-2.55075966850829,2.55075966850829
"25","007","050","Dukes County",20600,17474,17551,-3126,-15.1747572815534,15.1747572815534,-3049,-14.8009708737864,14.8009708737864
"25","009","050","Essex County",809829,791347,764582,-18482,-2.28221019499178,2.28221019499178,-45247,-5.58722890881902,5.58722890881902
"25","011","050","Franklin County",71029,70323,72419,-706,-0.993960213433949,0.993960213433949,1390,1.95694716242661,1.95694716242661
"25","013","050","Hampden County",465825,464723,468069,-1102,-0.236569527182955,0.236569527182955,2244,0.481725970053132,0.481725970053132
"25","015","050","Hampshire County",162308,161518,163348,-790,-0.486728935111023,0.486728935111023,1040,0.640757079133499,0.640757079133499
"25","017","050","Middlesex County",1632002,1610956,1594083,-21046,-1.28958175296354,1.28958175296354,-37919,-2.32346528987097,2.32346528987097
"25","019","050","Nantucket County",14255,11353,11192,-2902,-20.3577692037881,20.3577692037881,-3063,-21.4871974745703,21.4871974745703
"25","021","050","Norfolk County",725981,709317,702829,-16664,-2.29537687625434,2.29537687625434,-23152,-3.18906417661068,3.18906417661068
"25","023","050","Plymouth County",530819,523502,519947,-7317,-1.37843596404801,1.37843596404801,-10872,-2.04815577437884,2.04815577437884
"25","025","050","Suffolk County",797936,803229,795629,5293,0.663336407932466,0.663336407932466,-2307,-0.289120932004572,0.289120932004572
"25","027","050","Worcester County",862111,829649,828581,-32462,-3.76540839868648,3.76540839868648,-33530,-3.88929035820213,3.88929035820213
"26","001","050","Alcona County",10167,10510,11123,343,3.37365988000393,3.37365988000393,956,9.4029703944133,9.4029703944133
"26","003","050","Alger County",8842,9050,9853,208,2.35240895724949,2.35240895724949,1011,11.4340646912463,11.4340646912463
"26","005","050","Allegan County",120502,118779,117792,-1723,-1.42985178669234,1.42985178669234,-2710,-2.24892532904018,2.24892532904018
"26","007","050","Alpena County",28907,28306,29651,-601,-2.07908119140693,2.07908119140693,744,2.57377105891307,2.57377105891307
"26","009","050","Antrim County",23431,23461,24139,30,0.128035508514361,0.128035508514361,708,3.02163800093893,3.02163800093893
"26","011","050","Arenac County",15002,14989,16059,-13,-0.0866551126516464,0.0866551126516464,1057,7.04572723636849,7.04572723636849
"26","013","050","Baraga County",8158,8205,8930,47,0.576121598430988,0.576121598430988,772,9.46310370188772,9.46310370188772
"26","015","050","Barry County",62423,61972,61600,-451,-0.722490107812825,0.722490107812825,-823,-1.31842429873604,1.31842429873604
"26","017","050","Bay County",103856,102596,108133,-1260,-1.21321830226467,1.21321830226467,4277,4.11820212602064,4.11820212602064
"26","019","050","Benzie County",17970,17852,18226,-118,-0.656649972175849,0.656649972175849,256,1.42459654980523,1.42459654980523
"26","021","050","Berrien County",154316,153226,158920,-1090,-0.706342829000233,0.706342829000233,4604,2.98348842634594,2.98348842634594
"26","023","050","Branch County",44862,43479,45765,-1383,-3.08278721412331,3.08278721412331,903,2.01283937408051,2.01283937408051
"26","025","050","Calhoun County",134310,133733,135809,-577,-0.429603156875884,0.429603156875884,1499,1.11607475243839,1.11607475243839
"26","027","050","Cass County",51589,51688,53695,99,0.191901374323984,0.191901374323984,2106,4.08226559925566,4.08226559925566
"26","029","050","Charlevoix County",26054,26159,26960,105,0.403009134873724,0.403009134873724,906,3.4773931066247,3.4773931066247
"26","031","050","Cheboygan County",25579,25380,26710,-199,-0.777981938308769,0.777981938308769,1131,4.42159584033778,4.42159584033778
"26","033","050","Chippewa County",36785,37064,39255,279,0.758461329346201,0.758461329346201,2470,6.71469348919396,6.71469348919396
"26","035","050","Clare County",30856,30840,31285,-16,-0.0518537723619393,0.0518537723619393,429,1.3903292714545,1.3903292714545
"26","037","050","Clinton County",79128,79777,79544,649,0.820190071782428,0.820190071782428,416,0.525730462036194,0.525730462036194
"26","039","050","Crawford County",12988,14000,14317,1012,7.79180782260548,7.79180782260548,1329,10.232522328303,10.232522328303
"26","041","050","Delta County",36903,35675,37491,-1228,-3.3276427390727,3.3276427390727,588,1.59336639297618,1.59336639297618
"26","043","050","Dickinson County",25947,25189,26449,-758,-2.92133965390989,2.92133965390989,502,1.93471306894824,1.93471306894824
"26","045","050","Eaton County",109175,110195,109568,1020,0.934279825967483,0.934279825967483,393,0.359972521181589,0.359972521181589
"26","047","050","Emmet County",34112,33368,33624,-744,-2.18105065666041,2.18105065666041,-488,-1.43058161350844,1.43058161350844
"26","049","050","Genesee County",406211,405242,428017,-969,-0.238545977336901,0.238545977336901,21806,5.36814611125745,5.36814611125745
"26","051","050","Gladwin County",25386,25440,26198,54,0.212715670054361,0.212715670054361,812,3.19861340896557,3.19861340896557
"26","053","050","Gogebic County",14380,13890,16413,-490,-3.40751043115438,3.40751043115438,2033,14.1376912378303,14.1376912378303
"26","055","050","Grand Traverse County",95238,93515,95145,-1723,-1.80915180915181,1.80915180915181,-93,-0.0976500976500976,0.0976500976500976
"26","057","050","Gratiot County",41761,40415,42590,-1346,-3.22310289504562,3.22310289504562,829,1.98510572064845,1.98510572064845
"26","059","050","Hillsdale County",45746,45664,47579,-82,-0.179250644865125,0.179250644865125,1833,4.00690770777773,4.00690770777773
"26","061","050","Houghton County",37361,35285,37277,-2076,-5.55659645084446,5.55659645084446,-84,-0.224833382404111,0.224833382404111
"26","063","050","Huron County",31407,30721,33321,-686,-2.18422644633362,2.18422644633362,1914,6.09418282548476,6.09418282548476
"26","065","050","Ingham County",284900,290986,288705,6086,2.13618813618814,2.13618813618814,3805,1.33555633555634,1.33555633555634
"26","067","050","Ionia County",66804,64600,65170,-2204,-3.29920364050057,3.29920364050057,-1634,-2.44596131968146,2.44596131968146
"26","069","050","Iosco County",25237,25185,26104,-52,-0.206046677497325,0.206046677497325,867,3.43543210365733,3.43543210365733
"26","071","050","Iron County",11631,11074,12021,-557,-4.78892614564526,4.78892614564526,390,3.35310807325251,3.35310807325251
"26","073","050","Isabella County",64394,69581,72726,5187,8.05509830108395,8.05509830108395,8332,12.9390937043824,12.9390937043824
"26","075","050","Jackson County",160366,157359,161560,-3007,-1.87508574136662,1.87508574136662,1194,0.744546849082723,0.744546849082723
"26","077","050","Kalamazoo County",261670,266005,258148,4335,1.65666679405358,1.65666679405358,-3522,-1.34597011503038,1.34597011503038
"26","079","050","Kalkaska County",17939,18010,17618,71,0.395785718267462,0.395785718267462,-321,-1.78939740230782,1.78939740230782
"26","081","050","Kent County",657974,658530,637262,556,0.0845018192208203,0.0845018192208203,-20712,-3.1478447476648,3.1478447476648
"26","083","050","Keweenaw County",2046,2110,2202,64,3.12805474095797,3.12805474095797,156,7.62463343108504,7.62463343108504
"26","085","050","Lake County",12096,11624,11983,-472,-3.9021164021164,3.9021164021164,-113,-0.934193121693122,0.934193121693122
"26","087","050","Lapeer County",88619,87726,90115,-893,-1.00768458231305,1.00768458231305,1496,1.68812557126576,1.68812557126576
"26","089","050","Leelanau County",22301,21732,23291,-569,-2.55145509169992,2.55145509169992,990,4.43926281332676,4.43926281332676
"26","091","050","Lenawee County",99423,98041,101167,-1382,-1.39002041781077,1.39002041781077,1744,1.75412127978436,1.75412127978436
"26","093","050","Livingston County",193866,192338,194420,-1528,-0.788173274323502,0.788173274323502,554,0.28576439396284,0.28576439396284
"26","095","050","Luce County",5339,6149,6706,810,15.1713804083162,15.1713804083162,1367,25.6040457014422,25.6040457014422
"26","097","050","Mackinac County",10834,10832,11431,-2,-0.0184604024367731,0.0184604024367731,597,5.51043012737678,5.51043012737678
"26","099","050","Macomb County",881217,871621,874372,-9596,-1.08894857906736,1.08894857906736,-6845,-0.776766676085459,0.776766676085459
"26","101","050","Manistee County",25032,24695,25103,-337,-1.34627676573985,1.34627676573985,71,0.28363694471077,0.28363694471077
"26","103","050","Marquette County",66017,66067,68409,50,0.0757380674674705,0.0757380674674705,2392,3.62330914764379,3.62330914764379
"26","105","050","Mason County",29052,29170,29515,118,0.406168250034421,0.406168250034421,463,1.59369406581302,1.59369406581302
"26","107","050","Mecosta County",39714,43841,44556,4127,10.391801379866,10.391801379866,4842,12.1921740444176,12.1921740444176
"26","109","050","Menominee County",23502,22645,24289,-857,-3.64649817036848,3.64649817036848,787,3.3486511786231,3.3486511786231
"26","111","050","Midland County",83494,83470,86712,-24,-0.0287445804488945,0.0287445804488945,3218,3.85416916185594,3.85416916185594
"26","113","050","Missaukee County",15052,15141,15196,89,0.591283550358756,0.591283550358756,144,0.956683497209673,0.956683497209673
"26","115","050","Monroe County",154809,150577,158032,-4232,-2.73369119366445,2.73369119366445,3223,2.08192030179124,2.08192030179124
"26","117","050","Montcalm County",66614,63548,64832,-3066,-4.60263608250518,4.60263608250518,-1782,-2.67511333953824,2.67511333953824
"26","119","050","Montmorency County",9153,9327,9790,174,1.9010160603081,1.9010160603081,637,6.95946684147274,6.95946684147274
"26","121","050","Muskegon County",175824,173897,174887,-1927,-1.09598234598235,1.09598234598235,-937,-0.532919282919283,0.532919282919283
"26","123","050","Newaygo County",49978,49267,50069,-711,-1.42262595542038,1.42262595542038,91,0.18208011525071,0.18208011525071
"26","125","050","Oakland County",1274395,1255261,1245707,-19134,-1.5014183200656,1.5014183200656,-28688,-2.25110738821166,2.25110738821166
"26","127","050","Oceana County",26659,26762,27190,103,0.386361078810158,0.386361078810158,531,1.99182264901159,1.99182264901159
"26","129","050","Ogemaw County",20770,20921,21993,151,0.727010110736639,0.727010110736639,1223,5.88830043331728,5.88830043331728
"26","131","050","Ontonagon County",5816,5672,6821,-144,-2.47592847317744,2.47592847317744,1005,17.2799174690509,17.2799174690509
"26","133","050","Osceola County",22891,23432,23972,541,2.36337425188939,2.36337425188939,1081,4.72237997466253,4.72237997466253
"26","135","050","Oscoda County",8219,8354,8798,135,1.64253558827108,1.64253558827108,579,7.04465263414041,7.04465263414041
"26","137","050","Otsego County",25091,24719,24507,-372,-1.482603323901,1.482603323901,-584,-2.32752779881232,2.32752779881232
"26","139","050","Ottawa County",296200,293970,290721,-2230,-0.75286968264686,0.75286968264686,-5479,-1.84976367319379,1.84976367319379
"26","141","050","Presque Isle County",12982,12653,13477,-329,-2.53427823139732,2.53427823139732,495,3.81297180711755,3.81297180711755
"26","143","050","Roscommon County",23459,23978,24617,519,2.21237051877744,2.21237051877744,1158,4.93627179334158,4.93627179334158
"26","145","050","Saginaw County",190124,190103,203135,-21,-0.0110454229871032,0.0110454229871032,13011,6.8434284992952,6.8434284992952
"26","147","050","St. Clair County",160383,159349,165246,-1034,-0.644706733257265,0.644706733257265,4863,3.03211687024186,3.03211687024186
"26","149","050","St. Joseph County",60939,60872,61996,-67,-0.109946011585356,0.109946011585356,1057,1.73452140665255,1.73452140665255
"26","151","050","Sanilac County",40611,40857,43971,246,0.605747211346679,0.605747211346679,3360,8.27362044766196,8.27362044766196
"26","153","050","Schoolcraft County",8047,8087,8595,40,0.497079657015037,0.497079657015037,548,6.809991301106,6.809991301106
"26","155","050","Shiawassee County",68094,67809,70568,-285,-0.418539078332893,0.418539078332893,2474,3.63321291156343,3.63321291156343
"26","157","050","Tuscola County",53323,52313,55950,-1010,-1.89411698516588,1.89411698516588,2627,4.92657952478293,4.92657952478293
"26","159","050","Van Buren County",75587,75524,78083,-63,-0.0833476656038737,0.0833476656038737,2496,3.30215513249633,3.30215513249633
"26","161","050","Washtenaw County",372258,367108,357394,-5150,-1.38344911324941,1.38344911324941,-14864,-3.99292963482316,3.99292963482316
"26","163","050","Wayne County",1793561,1744071,1806629,-49490,-2.75931512783786,2.75931512783786,13068,0.728606386958682,0.728606386958682
"26","165","050","Wexford County",33673,33702,33493,29,0.0861224126154486,0.0861224126154486,-180,-0.534552905888991,0.534552905888991
"27","001","050","Aitkin County",15697,15877,17299,180,1.14671593298082,1.14671593298082,1602,10.2057718035293,10.2057718035293
"27","003","050","Anoka County",363887,359504,353985,-4383,-1.20449480195775,1.20449480195775,-9902,-2.72117443052376,2.72117443052376
"27","005","050","Becker County",35183,34515,35038,-668,-1.89864423158912,1.89864423158912,-145,-0.412130858653327,0.412130858653327
"27","007","050","Beltrami County",46228,47438,47815,1210,2.6174612788786,2.6174612788786,1587,3.43298433849615,3.43298433849615
"27","009","050","Benton County",41379,40999,42103,-380,-0.91834022088499,0.91834022088499,724,1.74967978926509,1.74967978926509
"27","011","050","Big Stone County",5166,4941,5366,-225,-4.35540069686411,4.35540069686411,200,3.87146728610143,3.87146728610143
"27","013","050","Blue Earth County",69112,68220,71564,-892,-1.29065864104642,1.29065864104642,2452,3.54786433615002,3.54786433615002
"27","015","050","Brown County",25912,24910,26643,-1002,-3.86693423896264,3.86693423896264,731,2.82108675517135,2.82108675517135
"27","017","050","Carlton County",36207,35826,36973,-381,-1.05228270776369,1.05228270776369,766,2.11561300301047,2.11561300301047
"27","019","050","Carver County",106922,106250,105869,-672,-0.628495538803988,0.628495538803988,-1053,-0.984830063036606,0.984830063036606
"27","021","050","Cass County",30066,29892,30353,-174,-0.578726801037717,0.578726801037717,287,0.954566620102441,0.954566620102441
"27","023","050","Chippewa County",12598,11781,12408,-817,-6.48515637402762,6.48515637402762,-190,-1.50817590093666,1.50817590093666
"27","025","050","Chisago County",56621,56763,57409,142,0.250790342805673,0.250790342805673,788,1.39170978965402,1.39170978965402
"27","027","050","Clay County",65318,64668,67290,-650,-0.995131510456536,0.995131510456536,1972,3.01907590556967,3.01907590556967
"27","029","050","Clearwater County",8524,8980,8753,456,5.34960112623182,5.34960112623182,229,2.68653214453308,2.68653214453308
"27","031","050","Cook County",5600,5429,5581,-171,-3.05357142857143,3.05357142857143,-19,-0.339285714285714,0.339285714285714
"27","033","050","Cottonwood County",11517,11277,11737,-240,-2.08387600937744,2.08387600937744,220,1.91021967526266,1.91021967526266
"27","035","050","Crow Wing County",66123,65573,66925,-550,-0.831783191930191,0.831783191930191,802,1.21289112714184,1.21289112714184
"27","037","050","Dakota County",439882,431437,428324,-8445,-1.9198330461351,1.9198330461351,-11558,-2.62752283566957,2.62752283566957
"27","039","050","Dodge County",20867,21007,21389,140,0.670915800067092,0.670915800067092,522,2.5015574831073,2.5015574831073
"27","041","050","Douglas County",39006,38300,39188,-706,-1.80997795210993,1.80997795210993,182,0.466594882838538,0.466594882838538
"27","043","050","Faribault County",13921,13649,14446,-272,-1.95388262337476,1.95388262337476,525,3.77128079879319,3.77128079879319
"27","045","050","Fillmore County",21228,21138,21704,-90,-0.423968343697004,0.423968343697004,476,2.24232146221971,2.24232146221971
"27","047","050","Freeborn County",30895,30408,31537,-487,-1.57630684576792,1.57630684576792,642,2.07800614986244,2.07800614986244
"27","049","050","Goodhue County",47582,46370,47511,-1212,-2.54718170736833,2.54718170736833,-71,-0.149216090118112,0.149216090118112
"27","051","050","Grant County",6074,6022,5971,-52,-0.856108001317089,0.856108001317089,-103,-1.69575238722423,1.69575238722423
"27","053","050","Hennepin County",1281565,1268278,1244052,-13287,-1.03677925036967,1.03677925036967,-37513,-2.92712425823115,2.92712425823115
"27","055","050","Houston County",18843,18645,19511,-198,-1.0507880910683,1.0507880910683,668,3.54508305471528,3.54508305471528
"27","057","050","Hubbard County",21344,21756,20902,412,1.93028485757121,1.93028485757121,-442,-2.0708395802099,2.0708395802099
"27","059","050","Isanti County",41135,41221,41136,86,0.209067703901787,0.209067703901787,1,0.00243101981281147,0.00243101981281147
"27","061","050","Itasca County",45014,45275,46462,261,0.579819611676367,0.579819611676367,1448,3.21677700271027,3.21677700271027
"27","063","050","Jackson County",9989,9789,10447,-200,-2.00220242266493,2.00220242266493,458,4.58504354790269,4.58504354790269
"27","065","050","Kanabec County",16032,16409,16650,377,2.35154690618762,2.35154690618762,618,3.85479041916168,3.85479041916168
"27","067","050","Kandiyohi County",43732,43154,43742,-578,-1.32168663678771,1.32168663678771,10,0.0228665508094759,0.0228665508094759
"27","069","050","Kittson County",4207,4231,4561,24,0.570477775136677,0.570477775136677,354,8.41454718326599,8.41454718326599
"27","071","050","Koochiching County",12062,12107,13420,45,0.37307245896203,0.37307245896203,1358,11.2584977615652,11.2584977615652
"27","073","050","Lac qui Parle County",6719,6556,7272,-163,-2.42595624348861,2.42595624348861,553,8.23039142729573,8.23039142729573
"27","075","050","Lake County",10905,10651,11408,-254,-2.32920678587804,2.32920678587804,503,4.61256304447501,4.61256304447501
"27","077","050","Lake of the Woods County",3763,3756,4314,-7,-0.186021791124103,0.186021791124103,551,14.6425724156258,14.6425724156258
"27","079","050","Le Sueur County",28674,28791,28873,117,0.408035153797866,0.408035153797866,199,0.694008509451071,0.694008509451071
"27","081","050","Lincoln County",5640,5587,5973,-53,-0.939716312056738,0.939716312056738,333,5.90425531914894,5.90425531914894
"27","083","050","Lyon County",25269,25374,26562,105,0.415528908939808,0.415528908939808,1293,5.1169417072302,5.1169417072302
"27","085","050","McLeod County",36771,35758,37438,-1013,-2.75488836311224,2.75488836311224,667,1.81392945527726,1.81392945527726
"27","087","050","Mahnomen County",5411,5475,5405,64,1.18277582701904,1.18277582701904,-6,-0.110885233783035,0.110885233783035
"27","089","050","Marshall County",9040,9332,9449,292,3.23008849557522,3.23008849557522,409,4.52433628318584,4.52433628318584
"27","091","050","Martin County",20025,19537,20760,-488,-2.43695380774032,2.43695380774032,735,3.67041198501873,3.67041198501873
"27","093","050","Meeker County",23400,23314,24169,-86,-0.367521367521368,0.367521367521368,769,3.28632478632479,3.28632478632479
"27","095","050","Mille Lacs County",26459,26139,26817,-320,-1.20941834536453,1.20941834536453,358,1.35303677387656,1.35303677387656
"27","097","050","Morrison County",34010,33229,34595,-781,-2.29638341664216,2.29638341664216,585,1.72008232872684,1.72008232872684
"27","099","050","Mower County",40029,40135,39448,106,0.264808014189712,0.264808014189712,-581,-1.4514477004172,1.4514477004172
"27","101","050","Murray County",8179,8167,8943,-12,-0.146717202592004,0.146717202592004,764,9.34099523169091,9.34099523169091
"27","103","050","Nicollet County",34454,34458,34872,4,0.0116096824751843,0.0116096824751843,418,1.21321181865676,1.21321181865676
"27","105","050","Nobles County",22290,21488,21776,-802,-3.59802602063706,3.59802602063706,-514,-2.30596680125617,2.30596680125617
"27","107","050","Norman County",6441,6345,6889,-96,-1.49045179319981,1.49045179319981,448,6.95544170159913,6.95544170159913
"27","109","050","Olmsted County",162847,159124,164026,-3723,-2.28619501740898,2.28619501740898,1179,0.723992459179475,0.723992459179475
"27","111","050","Otter Tail County",60081,58738,58628,-1343,-2.23531565719612,2.23531565719612,-1453,-2.41840182420399,2.41840182420399
"27","113","050","Pennington County",13992,13917,14777,-75,-0.536020583190394,0.536020583190394,785,5.61034877072613,5.61034877072613
"27","115","050","Pine County",28876,29390,30670,514,1.78002493420141,1.78002493420141,1794,6.21277185205707,6.21277185205707
"27","117","050","Pipestone County",9424,9118,9672,-306,-3.24702886247878,3.24702886247878,248,2.63157894736842,2.63157894736842
"27","119","050","Polk County",31192,30994,32718,-198,-0.634778148243139,0.634778148243139,1526,4.89228007181329,4.89228007181329
"27","121","050","Pope County",11308,11264,11514,-44,-0.389105058365759,0.389105058365759,206,1.82171913689423,1.82171913689423
"27","123","050","Ramsey County",552352,548750,522246,-3602,-0.652120386999595,0.652120386999595,-30106,-5.45050981982504,5.45050981982504
"27","125","050","Red Lake County",3935,4033,4091,98,2.49047013977128,2.49047013977128,156,3.96442185514612,3.96442185514612
"27","127","050","Redwood County",15425,15099,16235,-326,-2.11345218800648,2.11345218800648,810,5.25121555915721,5.25121555915721
"27","129","050","Renville County",14723,14436,15719,-287,-1.94933097874075,1.94933097874075,996,6.76492562657067,6.76492562657067
"27","131","050","Rice County",67097,67089,66630,-8,-0.0119230367974723,0.0119230367974723,-467,-0.696007273052446,0.696007273052446
"27","133","050","Rock County",9704,9305,9886,-399,-4.11170651277824,4.11170651277824,182,1.8755152514427,1.8755152514427
"27","135","050","Roseau County",15331,15104,16048,-227,-1.48066010045007,1.48066010045007,717,4.6767986432718,4.6767986432718
"27","137","050","St. Louis County",200231,198761,205364,-1470,-0.734152054377194,0.734152054377194,5133,2.56353911232526,2.56353911232526
"27","139","050","Scott County",150928,150307,148394,-621,-0.411454468355772,0.411454468355772,-2534,-1.67894625251776,1.67894625251776
"27","141","050","Sherburne County",97183,98469,95964,1286,1.32327670477347,1.32327670477347,-1219,-1.2543346058467,1.2543346058467
"27","143","050","Sibley County",14836,14762,15417,-74,-0.498786734968994,0.498786734968994,581,3.91614990563494,3.91614990563494
"27","145","050","Stearns County",158292,161860,160308,3568,2.25406211305688,2.25406211305688,2016,1.2735956333864,1.2735956333864
"27","147","050","Steele County",37406,36635,37823,-771,-2.06116665775544,2.06116665775544,417,1.11479441800781,1.11479441800781
"27","149","050","Stevens County",9671,9747,9979,76,0.785854616895874,0.785854616895874,308,3.18477923689381,3.18477923689381
"27","151","050","Swift County",9838,9180,9792,-658,-6.68835129091279,6.68835129091279,-46,-0.467574710306973,0.467574710306973
"27","153","050","Todd County",25262,24738,25903,-524,-2.07426173699628,2.07426173699628,641,2.53740796453171,2.53740796453171
"27","155","050","Traverse County",3360,3208,3611,-152,-4.52380952380952,4.52380952380952,251,7.47023809523809,7.47023809523809
"27","157","050","Wabasha County",21387,21608,22419,221,1.03333800907093,1.03333800907093,1032,4.82536120072942,4.82536120072942
"27","159","050","Wadena County",14065,13752,14481,-313,-2.22538215428368,2.22538215428368,416,2.9576964095272,2.9576964095272
"27","161","050","Waseca County",18968,18548,19293,-420,-2.21425558835934,2.21425558835934,325,1.71341206242092,1.71341206242092
"27","163","050","Washington County",267568,264834,263599,-2734,-1.02179632840997,1.02179632840997,-3969,-1.48336123901214,1.48336123901214
"27","165","050","Watonwan County",11253,10806,11229,-447,-3.9722740602506,3.9722740602506,-24,-0.21327645961077,0.21327645961077
"27","167","050","Wilkin County",6506,6170,6762,-336,-5.1644635720873,5.1644635720873,256,3.93482938825699,3.93482938825699
"27","169","050","Winona County",49671,50537,52978,866,1.7434720460631,1.7434720460631,3307,6.65780837913471,6.65780837913471
"27","171","050","Wright County",141337,139840,137587,-1497,-1.0591706347241,1.0591706347241,-3750,-2.65323305291608,2.65323305291608
"27","173","050","Yellow Medicine County",9528,9601,10452,73,0.766162888329135,0.766162888329135,924,9.69773299748111,9.69773299748111
"28","001","050","Adams County",29538,30446,32489,908,3.07400636468278,3.07400636468278,2951,9.99052068521904,9.99052068521904
"28","003","050","Alcorn County",34740,36981,37585,2241,6.45077720207254,6.45077720207254,2845,8.18940702360391,8.18940702360391
"28","005","050","Amite County",12720,12250,13640,-470,-3.69496855345912,3.69496855345912,920,7.23270440251572,7.23270440251572
"28","007","050","Attala County",17889,18077,19980,188,1.05092514953323,1.05092514953323,2091,11.6887472748616,11.6887472748616
"28","009","050","Benton County",7646,8347,8980,701,9.16819251896417,9.16819251896417,1334,17.4470311273869,17.4470311273869
"28","011","050","Bolivar County",30985,30335,34979,-650,-2.09778925286429,2.09778925286429,3994,12.8901081168307,12.8901081168307
"28","013","050","Calhoun County",13266,14292,15243,1026,7.73405698778833,7.73405698778833,1977,14.9027589326097,14.9027589326097
"28","015","050","Carroll County",9998,9790,10979,-208,-2.08041608321664,2.08041608321664,981,9.8119623924785,9.8119623924785
"28","017","050","Chickasaw County",17106,16992,17637,-114,-0.666432830585759,0.666432830585759,531,3.10417397404419,3.10417397404419
"28","019","050","Choctaw County",8246,8100,8723,-146,-1.77055542081009,1.77055542081009,477,5.78462284744118,5.78462284744118
"28","021","050","Claiborne County",9135,8944,9982,-191,-2.09085933223864,2.09085933223864,847,9.272030651341,9.272030651341
"28","023","050","Clarke County",15615,15371,17132,-244,-1.56260006404099,1.56260006404099,1517,9.71501761127121,9.71501761127121
"28","025","050","Clay County",18636,19375,21099,739,3.96544322816055,3.96544322816055,2463,13.2163554410818,13.2163554410818
"28","027","050","Coahoma County",21390,21723,25921,333,1.55680224403927,1.55680224403927,4531,21.1827956989247,21.1827956989247
"28","029","050","Copiah County",28368,28029,30007,-339,-1.19500846023689,1.19500846023689,1639,5.77763677382967,5.77763677382967
"28","031","050","Covington County",18340,18560,20234,220,1.19956379498364,1.19956379498364,1894,10.3271537622683,10.3271537622683
"28","033","050","DeSoto County",185314,187678,185013,2364,1.27567264211015,1.27567264211015,-301,-0.162427015767832,0.162427015767832
"28","035","050","Forrest County",78158,75083,77213,-3075,-3.93433813557153,3.93433813557153,-945,-1.20908928068784,1.20908928068784
"28","037","050","Franklin County",7675,7671,8448,-4,-0.0521172638436482,0.0521172638436482,773,10.071661237785,10.071661237785
"28","039","050","George County",24350,24446,23250,96,0.394250513347023,0.394250513347023,-1100,-4.51745379876797,4.51745379876797
"28","041","050","Greene County",13530,13507,14811,-23,-0.169992609016999,0.169992609016999,1281,9.46784922394679,9.46784922394679
"28","043","050","Grenada County",21629,20673,22117,-956,-4.41999167783994,4.41999167783994,488,2.25623006149152,2.25623006149152
"28","045","050","Hancock County",46053,47966,54170,1913,4.15390962586585,4.15390962586585,8117,17.625344711528,17.625344711528
"28","047","050","Harrison County",208621,208696,209643,75,0.0359503597432665,0.0359503597432665,1022,0.489883568768245,0.489883568768245
"28","049","050","Hinds County",227742,229130,247877,1388,0.609461583721931,0.609461583721931,20135,8.84114480420827,8.84114480420827
"28","051","050","Holmes County",17000,16808,20062,-192,-1.12941176470588,1.12941176470588,3062,18.0117647058824,18.0117647058824
"28","053","050","Humphreys County",7785,7908,9273,123,1.57996146435453,1.57996146435453,1488,19.1136801541426,19.1136801541426
"28","055","050","Issaquena County",1338,1252,1429,-86,-6.42750373692078,6.42750373692078,91,6.80119581464873,6.80119581464873
"28","057","050","Itawamba County",23863,23300,23949,-563,-2.35930100993169,2.35930100993169,86,0.36039056279596,0.36039056279596
"28","059","050","Jackson County",143252,143776,146761,524,0.365788959316449,0.365788959316449,3509,2.44952950046073,2.44952950046073
"28","061","050","Jasper County",16367,16354,17636,-13,-0.079428117553614,0.079428117553614,1269,7.75340624427201,7.75340624427201
"28","063","050","Jefferson County",7260,7000,8047,-260,-3.58126721763085,3.58126721763085,787,10.8402203856749,10.8402203856749
"28","065","050","Jefferson Davis County",11321,10952,12770,-369,-3.25942937903012,3.25942937903012,1449,12.7992226835085,12.7992226835085
"28","067","050","Jones County",67246,68118,69938,872,1.29673140409839,1.29673140409839,2692,4.00321208696428,4.00321208696428
"28","069","050","Kemper County",8988,9584,10611,596,6.63106364040943,6.63106364040943,1623,18.0574098798398,18.0574098798398
"28","071","050","Lafayette County",55813,54411,55610,-1402,-2.51195957930948,2.51195957930948,-203,-0.363714546790174,0.363714546790174
"28","073","050","Lamar County",64222,64032,57369,-190,-0.295848774563234,0.295848774563234,-6853,-10.6707981688518,10.6707981688518
"28","075","050","Lauderdale County",72984,74036,81946,1052,1.4414118162885,1.4414118162885,8962,12.2794037049216,12.2794037049216
"28","077","050","Lawrence County",12016,12515,13428,499,4.15279627163782,4.15279627163782,1412,11.7509986684421,11.7509986684421
"28","079","050","Leake County",21275,22779,24409,1504,7.06933019976498,7.06933019976498,3134,14.7309048178613,14.7309048178613
"28","081","050","Lee County",83343,85555,86167,2212,2.65409212531346,2.65409212531346,2824,3.3884069447944,3.3884069447944
"28","083","050","Leflore County",28339,27957,32007,-382,-1.34796570097745,1.34796570097745,3668,12.9432936942023,12.9432936942023
"28","085","050","Lincoln County",34907,34011,36047,-896,-2.56682040851405,2.56682040851405,1140,3.2658206090469,3.2658206090469
"28","087","050","Lowndes County",58879,58413,62068,-466,-0.791453659199375,0.791453659199375,3189,5.41619253044379,5.41619253044379
"28","089","050","Madison County",109145,106784,110785,-2361,-2.16317742452701,2.16317742452701,1640,1.50258829996793,1.50258829996793
"28","091","050","Marion County",24441,24462,27871,21,0.0859211979869891,0.0859211979869891,3430,14.0337956712082,14.0337956712082
"28","093","050","Marshall County",33752,35323,40020,1571,4.65453899028206,4.65453899028206,6268,18.5707513628822,18.5707513628822
"28","095","050","Monroe County",34180,35177,37535,997,2.91691047396138,2.91691047396138,3355,9.81568168519602,9.81568168519602
"28","097","050","Montgomery County",9822,9694,12467,-128,-1.30319690490735,1.30319690490735,2645,26.9293422928121,26.9293422928121
"28","099","050","Neshoba County",29087,29026,30321,-61,-0.209715680544573,0.209715680544573,1234,4.24244507855743,4.24244507855743
"28","101","050","Newton County",21291,20901,22261,-390,-1.83175989854868,1.83175989854868,970,4.55591564510826,4.55591564510826
"28","103","050","Noxubee County",10285,10286,11881,1,0.00972289742343218,0.00972289742343218,1596,15.5177442877978,15.5177442877978
"28","105","050","Oktibbeha County",51788,49760,50691,-2028,-3.91596508843748,3.91596508843748,-1097,-2.11825133235499,2.11825133235499
"28","107","050","Panola County",33208,33919,35943,711,2.14105034931342,2.14105034931342,2735,8.23596723681041,8.23596723681041
"28","109","050","Pearl River County",56145,55845,60923,-300,-0.534330750734705,0.534330750734705,4778,8.5101077567014,8.5101077567014
"28","111","050","Perry County",11511,11897,12727,386,3.35331422117974,3.35331422117974,1216,10.5638085309704,10.5638085309704
"28","113","050","Pike County",40324,39075,43098,-1249,-3.09741097113382,3.09741097113382,2774,6.8792778494197,6.8792778494197
"28","115","050","Pontotoc County",31184,32427,31697,1243,3.98601847101077,3.98601847101077,513,1.64507439712673,1.64507439712673
"28","117","050","Prentiss County",25008,25031,25821,23,0.0919705694177863,0.0919705694177863,813,3.25095969289827,3.25095969289827
"28","119","050","Quitman County",6176,6774,8154,598,9.68264248704663,9.68264248704663,1978,32.0272020725389,32.0272020725389
"28","121","050","Rankin County",157031,155852,156168,-1179,-0.750807165464144,0.750807165464144,-863,-0.549573014245595,0.549573014245595
"28","123","050","Scott County",27990,28104,29174,114,0.407288317256163,0.407288317256163,1184,4.23008217220436,4.23008217220436
"28","125","050","Sharkey County",3800,4209,5042,409,10.7631578947368,10.7631578947368,1242,32.6842105263158,32.6842105263158
"28","127","050","Simpson County",25949,26672,28288,723,2.78623453697638,2.78623453697638,2339,9.01383482985857,9.01383482985857
"28","129","050","Smith County",14209,15784,17003,1575,11.0845238933071,11.0845238933071,2794,19.6635934970793,19.6635934970793
"28","131","050","Stone County",18333,18339,18950,6,0.0327278677794142,0.0327278677794142,617,3.36551573664976,3.36551573664976
"28","133","050","Sunflower County",25971,24831,29319,-1140,-4.38951137807555,4.38951137807555,3348,12.891301836664,12.891301836664
"28","135","050","Tallahatchie County",12715,13769,15827,1054,8.2894219425875,8.2894219425875,3112,24.4750294927251,24.4750294927251
"28","137","050","Tate County",28064,28463,31337,399,1.42175028506271,1.42175028506271,3273,11.6626282782212,11.6626282782212
"28","139","050","Tippah County",21815,21812,22908,-3,-0.0137520055008022,0.0137520055008022,1093,5.0103140041256,5.0103140041256
"28","141","050","Tishomingo County",18850,19288,19975,438,2.3236074270557,2.3236074270557,1125,5.96816976127321,5.96816976127321
"28","143","050","Tunica County",9782,9423,11442,-359,-3.67000613371499,3.67000613371499,1660,16.9699447965651,16.9699447965651
"28","145","050","Union County",27777,28829,28507,1052,3.78730604456925,3.78730604456925,730,2.62807358606041,2.62807358606041
"28","147","050","Walthall County",13884,14294,15925,410,2.9530394698934,2.9530394698934,2041,14.7003745318352,14.7003745318352
"28","149","050","Warren County",44722,45004,49351,282,0.630562139439202,0.630562139439202,4629,10.3506104378158,10.3506104378158
"28","151","050","Washington County",44922,43125,50871,-1797,-4.00026712969146,4.00026712969146,5949,13.2429544543876,13.2429544543876
"28","153","050","Wayne County",19779,20268,21504,489,2.47231912634612,2.47231912634612,1725,8.72137115122099,8.72137115122099
"28","155","050","Webster County",9926,9684,10436,-242,-2.43804150715293,2.43804150715293,510,5.13802135804957,5.13802135804957
"28","157","050","Wilkinson County",8587,8423,10286,-164,-1.90986374752533,1.90986374752533,1699,19.7857226039362,19.7857226039362
"28","159","050","Winston County",17714,17864,19361,150,0.846787851416958,0.846787851416958,1647,9.2977306085582,9.2977306085582
"28","161","050","Yalobusha County",12481,11993,13194,-488,-3.90994311353257,3.90994311353257,713,5.71268327858345,5.71268327858345
"28","163","050","Yazoo County",26743,27619,28327,876,3.2756235276521,3.2756235276521,1584,5.92304528287776,5.92304528287776
"29","001","050","Adair County",25314,25470,26534,156,0.616259777198388,0.616259777198388,1220,4.81946748834637,4.81946748834637
"29","003","050","Andrew County",18135,17637,17369,-498,-2.74607113316791,2.74607113316791,-766,-4.223876481941,4.223876481941
"29","005","050","Atchison County",5305,5105,5613,-200,-3.77002827521206,3.77002827521206,308,5.80584354382658,5.80584354382658
"29","007","050","Audrain County",24962,24911,25724,-51,-0.204310552039099,0.204310552039099,762,3.05264001281949,3.05264001281949
"29","009","050","Barry County",34534,35893,35930,1359,3.9352522152082,3.9352522152082,1396,4.04239300399606,4.04239300399606
"29","011","050","Barton County",11637,11632,12372,-5,-0.042966400274985,0.042966400274985,735,6.31606084042279,6.31606084042279
"29","013","050","Bates County",16042,16266,17043,224,1.39633462161825,1.39633462161825,1001,6.23987034035656,6.23987034035656
"29","015","050","Benton County",19394,19624,19259,230,1.18593379395689,1.18593379395689,-135,-0.696091574713829,0.696091574713829
"29","017","050","Bollinger County",10567,12142,12354,1575,14.9048925901391,14.9048925901391,1787,16.9111384498912,16.9111384498912
"29","019","050","Boone County",183610,182643,186852,-967,-0.526659767986493,0.526659767986493,3242,1.76569903600022,1.76569903600022
"29","021","050","Buchanan County",84793,86771,90303,1978,2.33273973087401,2.33273973087401,5510,6.49817791562983,6.49817791562983
"29","023","050","Butler County",42130,42338,43096,208,0.493709945407073,0.493709945407073,966,2.29290291953477,2.29290291953477
"29","025","050","Caldwell County",8815,9061,9715,246,2.7906976744186,2.7906976744186,900,10.2098695405559,10.2098695405559
"29","027","050","Callaway County",44283,44879,45726,596,1.34588894158029,1.34588894158029,1443,3.25858681661134,3.25858681661134
"29","029","050","Camden County",42745,46420,45173,3675,8.5974967832495,8.5974967832495,2428,5.68019651421219,5.68019651421219
"29","031","050","Cape Girardeau County",81710,79442,82467,-2268,-2.77567005262514,2.77567005262514,757,0.926447191286256,0.926447191286256
"29","033","050","Carroll County",8495,8602,9328,107,1.25956444967628,1.25956444967628,833,9.8057680988817,9.8057680988817
"29","035","050","Carter County",5202,5995,6296,793,15.2441368704344,15.2441368704344,1094,21.0303729334871,21.0303729334871
"29","037","050","Cass County",107824,106618,107425,-1206,-1.11848939011723,1.11848939011723,-399,-0.370047484790028,0.370047484790028
"29","039","050","Cedar County",14188,14341,14096,153,1.07837609247251,1.07837609247251,-92,-0.648435297434452,0.648435297434452
"29","041","050","Chariton County",7408,7400,7803,-8,-0.107991360691145,0.107991360691145,395,5.33207343412527,5.33207343412527
"29","043","050","Christian County",88842,90279,87835,1437,1.61747821976092,1.61747821976092,-1007,-1.13347290695842,1.13347290695842
"29","045","050","Clark County",6634,6831,7196,197,2.96955079891468,2.96955079891468,562,8.47151040096473,8.47151040096473
"29","047","050","Clay County",253335,252879,236770,-456,-0.179998815797264,0.179998815797264,-16565,-6.53877277123177,6.53877277123177
"29","049","050","Clinton County",21184,20541,21375,-643,-3.03530966767372,3.03530966767372,191,0.901623867069486,0.901623867069486
"29","051","050","Cole County",77279,76398,79399,-881,-1.14002510384451,1.14002510384451,2120,2.74330671980745,2.74330671980745
"29","053","050","Cooper County",17103,17255,17680,152,0.888732970823832,0.888732970823832,577,3.37367713266678,3.37367713266678
"29","055","050","Crawford County",23056,23780,25040,724,3.14018043025677,3.14018043025677,1984,8.60513532269257,8.60513532269257
"29","057","050","Dade County",7569,7558,7873,-11,-0.145329634033558,0.145329634033558,304,4.01638261329106,4.01638261329106
"29","059","050","Dallas County",17071,17176,16878,105,0.61507820280007,0.61507820280007,-193,-1.13057231562299,1.13057231562299
"29","061","050","Daviess County",8430,8291,8406,-139,-1.64887307236062,1.64887307236062,-24,-0.284697508896797,0.284697508896797
"29","063","050","DeKalb County",11029,10919,13025,-110,-0.997370568501224,0.997370568501224,1996,18.0977423157131,18.0977423157131
"29","065","050","Dent County",14421,15512,15754,1091,7.56535607794189,7.56535607794189,1333,9.24346439220581,9.24346439220581
"29","067","050","Douglas County",11578,13340,13688,1762,15.2185178787355,15.2185178787355,2110,18.2242183451373,18.2242183451373
"29","069","050","Dunklin County",28283,28974,32054,691,2.44316373793445,2.44316373793445,3771,13.3330976204787,13.3330976204787
"29","071","050","Franklin County",104682,104374,107890,-308,-0.294224412984085,0.294224412984085,3208,3.06451921056151,3.06451921056151
"29","073","050","Gasconade County",14794,14617,15165,-177,-1.19643098553468,1.19643098553468,371,2.50777342165743,2.50777342165743
"29","075","050","Gentry County",6162,6506,6732,344,5.58260305095748,5.58260305095748,570,9.25024342745862,9.25024342745862
"29","077","050","Greene County",298915,294776,298795,-4139,-1.38467457303916,1.38467457303916,-120,-0.0401451917769266,0.0401451917769266
"29","079","050","Grundy County",9808,9649,10213,-159,-1.62112561174551,1.62112561174551,405,4.12928221859706,4.12928221859706
"29","081","050","Harrison County",8157,8334,8892,177,2.16991541007723,2.16991541007723,735,9.01066568591394,9.01066568591394
"29","083","050","Henry County",21946,22069,22485,123,0.560466599835961,0.560466599835961,539,2.4560284334275,2.4560284334275
"29","085","050","Hickory County",8279,9567,9730,1288,15.5574344727624,15.5574344727624,1451,17.526271288803,17.526271288803
"29","087","050","Holt County",4223,4270,4887,47,1.11295287710159,1.11295287710159,664,15.723419370116,15.723419370116
"29","089","050","Howard County",10151,10001,10155,-150,-1.47768692739632,1.47768692739632,4,0.0394049847305684,0.0394049847305684
"29","091","050","Howell County",39750,40238,41147,488,1.22767295597484,1.22767295597484,1397,3.51446540880503,3.51446540880503
"29","093","050","Iron County",9537,10123,10589,586,6.1444898815141,6.1444898815141,1052,11.0307224494076,11.0307224494076
"29","095","050","Jackson County",717204,705907,713553,-11297,-1.57514458926609,1.57514458926609,-3651,-0.50906018371342,0.50906018371342
"29","097","050","Jasper County",122761,121585,122156,-1176,-0.95795896090778,0.95795896090778,-605,-0.492827526657489,0.492827526657489
"29","099","050","Jefferson County",226739,226350,231192,-389,-0.171562898310392,0.171562898310392,4453,1.96393209813927,1.96393209813927
"29","101","050","Johnson County",54013,54228,54853,215,0.3980523207376,0.3980523207376,840,1.55518116009109,1.55518116009109
"29","103","050","Knox County",3744,3943,4100,199,5.31517094017094,5.31517094017094,356,9.50854700854701,9.50854700854701
"29","105","050","Laclede County",36039,35902,36304,-137,-0.380143733177946,0.380143733177946,265,0.735314520380699,0.735314520380699
"29","107","050","Lafayette County",32984,32977,33795,-7,-0.0212224108658744,0.0212224108658744,811,2.45876788746059,2.45876788746059
"29","109","050","Lawrence County",38001,38220,38814,219,0.576300623667798,0.576300623667798,813,2.13941738375306,2.13941738375306
"29","111","050","Lewis County",10032,9809,10230,-223,-2.22288676236045,2.22288676236045,198,1.97368421052632,1.97368421052632
"29","113","050","Lincoln County",59574,59871,55341,297,0.498539631382818,0.498539631382818,-4233,-7.10544868566824,7.10544868566824
"29","115","050","Linn County",11874,11857,12656,-17,-0.143169951153781,0.143169951153781,782,6.58581775307394,6.58581775307394
"29","117","050","Livingston County",14557,14544,15510,-13,-0.0893041148588308,0.0893041148588308,953,6.54667857388198,6.54667857388198
"29","119","050","McDonald County",23303,22904,23243,-399,-1.71222589366176,1.71222589366176,-60,-0.25747757799425,0.25747757799425
"29","121","050","Macon County",15209,15109,15579,-100,-0.657505424419751,0.657505424419751,370,2.43277007035308,2.43277007035308
"29","123","050","Madison County",12626,12102,12270,-524,-4.15016632345953,4.15016632345953,-356,-2.81957864723586,2.81957864723586
"29","125","050","Maries County",8432,8789,9162,357,4.23387096774194,4.23387096774194,730,8.65749525616698,8.65749525616698
"29","127","050","Marion County",28525,28465,29474,-60,-0.21034180543383,0.21034180543383,949,3.32690622261174,3.32690622261174
"29","129","050","Mercer County",3538,3573,3758,35,0.989259468626343,0.989259468626343,220,6.21820237422272,6.21820237422272
"29","131","050","Miller County",24722,25744,25148,1022,4.13396974354826,4.13396974354826,426,1.72316155650837,1.72316155650837
"29","133","050","Mississippi County",12577,12830,14402,253,2.01160849169118,2.01160849169118,1825,14.5106146139779,14.5106146139779
"29","135","050","Moniteau County",15473,15647,15600,174,1.12453952045499,1.12453952045499,127,0.820784592515996,0.820784592515996
"29","137","050","Monroe County",8666,8662,8951,-4,-0.0461573967228248,0.0461573967228248,285,3.28871451650127,3.28871451650127
"29","139","050","Montgomery County",11322,11333,12564,11,0.0971559795089207,0.0971559795089207,1242,10.9697933227345,10.9697933227345
"29","141","050","Morgan County",21006,20729,20694,-277,-1.31867085594592,1.31867085594592,-312,-1.48528991716652,1.48528991716652
"29","143","050","New Madrid County",16434,16786,19148,352,2.14190093708166,2.14190093708166,2714,16.5145430205671,16.5145430205671
"29","145","050","Newton County",58648,58443,59505,-205,-0.349543036420679,0.349543036420679,857,1.46126040103669,1.46126040103669
"29","147","050","Nodaway County",21241,21818,24156,577,2.7164446118356,2.7164446118356,2915,13.7234593474883,13.7234593474883
"29","149","050","Oregon County",8635,10440,10853,1805,20.9033005211349,20.9033005211349,2218,25.6861609727852,25.6861609727852
"29","151","050","Osage County",13274,13563,14101,289,2.17718848877505,2.17718848877505,827,6.23022449902064,6.23022449902064
"29","153","050","Ozark County",8553,9091,9817,538,6.29019057640594,6.29019057640594,1264,14.7784403133403,14.7784403133403
"29","155","050","Pemiscot County",15661,15670,18305,9,0.057467594661899,0.057467594661899,2644,16.8827022540068,16.8827022540068
"29","157","050","Perry County",18956,19180,19688,224,1.18168389955687,1.18168389955687,732,3.8615741717662,3.8615741717662
"29","159","050","Pettis County",42980,42475,42141,-505,-1.17496510004653,1.17496510004653,-839,-1.95207073057236,1.95207073057236
"29","161","050","Phelps County",44638,44480,47654,-158,-0.353958510685963,0.353958510685963,3016,6.75657511537255,6.75657511537255
"29","163","050","Pike County",17587,17579,18650,-8,-0.0454881446523,0.0454881446523,1063,6.04423722067436,6.04423722067436
"29","165","050","Platte County",106718,106107,98803,-611,-0.572536966584831,0.572536966584831,-7915,-7.41674319233869,7.41674319233869
"29","167","050","Polk County",31519,32438,31905,919,2.91570164028047,2.91570164028047,386,1.22465814270757,1.22465814270757
"29","169","050","Pulaski County",53955,52703,56083,-1252,-2.32045222870911,2.32045222870911,2128,3.94402743026596,3.94402743026596
"29","171","050","Putnam County",4681,4686,4972,5,0.10681478316599,0.10681478316599,291,6.21662038026063,6.21662038026063
"29","173","050","Ralls County",10355,10285,10205,-70,-0.67600193143409,0.67600193143409,-150,-1.44857556735876,1.44857556735876
"29","175","050","Randolph County",24716,24504,25719,-212,-0.857743971516427,0.857743971516427,1003,4.05810001618385,4.05810001618385
"29","177","050","Ray County",23158,22927,23928,-231,-0.9974954659297,0.9974954659297,770,3.32498488643233,3.32498488643233
"29","179","050","Reynolds County",6096,6211,6690,115,1.88648293963255,1.88648293963255,594,9.74409448818898,9.74409448818898
"29","181","050","Ripley County",10679,13304,14200,2625,24.5809532727783,24.5809532727783,3521,32.9712519898867,32.9712519898867
"29","183","050","St. Charles County",405262,405210,409355,-52,-0.012831205491756,0.012831205491756,4093,1.00996392457225,1.00996392457225
"29","185","050","St. Clair County",9284,9618,9829,334,3.59758724687635,3.59758724687635,545,5.87031451960362,5.87031451960362
"29","186","050","Ste. Genevieve County",18479,17922,18479,-557,-3.0142323718816,3.0142323718816,0,0,0
"29","187","050","St. Francois County",66922,66608,70032,-314,-0.469202952691193,0.469202952691193,3110,4.64720121932997,4.64720121932997
"29","189","050","St. Louis County",1004125,994969,1009331,-9156,-0.911838665504793,0.911838665504793,5206,0.518461346943857,0.518461346943857
"29","195","050","Saline County",23333,22841,23497,-492,-2.10860155145074,2.10860155145074,164,0.702867183816912,0.702867183816912
"29","197","050","Schuyler County",4032,4555,4427,523,12.9712301587302,12.9712301587302,395,9.79662698412698,9.79662698412698
"29","199","050","Scotland County",4716,4885,4854,169,3.58354537743851,3.58354537743851,138,2.92620865139949,2.92620865139949
"29","201","050","Scott County",38059,38322,40065,263,0.691032344517722,0.691032344517722,2006,5.27076381407814,5.27076381407814
"29","203","050","Shannon County",7031,8196,8463,1165,16.5694780258854,16.5694780258854,1432,20.3669463803157,20.3669463803157
"29","205","050","Shelby County",6103,5914,6366,-189,-3.09683762084221,3.09683762084221,263,4.30935605439948,4.30935605439948
"29","207","050","Stoddard County",28672,29009,30305,337,1.17536272321429,1.17536272321429,1633,5.69545200892857,5.69545200892857
"29","209","050","Stone County",31076,32357,33994,1281,4.12215214313296,4.12215214313296,2918,9.38988286780795,9.38988286780795
"29","211","050","Sullivan County",5999,6040,6664,41,0.683447241206868,0.683447241206868,665,11.0851808634772,11.0851808634772
"29","213","050","Taney County",56066,56106,55448,40,0.0713444868547783,0.0713444868547783,-618,-1.10227232190632,1.10227232190632
"29","215","050","Texas County",24487,25148,26134,661,2.6993915138645,2.6993915138645,1647,6.7260178870421,6.7260178870421
"29","217","050","Vernon County",19707,20423,21390,716,3.63322677221292,3.63322677221292,1683,8.54011265032729,8.54011265032729
"29","219","050","Warren County",35532,36363,36295,831,2.338736913205,2.338736913205,763,2.14736012608353,2.14736012608353
"29","221","050","Washington County",23514,24619,25362,1105,4.69932805987922,4.69932805987922,1848,7.85914774177086,7.85914774177086
"29","223","050","Wayne County",10974,12792,13575,1818,16.566429743029,16.566429743029,2601,23.7014762165118,23.7014762165118
"29","225","050","Webster County",39085,39780,37429,695,1.77817577075604,1.77817577075604,-1656,-4.23691953434821,4.23691953434821
"29","227","050","Worth County",1973,1960,2149,-13,-0.658895083628991,0.658895083628991,176,8.9204257475925,8.9204257475925
"29","229","050","Wright County",18188,18296,18801,108,0.593798108643061,0.593798108643061,613,3.37035407961293,3.37035407961293
"29","510","050","St. Louis city",301578,298587,321799,-2991,-0.991783220261425,0.991783220261425,20221,6.7050646930479,6.7050646930479
"30","001","050","Beaverhead County",9371,9515,9423,144,1.53665563973962,1.53665563973962,52,0.55490342546153,0.55490342546153
"30","003","050","Big Horn County",13124,13140,12951,16,0.121914050594331,0.121914050594331,-173,-1.3181956720512,1.3181956720512
"30","005","050","Blaine County",7044,6623,6526,-421,-5.97671777399205,5.97671777399205,-518,-7.35377626348666,7.35377626348666
"30","007","050","Broadwater County",6774,6403,5697,-371,-5.47682314732802,5.47682314732802,-1077,-15.8990256864482,15.8990256864482
"30","009","050","Carbon County",10473,10899,10322,426,4.06760240618734,4.06760240618734,-151,-1.44180273083166,1.44180273083166
"30","011","050","Carter County",1415,1244,1197,-171,-12.0848056537102,12.0848056537102,-218,-15.4063604240283,15.4063604240283
"30","013","050","Cascade County",84414,81412,85710,-3002,-3.55628213329542,3.55628213329542,1296,1.5352903546805,1.5352903546805
"30","015","050","Chouteau County",5895,5710,5999,-185,-3.13825275657337,3.13825275657337,104,1.76420695504665,1.76420695504665
"30","017","050","Custer County",11867,11350,12000,-517,-4.35661919609,4.35661919609,133,1.12075503497093,1.12075503497093
"30","019","050","Daniels County",1661,1649,1783,-12,-0.722456351595424,0.722456351595424,122,7.34497290788681,7.34497290788681
"30","021","050","Dawson County",8940,8587,9440,-353,-3.94854586129754,3.94854586129754,500,5.59284116331096,5.59284116331096
"30","023","050","Deer Lodge County",9421,9222,9517,-199,-2.11230230336482,2.11230230336482,96,1.01900010614584,1.01900010614584
"30","025","050","Fallon County",3049,2845,3472,-204,-6.69071826828468,6.69071826828468,423,13.8734011151197,13.8734011151197
"30","027","050","Fergus County",11446,11101,11727,-345,-3.01415341604054,3.01415341604054,281,2.4550061156736,2.4550061156736
"30","029","050","Flathead County",104357,105422,96709,1065,1.02053527794015,1.02053527794015,-7648,-7.32868901942371,7.32868901942371
"30","031","050","Gallatin County",118960,116274,113925,-2686,-2.25790181573638,2.25790181573638,-5035,-4.23251513113652,4.23251513113652
"30","033","050","Garfield County",1173,1269,1236,96,8.18414322250639,8.18414322250639,63,5.37084398976982,5.37084398976982
"30","035","050","Glacier County",13778,13638,13527,-140,-1.01611264334446,1.01611264334446,-251,-1.82174481056757,1.82174481056757
"30","037","050","Golden Valley County",823,829,903,6,0.729040097205346,0.729040097205346,80,9.72053462940462,9.72053462940462
"30","039","050","Granite County",3309,3336,3089,27,0.815956482320943,0.815956482320943,-220,-6.64853430039287,6.64853430039287
"30","041","050","Hill County",16309,16398,16315,89,0.545710957140229,0.545710957140229,6,0.0367895027285548,0.0367895027285548
"30","043","050","Jefferson County",12085,12346,11556,261,2.15970211005379,2.15970211005379,-529,-4.3773272652048,4.3773272652048
"30","045","050","Judith Basin County",2023,2002,2105,-21,-1.03806228373702,1.03806228373702,82,4.05338606030648,4.05338606030648
"30","047","050","Lake County",31134,30902,29410,-232,-0.745166056401362,0.745166056401362,-1724,-5.53735466049977,5.53735466049977
"30","049","050","Lewis and Clark County",70973,70107,67383,-866,-1.22018232285517,1.22018232285517,-3590,-5.05826159243656,5.05826159243656
"30","051","050","Liberty County",1959,2374,2350,415,21.1842776927004,21.1842776927004,391,19.9591628381827,19.9591628381827
"30","053","050","Lincoln County",19677,20288,20022,611,3.1051481425014,3.1051481425014,345,1.75331605427657,1.75331605427657
"30","055","050","McCone County",1729,1657,1763,-72,-4.16425679583574,4.16425679583574,34,1.96645459803355,1.96645459803355
"30","057","050","Madison County",8623,8908,7771,285,3.30511422938652,3.30511422938652,-852,-9.88055201206077,9.88055201206077
"30","059","050","Meagher County",1927,1834,1912,-93,-4.82615464452517,4.82615464452517,-15,-0.778412039439543,0.778412039439543
"30","061","050","Mineral County",4535,4511,4334,-24,-0.529217199558986,0.529217199558986,-201,-4.43219404630651,4.43219404630651
"30","063","050","Missoula County",117922,121277,122264,3355,2.84510099896542,2.84510099896542,4342,3.6820949441156,3.6820949441156
"30","065","050","Musselshell County",4730,4645,4618,-85,-1.79704016913319,1.79704016913319,-112,-2.36786469344609,2.36786469344609
"30","067","050","Park County",17191,16743,16249,-448,-2.60601477517306,2.60601477517306,-942,-5.47961142458263,5.47961142458263
"30","069","050","Petroleum County",496,495,503,-1,-0.201612903225806,0.201612903225806,7,1.41129032258065,1.41129032258065
"30","071","050","Phillips County",4217,3921,4294,-296,-7.01920796774959,7.01920796774959,77,1.82594261323216,1.82594261323216
"30","073","050","Pondera County",5898,5805,6201,-93,-1.57680569684639,1.57680569684639,303,5.13733468972533,5.13733468972533
"30","075","050","Powder River County",1694,1673,1767,-21,-1.2396694214876,1.2396694214876,73,4.30932703659976,4.30932703659976
"30","077","050","Powell County",6946,6826,7534,-120,-1.72761301468471,1.72761301468471,588,8.46530377195508,8.46530377195508
"30","079","050","Prairie County",1088,1073,1193,-15,-1.37867647058824,1.37867647058824,105,9.65073529411765,9.65073529411765
"30","081","050","Ravalli County",44174,44796,40799,622,1.40806809435415,1.40806809435415,-3375,-7.64024086566759,7.64024086566759
"30","083","050","Richland County",11491,11004,11342,-487,-4.23809938212514,4.23809938212514,-149,-1.29666695674876,1.29666695674876
"30","085","050","Roosevelt County",10794,10960,10630,166,1.5378914211599,1.5378914211599,-164,-1.51936260885677,1.51936260885677
"30","087","050","Rosebud County",8329,8854,9458,525,6.30327770440629,6.30327770440629,1129,13.5550486252851,13.5550486252851
"30","089","050","Sanders County",12400,12089,11563,-311,-2.50806451612903,2.50806451612903,-837,-6.75,6.75
"30","091","050","Sheridan County",3539,3266,3496,-273,-7.71404351511727,7.71404351511727,-43,-1.2150324950551,1.2150324950551
"30","093","050","Silver Bow County",35133,35090,35825,-43,-0.122392053055532,0.122392053055532,692,1.96965815614949,1.96965815614949
"30","095","050","Stillwater County",8963,9825,9249,862,9.61731563092714,9.61731563092714,286,3.19089590538882,3.19089590538882
"30","097","050","Sweet Grass County",3678,3680,3683,2,0.0543773790103317,0.0543773790103317,5,0.135943447525829,0.135943447525829
"30","099","050","Teton County",6226,6207,6134,-19,-0.305171859942178,0.305171859942178,-92,-1.4776742691937,1.4776742691937
"30","101","050","Toole County",4971,4676,5433,-295,-5.93441963387648,5.93441963387648,462,9.29390464695232,9.29390464695232
"30","103","050","Treasure County",762,700,731,-62,-8.13648293963255,8.13648293963255,-31,-4.06824146981627,4.06824146981627
"30","105","050","Valley County",7578,7345,7407,-233,-3.07468989179203,3.07468989179203,-171,-2.25653206650831,2.25653206650831
"30","107","050","Wheatland County",2069,2134,2192,65,3.14161430642823,3.14161430642823,123,5.94490091831803,5.94490091831803
"30","109","050","Wibaux County",937,939,1098,2,0.213447171824973,0.213447171824973,161,17.1824973319104,17.1824973319104
"30","111","050","Yellowstone County",164731,162587,172936,-2144,-1.30151580455409,1.30151580455409,8205,4.98084756360369,4.98084756360369
"31","001","050","Adams County",31205,31371,33075,166,0.531966031084762,0.531966031084762,1870,5.9926293863163,5.9926293863163
"31","003","050","Antelope County",6295,6282,6813,-13,-0.206513105639396,0.206513105639396,518,8.22875297855441,8.22875297855441
"31","005","050","Arthur County",434,471,458,37,8.52534562211982,8.52534562211982,24,5.52995391705069,5.52995391705069
"31","007","050","Banner County",674,789,688,115,17.0623145400593,17.0623145400593,14,2.07715133531157,2.07715133531157
"31","009","050","Blaine County",431,459,475,28,6.49651972157773,6.49651972157773,44,10.2088167053364,10.2088167053364
"31","011","050","Boone County",5379,5126,5472,-253,-4.70347648261759,4.70347648261759,93,1.72894590072504,1.72894590072504
"31","013","050","Box Butte County",10842,10749,11205,-93,-0.857775318206973,0.857775318206973,363,3.3480907581627,3.3480907581627
"31","015","050","Boyd County",1810,1871,2069,61,3.37016574585635,3.37016574585635,259,14.3093922651934,14.3093922651934
"31","017","050","Brown County",2903,2992,3108,89,3.06579400620048,3.06579400620048,205,7.06166035136066,7.06166035136066
"31","019","050","Buffalo County",50084,50120,50546,36,0.0718792428719751,0.0718792428719751,462,0.92245028352368,0.92245028352368
"31","021","050","Burt County",6722,6495,6858,-227,-3.3769711395418,3.3769711395418,136,2.02320737875632,2.02320737875632
"31","023","050","Butler County",8369,7991,8459,-378,-4.51666865814315,4.51666865814315,90,1.07539729955789,1.07539729955789
"31","025","050","Cass County",26598,26268,26769,-330,-1.24069478908189,1.24069478908189,171,0.642905481615159,0.642905481615159
"31","027","050","Cedar County",8380,8424,8897,44,0.525059665871122,0.525059665871122,517,6.16945107398568,6.16945107398568
"31","029","050","Chase County",3893,3860,4025,-33,-0.847675314667352,0.847675314667352,132,3.39070125866941,3.39070125866941
"31","031","050","Cherry County",5455,5794,5948,339,6.21448212648946,6.21448212648946,493,9.03758020164986,9.03758020164986
"31","033","050","Cheyenne County",9468,9115,10270,-353,-3.7283481199831,3.7283481199831,802,8.47063793831855,8.47063793831855
"31","035","050","Clay County",6104,6228,6596,124,2.03145478374836,2.03145478374836,492,8.06028833551769,8.06028833551769
"31","037","050","Colfax County",10582,10646,10905,64,0.604800604800605,0.604800604800605,323,3.05235305235305,3.05235305235305
"31","039","050","Cuming County",9013,8820,9285,-193,-2.14135138133807,2.14135138133807,272,3.01786308665261,3.01786308665261
"31","041","050","Custer County",10545,10680,11123,135,1.28022759601707,1.28022759601707,578,5.48127074442864,5.48127074442864
"31","043","050","Dakota County",21582,20111,21788,-1471,-6.81586507274581,6.81586507274581,206,0.954499119636734,0.954499119636734
"31","045","050","Dawes County",8199,8410,9171,211,2.57348457128918,2.57348457128918,972,11.8551042810099,11.8551042810099
"31","047","050","Dawson County",24111,23544,24919,-567,-2.35162374020157,2.35162374020157,808,3.351167516901,3.351167516901
"31","049","050","Deuel County",1838,1804,1895,-34,-1.84983677910773,1.84983677910773,57,3.10119695321001,3.10119695321001
"31","051","050","Dixon County",5606,5607,6063,1,0.0178380306814128,0.0178380306814128,457,8.15198002140564,8.15198002140564
"31","053","050","Dodge County",37167,36321,37552,-846,-2.2762127693922,2.2762127693922,385,1.03586514919149,1.03586514919149
"31","055","050","Douglas County",584526,573764,567823,-10762,-1.84114992318562,1.84114992318562,-16703,-2.85752900640861,2.85752900640861
"31","057","050","Dundy County",1654,1675,1997,21,1.26964933494559,1.26964933494559,343,20.7376058041112,20.7376058041112
"31","059","050","Fillmore County",5551,5521,5932,-30,-0.540443163393983,0.540443163393983,381,6.86362817510359,6.86362817510359
"31","061","050","Franklin County",2889,2953,3192,64,2.21529941156109,2.21529941156109,303,10.4880581516096,10.4880581516096
"31","063","050","Frontier County",2519,2601,2770,82,3.25526002381898,3.25526002381898,251,9.96427153632394,9.96427153632394
"31","065","050","Furnas County",4636,4666,4939,30,0.647109577221743,0.647109577221743,303,6.5358067299396,6.5358067299396
"31","067","050","Gage County",21704,21488,22488,-216,-0.995208256542573,0.995208256542573,784,3.61223737559897,3.61223737559897
"31","069","050","Garden County",1874,1846,2043,-28,-1.49413020277481,1.49413020277481,169,9.01814300960512,9.01814300960512
"31","071","050","Garfield County",1813,1956,2122,143,7.88747931605075,7.88747931605075,309,17.0435741864313,17.0435741864313
"31","073","050","Gosper County",1893,1979,2113,86,4.54305335446381,4.54305335446381,220,11.62176439514,11.62176439514
"31","075","050","Grant County",611,631,609,20,3.27332242225859,3.27332242225859,-2,-0.327332242225859,0.327332242225859
"31","077","050","Greeley County",2188,2339,2565,151,6.90127970749543,6.90127970749543,377,17.2303473491773,17.2303473491773
"31","079","050","Hall County",62895,61164,62820,-1731,-2.75220605771524,2.75220605771524,-75,-0.119246362985929,0.119246362985929
"31","081","050","Hamilton County",9429,9254,9645,-175,-1.85597624350408,1.85597624350408,216,2.29080496341075,2.29080496341075
"31","083","050","Harlan County",3073,3325,3482,252,8.2004555808656,8.2004555808656,409,13.3094695737065,13.3094695737065
"31","085","050","Hayes County",856,917,964,61,7.12616822429906,7.12616822429906,108,12.6168224299065,12.6168224299065
"31","087","050","Hitchcock County",2616,2779,2868,163,6.23088685015291,6.23088685015291,252,9.63302752293578,9.63302752293578
"31","089","050","Holt County",10127,9994,10543,-133,-1.31332082551595,1.31332082551595,416,4.10783055198973,4.10783055198973
"31","091","050","Hooker County",711,653,767,-58,-8.15752461322082,8.15752461322082,56,7.87623066104079,7.87623066104079
"31","093","050","Howard County",6475,6470,6691,-5,-0.0772200772200772,0.0772200772200772,216,3.33590733590734,3.33590733590734
"31","095","050","Jefferson County",7240,7088,7539,-152,-2.09944751381215,2.09944751381215,299,4.12983425414365,4.12983425414365
"31","097","050","Johnson County",5290,5054,5165,-236,-4.46124763705104,4.46124763705104,-125,-2.36294896030246,2.36294896030246
"31","099","050","Kearney County",6688,6644,6736,-44,-0.657894736842105,0.657894736842105,48,0.717703349282297,0.717703349282297
"31","101","050","Keith County",8335,7989,8521,-346,-4.15116976604679,4.15116976604679,186,2.23155368926215,2.23155368926215
"31","103","050","Keya Paha County",769,768,818,-1,-0.130039011703511,0.130039011703511,49,6.37191157347204,6.37191157347204
"31","105","050","Kimball County",3434,3519,3786,85,2.47524752475248,2.47524752475248,352,10.2504368083867,10.2504368083867
"31","107","050","Knox County",8391,8312,9059,-79,-0.94148492432368,0.94148492432368,668,7.96091049934454,7.96091049934454
"31","109","050","Lancaster County",322608,320229,321764,-2379,-0.73742746615087,0.73742746615087,-844,-0.261617814809304,0.261617814809304
"31","111","050","Lincoln County",34676,34489,36997,-187,-0.539277886722805,0.539277886722805,2321,6.69339024108894,6.69339024108894
"31","113","050","Logan County",716,744,765,28,3.91061452513966,3.91061452513966,49,6.84357541899441,6.84357541899441
"31","115","050","Loup County",607,641,699,34,5.60131795716639,5.60131795716639,92,15.1565074135091,15.1565074135091
"31","117","050","McPherson County",399,475,535,76,19.047619047619,19.047619047619,136,34.0852130325814,34.0852130325814
"31","119","050","Madison County",35585,34863,36279,-722,-2.02894478010398,2.02894478010398,694,1.95025994098637,1.95025994098637
"31","121","050","Merrick County",7668,7817,8196,149,1.94314032342201,1.94314032342201,528,6.88575899843505,6.88575899843505
"31","123","050","Morrill County",4555,4627,5017,72,1.58068057080132,1.58068057080132,462,10.1427003293085,10.1427003293085
"31","125","050","Nance County",3380,3521,3880,141,4.17159763313609,4.17159763313609,500,14.792899408284,14.792899408284
"31","127","050","Nemaha County",7074,7014,7240,-60,-0.848176420695505,0.848176420695505,166,2.3466214305909,2.3466214305909
"31","129","050","Nuckolls County",4095,4129,4469,34,0.83028083028083,0.83028083028083,374,9.13308913308913,9.13308913308913
"31","131","050","Otoe County",15912,15963,16233,51,0.32051282051282,0.32051282051282,321,2.01734539969834,2.01734539969834
"31","133","050","Pawnee County",2544,2617,2874,73,2.86949685534591,2.86949685534591,330,12.9716981132075,12.9716981132075
"31","135","050","Perkins County",2858,2874,2957,16,0.559832050384884,0.559832050384884,99,3.46396081175647,3.46396081175647
"31","137","050","Phelps County",8968,9006,9461,38,0.423728813559322,0.423728813559322,493,5.49732381801963,5.49732381801963
"31","139","050","Pierce County",7317,7163,7428,-154,-2.1046877135438,2.1046877135438,111,1.5170151701517,1.5170151701517
"31","141","050","Platte County",34296,33387,34049,-909,-2.65045486354094,2.65045486354094,-247,-0.720200606484721,0.720200606484721
"31","143","050","Polk County",5214,5190,5420,-24,-0.46029919447641,0.46029919447641,206,3.95090141925585,3.95090141925585
"31","145","050","Red Willow County",10702,10653,11156,-49,-0.457858344234722,0.457858344234722,454,4.24219772005233,4.24219772005233
"31","147","050","Richardson County",7871,7813,8373,-58,-0.736882225892517,0.736882225892517,502,6.37784271375937,6.37784271375937
"31","149","050","Rock County",1262,1373,1540,111,8.79556259904913,8.79556259904913,278,22.0285261489699,22.0285261489699
"31","151","050","Saline County",14292,14020,14580,-272,-1.90316260845228,1.90316260845228,288,2.01511335012594,2.01511335012594
"31","153","050","Sarpy County",190604,188409,184794,-2195,-1.15160227487356,1.15160227487356,-5810,-3.04820465467671,3.04820465467671
"31","155","050","Saunders County",22278,21836,22543,-442,-1.98402010952509,1.98402010952509,265,1.18951431905916,1.18951431905916
"31","157","050","Scotts Bluff County",36084,35346,36873,-738,-2.04522780179581,2.04522780179581,789,2.18656468240772,2.18656468240772
"31","159","050","Seward County",17609,17194,18063,-415,-2.35674938951672,2.35674938951672,454,2.57822704298938,2.57822704298938
"31","161","050","Sheridan County",5127,5159,5424,32,0.6241466744685,0.6241466744685,297,5.79286132241077,5.79286132241077
"31","163","050","Sherman County",2959,2983,3191,24,0.811084825954714,0.811084825954714,232,7.84048665089557,7.84048665089557
"31","165","050","Sioux County",1135,1184,1330,49,4.31718061674009,4.31718061674009,195,17.1806167400881,17.1806167400881
"31","167","050","Stanton County",5842,5884,6300,42,0.718931872646354,0.718931872646354,458,7.8397808969531,7.8397808969531
"31","169","050","Thayer County",5034,4901,5285,-133,-2.64203416765991,2.64203416765991,251,4.98609455701232,4.98609455701232
"31","171","050","Thomas County",669,719,652,50,7.47384155455904,7.47384155455904,-17,-2.54110612855007,2.54110612855007
"31","173","050","Thurston County",6773,7213,7063,440,6.49638269599882,6.49638269599882,290,4.28170677690831,4.28170677690831
"31","175","050","Valley County",4059,4100,4326,41,1.01010101010101,1.01010101010101,267,6.5779748706578,6.5779748706578
"31","177","050","Washington County",20865,20826,21312,-39,-0.186915887850467,0.186915887850467,447,2.14234363767074,2.14234363767074
"31","179","050","Wayne County",9697,9470,10154,-227,-2.34093018459317,2.34093018459317,457,4.71279777250696,4.71279777250696
"31","181","050","Webster County",3395,3427,3800,32,0.942562592047128,0.942562592047128,405,11.9293078055965,11.9293078055965
"31","183","050","Wheeler County",774,784,829,10,1.29198966408269,1.29198966408269,55,7.10594315245478,7.10594315245478
"31","185","050","York County",14125,13518,14086,-607,-4.29734513274336,4.29734513274336,-39,-0.276106194690265,0.276106194690265
"32","001","050","Churchill County",25516,25334,25583,-182,-0.713277943251293,0.713277943251293,67,0.262580341746355,0.262580341746355
"32","003","050","Clark County",2265461,2307540,2170752,42079,1.85741445118676,1.85741445118676,-94709,-4.1805619253653,4.1805619253653
"32","005","050","Douglas County",49488,49135,49422,-353,-0.713304235370191,0.713304235370191,-66,-0.133365664403492,0.133365664403492
"32","007","050","Elko County",53702,52997,55271,-705,-1.31280026814644,1.31280026814644,1569,2.9216788946408,2.9216788946408
"32","009","050","Esmeralda County",729,878,795,149,20.4389574759945,20.4389574759945,66,9.05349794238683,9.05349794238683
"32","011","050","Eureka County",1855,2085,2015,230,12.3989218328841,12.3989218328841,160,8.62533692722372,8.62533692722372
"32","013","050","Humboldt County",17285,16956,17765,-329,-1.90338443737344,1.90338443737344,480,2.77697425513451,2.77697425513451
"32","015","050","Lander County",5734,5523,6192,-211,-3.67980467387513,3.67980467387513,458,7.98744332054412,7.98744332054412
"32","017","050","Lincoln County",4499,5163,5547,664,14.7588352967326,14.7588352967326,1048,23.2940653478551,23.2940653478551
"32","019","050","Lyon County",59235,58142,55962,-1093,-1.84519287583354,1.84519287583354,-3273,-5.52544948088124,5.52544948088124
"32","021","050","Mineral County",4554,4520,4800,-34,-0.746596398770312,0.746596398770312,246,5.40184453227932,5.40184453227932
"32","023","050","Nye County",51591,47792,44324,-3799,-7.3636874648679,7.3636874648679,-7267,-14.085790157198,14.085790157198
"32","027","050","Pershing County",6650,6577,6888,-73,-1.09774436090226,1.09774436090226,238,3.57894736842105,3.57894736842105
"32","029","050","Storey County",4104,4203,4196,99,2.41228070175439,2.41228070175439,92,2.24171539961014,2.24171539961014
"32","031","050","Washoe County",486492,476178,477347,-10314,-2.12007597247231,2.12007597247231,-9145,-1.87978425133404,1.87978425133404
"32","033","050","White Pine County",9080,9465,10137,385,4.24008810572687,4.24008810572687,1057,11.6409691629956,11.6409691629956
"32","510","050","Carson City",58639,56012,57653,-2627,-4.47995361448865,4.47995361448865,-986,-1.68147478640495,1.68147478640495
"33","001","050","Belknap County",63705,61572,62893,-2133,-3.34824582057923,3.34824582057923,-812,-1.27462522564948,1.27462522564948
"33","003","050","Carroll County",50107,49113,50293,-994,-1.98375476480332,1.98375476480332,186,0.371205619973257,0.371205619973257
"33","005","050","Cheshire County",76458,76194,79742,-264,-0.345287608883308,0.345287608883308,3284,4.29516858929085,4.29516858929085
"33","007","050","Coos County",31268,31250,33754,-18,-0.0575668414992964,0.0575668414992964,2486,7.95062044262505,7.95062044262505
"33","009","050","Grafton County",91118,90655,93584,-463,-0.508132311947145,0.508132311947145,2466,2.70638073706622,2.70638073706622
"33","011","050","Hillsborough County",422937,418734,420419,-4203,-0.993765028834082,0.993765028834082,-2518,-0.595360538330768,0.595360538330768
"33","013","050","Merrimack County",153808,152426,151695,-1382,-0.898522833662748,0.898522833662748,-2113,-1.37379070009362,1.37379070009362
"33","015","050","Rockingham County",314176,310970,314768,-3206,-1.02044713790996,1.02044713790996,592,0.188429415359544,0.188429415359544
"33","017","050","Strafford County",130889,131356,131936,467,0.356790868598583,0.356790868598583,1047,0.799914431312028,0.799914431312028
"33","019","050","Sullivan County",43063,43263,44643,200,0.464435826579662,0.464435826579662,1580,3.66904302997933,3.66904302997933
"34","001","050","Atlantic County",274534,263339,279525,-11195,-4.07781914079859,4.07781914079859,4991,1.81798975718854,1.81798975718854
"34","003","050","Bergen County",955732,931649,929076,-24083,-2.51984866050315,2.51984866050315,-26656,-2.78906639099664,2.78906639099664
"34","005","050","Burlington County",461860,446784,462196,-15076,-3.26419261247997,3.26419261247997,336,0.072749317975144,0.072749317975144
"34","007","050","Camden County",523485,507070,518630,-16415,-3.13571544552375,3.13571544552375,-4855,-0.927438226501237,0.927438226501237
"34","009","050","Cape May County",95263,91777,98469,-3486,-3.65934308178411,3.65934308178411,3206,3.36541994268499,3.36541994268499
"34","011","050","Cumberland County",154152,147599,158321,-6553,-4.25099901396025,4.25099901396025,4169,2.70447350666874,2.70447350666874
"34","013","050","Essex County",863728,801474,802856,-62254,-7.20759313117092,7.20759313117092,-60872,-7.04758905581387,7.04758905581387
"34","015","050","Gloucester County",302294,293071,301335,-9223,-3.0510033278861,3.0510033278861,-959,-0.317240831773042,0.317240831773042
"34","017","050","Hudson County",724854,672875,679662,-51979,-7.17096132462537,7.17096132462537,-45192,-6.23463483680852,6.23463483680852
"34","019","050","Hunterdon County",128947,124979,130472,-3968,-3.07723328189101,3.07723328189101,1525,1.18265644024289,1.18265644024289
"34","021","050","Mercer County",387340,367702,373718,-19638,-5.06996437238602,5.06996437238602,-13622,-3.51680693963959,3.51680693963959
"34","023","050","Middlesex County",863162,823906,836932,-39256,-4.54792958911537,4.54792958911537,-26230,-3.0388270104569,3.0388270104569
"34","025","050","Monmouth County",643615,619032,642098,-24583,-3.81951943320153,3.81951943320153,-1517,-0.235699913768324,0.235699913768324
"34","027","050","Morris County",509285,491515,509937,-17770,-3.48920545470611,3.48920545470611,652,0.128022619947574,0.128022619947574
"34","029","050","Ocean County",637229,612913,594745,-24316,-3.81589663998343,3.81589663998343,-42484,-6.66699098754137,6.66699098754137
"34","031","050","Passaic County",524118,501079,505326,-23039,-4.39576583899046,4.39576583899046,-18792,-3.58545213100867,3.58545213100867
"34","033","050","Salem County",64837,62452,66511,-2385,-3.67845520304764,3.67845520304764,1674,2.58185912364853,2.58185912364853
"34","035","050","Somerset County",345361,329731,335673,-15630,-4.52569919591384,4.52569919591384,-9688,-2.80518066602772,2.80518066602772
"34","037","050","Sussex County",144221,140235,150716,-3986,-2.76381386899273,2.76381386899273,6495,4.50350503740787,4.50350503740787
"34","039","050","Union County",575345,556080,547704,-19265,-3.34842572717239,3.34842572717239,-27641,-4.80424788605098,4.80424788605098
"34","041","050","Warren County",109632,105621,110562,-4011,-3.65860332749562,3.65860332749562,930,0.848292469352014,0.848292469352014
"35","001","050","Bernalillo County",676444,681598,693126,5154,0.76192559916268,0.76192559916268,16682,2.4661317123073,2.4661317123073
"35","003","050","Catron County",3579,3613,3877,34,0.949986029617212,0.949986029617212,298,8.32634814193909,8.32634814193909
"35","005","050","Chaves County",65157,64767,67726,-390,-0.598554261245914,0.598554261245914,2569,3.94278435164295,3.94278435164295
"35","006","050","Cibola County",27172,26462,28117,-710,-2.61298395407037,2.61298395407037,945,3.47784484027676,3.47784484027676
"35","007","050","Colfax County",12387,11994,14212,-393,-3.1726810365706,3.1726810365706,1825,14.7331880196981,14.7331880196981
"35","009","050","Curry County",48430,48917,52130,487,1.00557505678299,1.00557505678299,3700,7.63989262853603,7.63989262853603
"35","011","050","De Baca County",1698,1695,2072,-3,-0.176678445229682,0.176678445229682,374,22.0259128386337,22.0259128386337
"35","013","050","Doña Ana County",219561,220845,233170,1284,0.584803312063618,0.584803312063618,13609,6.19827747186431,6.19827747186431
"35","015","050","Eddy County",62314,58469,60740,-3845,-6.17036300028886,6.17036300028886,-1574,-2.52591712937703,2.52591712937703
"35","017","050","Grant County",28185,27039,30494,-1146,-4.06599254922831,4.06599254922831,2309,8.1923008692567,8.1923008692567
"35","019","050","Guadalupe County",4452,4288,4845,-164,-3.6837376460018,3.6837376460018,393,8.82749326145553,8.82749326145553
"35","021","050","Harding County",657,638,715,-19,-2.89193302891933,2.89193302891933,58,8.82800608828006,8.82800608828006
"35","023","050","Hidalgo County",4178,4134,5092,-44,-1.05313547151747,1.05313547151747,914,21.8764959310675,21.8764959310675
"35","025","050","Lea County",74455,71710,70932,-2745,-3.68679067893358,3.68679067893358,-3523,-4.73171714458398,4.73171714458398
"35","027","050","Lincoln County",20269,19906,21592,-363,-1.79091223049978,1.79091223049978,1323,6.52720903843308,6.52720903843308
"35","028","050","Los Alamos County",19419,19477,18120,58,0.29867655389052,0.29867655389052,-1299,-6.68932488799629,6.68932488799629
"35","029","050","Luna County",25427,23896,25989,-1531,-6.02115861092539,6.02115861092539,562,2.21024894796869,2.21024894796869
"35","031","050","McKinley County",72902,71019,73250,-1883,-2.5829195358152,2.5829195358152,348,0.477353159035417,0.477353159035417
"35","033","050","Mora County",4189,4486,5043,297,7.08999761279542,7.08999761279542,854,20.3867271425161,20.3867271425161
"35","035","050","Otero County",67839,67893,65866,54,0.0796002299562199,0.0796002299562199,-1973,-2.90835655006707,2.90835655006707
"35","037","050","Quay County",8746,8235,9300,-511,-5.8426709352847,5.8426709352847,554,6.33432426252001,6.33432426252001
"35","039","050","Rio Arriba County",40363,38630,41738,-1733,-4.29353615935386,4.29353615935386,1375,3.40658523895647,3.40658523895647
"35","041","050","Roosevelt County",19191,18381,20898,-810,-4.22072846646866,4.22072846646866,1707,8.89479443489136,8.89479443489136
"35","043","050","Sandoval County",148834,148533,148550,-301,-0.20223873577274,0.20223873577274,-284,-0.19081661448325,0.19081661448325
"35","045","050","San Juan County",121661,123537,136057,1876,1.54198962691413,1.54198962691413,14396,11.8328798875564,11.8328798875564
"35","047","050","San Miguel County",27201,27191,30374,-10,-0.0367633542884453,0.0367633542884453,3173,11.6650123157237,11.6650123157237
"35","049","050","Santa Fe County",154823,151785,151077,-3038,-1.962240752343,1.962240752343,-3746,-2.41953714887323,2.41953714887323
"35","051","050","Sierra County",11576,10863,12368,-713,-6.15929509329648,6.15929509329648,792,6.84174153420871,6.84174153420871
"35","053","050","Socorro County",16595,16540,18417,-55,-0.331425128050618,0.331425128050618,1822,10.9792106056041,10.9792106056041
"35","055","050","Taos County",34489,32640,34589,-1849,-5.36112963553597,5.36112963553597,100,0.289947519498971,0.289947519498971
"35","057","050","Torrance County",15045,15453,17077,408,2.71186440677966,2.71186440677966,2032,13.5061482220007,13.5061482220007
"35","059","050","Union County",4079,4034,4664,-45,-1.10321157146359,1.10321157146359,585,14.3417504290267,14.3417504290267
"35","061","050","Valencia County",76205,77449,80954,1244,1.63243881635063,1.63243881635063,4749,6.23187454891411,6.23187454891411
"36","001","050","Albany County",314848,304151,316291,-10697,-3.39751245045228,3.39751245045228,1443,0.458316393942474,0.458316393942474
"36","003","050","Allegany County",46456,45702,49533,-754,-1.62304115722404,1.62304115722404,3077,6.62347167211986,6.62347167211986
"36","005","050","Bronx County",1472654,1406655,1461661,-65999,-4.48163655549776,4.48163655549776,-10993,-0.746475411060575,0.746475411060575
"36","007","050","Broome County",198683,189897,202872,-8786,-4.42211965794758,4.42211965794758,4189,2.10838370670868,2.10838370670868
"36","009","050","Cattaraugus County",77042,76012,81654,-1030,-1.3369331014252,1.3369331014252,4612,5.98634511045923,5.98634511045923
"36","011","050","Cayuga County",76248,76193,81869,-55,-0.0721330395551359,0.0721330395551359,5621,7.37199664253489,7.37199664253489
"36","013","050","Chautauqua County",127657,126269,136697,-1388,-1.08728859365331,1.08728859365331,9040,7.08147614310222,7.08147614310222
"36","015","050","Chemung County",84148,82878,90816,-1270,-1.50924561486904,1.50924561486904,6668,7.92413366924942,7.92413366924942
"36","017","050","Chenango County",47220,46873,53342,-347,-0.734858110969928,0.734858110969928,6122,12.9648454044896,12.9648454044896
"36","019","050","Clinton County",79843,79907,84575,64,0.0801573087183598,0.0801573087183598,4732,5.92663101336373,5.92663101336373
"36","021","050","Columbia County",61570,59596,64943,-1974,-3.20610687022901,3.20610687022901,3373,5.4783173623518,5.4783173623518
"36","023","050","Cortland County",46809,47287,50035,478,1.02117114230169,1.02117114230169,3226,6.89183703988549,6.89183703988549
"36","025","050","Delaware County",44308,44074,48670,-234,-0.528121332490747,0.528121332490747,4362,9.84472330053264,9.84472330053264
"36","027","050","Dutchess County",295911,293646,305717,-2265,-0.765432849741983,0.765432849741983,9806,3.31383422718317,3.31383422718317
"36","029","050","Erie County",954236,918182,944695,-36054,-3.77831060660046,3.77831060660046,-9541,-0.999857477605121,0.999857477605121
"36","031","050","Essex County",37381,36950,40830,-431,-1.15299216179342,1.15299216179342,3449,9.22661245017522,9.22661245017522
"36","033","050","Franklin County",47555,50017,53088,2462,5.17716328461781,5.17716328461781,5533,11.6349490064136,11.6349490064136
"36","035","050","Fulton County",53324,52994,56806,-330,-0.618858300202536,0.618858300202536,3482,6.52989273122797,6.52989273122797
"36","037","050","Genesee County",58388,57129,60876,-1259,-2.15626498595602,2.15626498595602,2488,4.26114955127766,4.26114955127766
"36","039","050","Greene County",47931,47220,50299,-711,-1.48338236214558,1.48338236214558,2368,4.94043520894619,4.94043520894619
"36","041","050","Hamilton County",5107,4370,5021,-737,-14.4311728999413,14.4311728999413,-86,-1.68396318778148,1.68396318778148
"36","043","050","Herkimer County",60139,61056,65592,917,1.52480087796605,1.52480087796605,5453,9.06732735828664,9.06732735828664
"36","045","050","Jefferson County",116721,108650,120923,-8071,-6.91477968831658,6.91477968831658,4202,3.60003769672981,3.60003769672981
"36","047","050","Kings County",2736074,2546958,2690353,-189116,-6.91194755697397,6.91194755697397,-45721,-1.67104398492146,1.67104398492146
"36","049","050","Lewis County",26582,26239,28409,-343,-1.29034685125273,1.29034685125273,1827,6.87307200361147,6.87307200361147
"36","051","050","Livingston County",61834,62561,66970,727,1.17572856357344,1.17572856357344,5136,8.30610990717081,8.30610990717081
"36","053","050","Madison County",68016,70589,75141,2573,3.78293342742884,3.78293342742884,7125,10.4754763585039,10.4754763585039
"36","055","050","Monroe County",759443,741770,768911,-17673,-2.3271002563721,2.3271002563721,9468,1.24670317588022,1.24670317588022
"36","057","050","Montgomery County",49532,49228,51348,-304,-0.613744649923282,0.613744649923282,1816,3.66631672454171,3.66631672454171
"36","059","050","Nassau County",1395774,1353544,1358932,-42230,-3.02556144476111,3.02556144476111,-36842,-2.63953906577999,2.63953906577999
"36","061","050","New York County",1694251,1618394,1674602,-75857,-4.47731770558199,4.47731770558199,-19649,-1.15974551586512,1.15974551586512
"36","063","050","Niagara County",212666,208781,220139,-3885,-1.82680823450857,1.82680823450857,7473,3.51396085881147,3.51396085881147
"36","065","050","Oneida County",232125,227713,238461,-4412,-1.9007000538503,1.9007000538503,6336,2.72956381260097,2.72956381260097
"36","067","050","Onondaga County",476516,459883,484739,-16633,-3.49054386421442,3.49054386421442,8223,1.72565034542387,1.72565034542387
"36","069","050","Ontario County",112458,110123,116141,-2335,-2.07633071902399,2.07633071902399,3683,3.27500044461043,3.27500044461043
"36","071","050","Orange County",401310,385352,397777,-15958,-3.97647703770153,3.97647703770153,-3533,-0.880366798734146,0.880366798734146
"36","073","050","Orleans County",40343,40097,43368,-246,-0.609771211858315,0.609771211858315,3025,7.49820291004635,7.49820291004635
"36","075","050","Oswego County",117525,116555,124891,-970,-0.825356307168688,0.825356307168688,7366,6.26760263773665,6.26760263773665
"36","077","050","Otsego County",58524,58883,63413,359,0.613423552730504,0.613423552730504,4889,8.35383774178115,8.35383774178115
"36","079","050","Putnam County",97668,98587,101146,919,0.940942785764017,0.940942785764017,3478,3.56104353524184,3.56104353524184
"36","081","050","Queens County",2405464,2235298,2334138,-170166,-7.0741445309512,7.0741445309512,-71326,-2.96516597213677,2.96516597213677
"36","083","050","Rensselaer County",161130,158394,164021,-2736,-1.69800781977285,1.69800781977285,2891,1.79420343821759,1.79420343821759
"36","085","050","Richmond County",495747,475845,482742,-19902,-4.01454774310283,4.01454774310283,-13005,-2.62331390810232,2.62331390810232
"36","087","050","Rockland County",338329,326446,321288,-11883,-3.51226173340151,3.51226173340151,-17041,-5.0368132793819,5.0368132793819
"36","089","050","St. Lawrence County",108505,107362,115055,-1143,-1.05340767706557,1.05340767706557,6550,6.03658817566011,6.03658817566011
"36","091","050","Saratoga County",235509,230224,242644,-5285,-2.24407559796016,2.24407559796016,7135,3.02960821030194,3.02960821030194
"36","093","050","Schenectady County",158061,155480,159311,-2581,-1.63291387502293,1.63291387502293,1250,0.790833918550433,0.790833918550433
"36","095","050","Schoharie County",29714,31116,33483,1402,4.71831459917884,4.71831459917884,3769,12.6842565793902,12.6842565793902
"36","097","050","Schuyler County",17898,17702,19269,-196,-1.09509442395798,1.09509442395798,1371,7.66007375125712,7.66007375125712
"36","099","050","Seneca County",33814,34044,36165,230,0.680191636600225,0.680191636600225,2351,6.95274146803099,6.95274146803099
"36","101","050","Steuben County",93584,94841,101103,1257,1.34317832108053,1.34317832108053,7519,8.03449307573944,8.03449307573944
"36","103","050","Suffolk County",1525920,1476136,1514018,-49784,-3.26255635944217,3.26255635944217,-11902,-0.779988465974625,0.779988465974625
"36","105","050","Sullivan County",78624,75775,81087,-2849,-3.6235754985755,3.6235754985755,2463,3.13263125763126,3.13263125763126
"36","107","050","Tioga County",48455,47997,52109,-458,-0.945206892993499,0.945206892993499,3654,7.5410174388608,7.5410174388608
"36","109","050","Tompkins County",105740,101336,110153,-4404,-4.16493285417061,4.16493285417061,4413,4.17344429733308,4.17344429733308
"36","111","050","Ulster County",181851,177839,187384,-4012,-2.20620178057861,2.20620178057861,5533,3.0426008105537,3.0426008105537
"36","113","050","Warren County",65737,63812,68516,-1925,-2.92833564050687,2.92833564050687,2779,4.2274518155681,4.2274518155681
"36","115","050","Washington County",61302,60752,65106,-550,-0.89719748132198,0.89719748132198,3804,6.20534403445238,6.20534403445238
"36","117","050","Wayne County",91283,89479,95841,-1804,-1.97627159493005,1.97627159493005,4558,4.99326271047183,4.99326271047183
"36","119","050","Westchester County",1004457,967141,970541,-37316,-3.7150420575495,3.7150420575495,-33916,-3.37655071347006,3.37655071347006
"36","121","050","Wyoming County",40531,39578,43571,-953,-2.35128666946288,2.35128666946288,3040,7.50043176827614,7.50043176827614
"36","123","050","Yates County",24774,24811,26392,37,0.149350125131186,0.149350125131186,1618,6.53104060708808,6.53104060708808
"37","001","050","Alamance County",171415,170945,167422,-470,-0.274188373246215,0.274188373246215,-3993,-2.32943441355774,2.32943441355774
"37","003","050","Alexander County",36444,37489,38308,1045,2.86741301723192,2.86741301723192,1864,5.11469652068928,5.11469652068928
"37","005","050","Alleghany County",10888,11202,11400,314,2.88390889052167,2.88390889052167,512,4.70242468772961,4.70242468772961
"37","007","050","Anson County",22055,23999,27211,1944,8.81432781682158,8.81432781682158,5156,23.3779188392655,23.3779188392655
"37","009","050","Ashe County",26577,27206,28266,629,2.36670805583775,2.36670805583775,1689,6.35511908793318,6.35511908793318
"37","011","050","Avery County",17806,17577,18548,-229,-1.28608334269347,1.28608334269347,742,4.16713467370549,4.16713467370549
"37","013","050","Beaufort County",44652,47152,51272,2500,5.59885335483293,5.59885335483293,6620,14.8257636835976,14.8257636835976
"37","015","050","Bertie County",17934,18787,21338,853,4.7563287610126,4.7563287610126,3404,18.9807070369131,18.9807070369131
"37","017","050","Bladen County",29606,32939,35858,3333,11.2578531378775,11.2578531378775,6252,21.1173410795109,21.1173410795109
"37","019","050","Brunswick County",136693,147669,135338,10976,8.02967233142882,8.02967233142882,-1355,-0.991272413364254,0.991272413364254
"37","021","050","Buncombe County",269452,263254,272089,-6198,-2.30022415866277,2.30022415866277,2637,0.978652969731158,0.978652969731158
"37","023","050","Burke County",87570,90508,92870,2938,3.35503026150508,3.35503026150508,5300,6.05230101632979,6.05230101632979
"37","025","050","Cabarrus County",225804,220350,208867,-5454,-2.41536908115002,2.41536908115002,-16937,-7.50075286531682,7.50075286531682
"37","027","050","Caldwell County",80652,82230,84383,1578,1.95655408421366,1.95655408421366,3731,4.62604771115409,4.62604771115409
"37","029","050","Camden County",10355,10949,10797,594,5.7363592467407,5.7363592467407,442,4.26846933848382,4.26846933848382
"37","031","050","Carteret County",67686,69611,70779,1925,2.84401501048961,2.84401501048961,3093,4.56963035191916,4.56963035191916
"37","033","050","Caswell County",22736,22507,24326,-229,-1.00721323011963,1.00721323011963,1590,6.99331456720619,6.99331456720619
"37","035","050","Catawba County",160610,160207,160174,-403,-0.250918373700268,0.250918373700268,-436,-0.271465039536766,0.271465039536766
"37","037","050","Chatham County",76285,75478,75966,-807,-1.05787507373665,1.05787507373665,-319,-0.418168709444845,0.418168709444845
"37","039","050","Cherokee County",28774,29014,29374,240,0.834086327934941,0.834086327934941,600,2.08521581983735,2.08521581983735
"37","041","050","Chowan County",13708,13865,14909,157,1.14531660344324,1.14531660344324,1201,8.76130726583017,8.76130726583017
"37","043","050","Clay County",11089,11462,11080,373,3.36369375056362,3.36369375056362,-9,-0.0811615114077013,0.0811615114077013
"37","045","050","Cleveland County",99519,98857,99185,-662,-0.6651996101247,0.6651996101247,-334,-0.335614304806117,0.335614304806117
"37","047","050","Columbus County",50623,54978,58995,4355,8.60280899986172,8.60280899986172,8372,16.5379373012267,16.5379373012267
"37","049","050","Craven County",100720,101502,110296,782,0.776409849086577,0.776409849086577,9576,9.50754567116759,9.50754567116759
"37","051","050","Cumberland County",334728,336589,348605,1861,0.555973805597381,0.555973805597381,13877,4.14575416457542,4.14575416457542
"37","053","050","Currituck County",28100,28804,27314,704,2.50533807829181,2.50533807829181,-786,-2.79715302491103,2.79715302491103
"37","055","050","Dare County",36915,37479,35960,564,1.52783421373425,1.52783421373425,-955,-2.5870242448869,2.5870242448869
"37","057","050","Davidson County",168930,169077,171545,147,0.087018291600071,0.087018291600071,2615,1.54797845261351,1.54797845261351
"37","059","050","Davie County",42712,43177,44017,465,1.08868702004121,1.08868702004121,1305,3.05534744334145,3.05534744334145
"37","061","050","Duplin County",48715,58856,59253,10141,20.8169968182285,20.8169968182285,10538,21.6319408806322,21.6319408806322
"37","063","050","Durham County",324833,326421,325120,1588,0.488866586830771,0.488866586830771,287,0.0883530922043019,0.0883530922043019
"37","065","050","Edgecombe County",48900,51023,57057,2123,4.34151329243354,4.34151329243354,8157,16.680981595092,16.680981595092
"37","067","050","Forsyth County",382590,383658,380534,1068,0.279150003920646,0.279150003920646,-2056,-0.53738989518806,0.53738989518806
"37","069","050","Franklin County",68573,71366,69347,2793,4.07303165969113,4.07303165969113,774,1.12872413340528,1.12872413340528
"37","071","050","Gaston County",227943,226209,222835,-1734,-0.760716494913202,0.760716494913202,-5108,-2.24091110496922,2.24091110496922
"37","073","050","Gates County",10478,11502,12906,1024,9.77285741553731,9.77285741553731,2428,23.1723611376217,23.1723611376217
"37","075","050","Graham County",8030,8481,9082,451,5.61643835616438,5.61643835616438,1052,13.1008717310087,13.1008717310087
"37","077","050","Granville County",60992,60494,63173,-498,-0.816500524658972,0.816500524658972,2181,3.57587880377754,3.57587880377754
"37","079","050","Greene County",20451,20942,21843,491,2.400860593614,2.400860593614,1392,6.80651312894235,6.80651312894235
"37","081","050","Guilford County",541299,540188,521463,-1111,-0.2052470076612,0.2052470076612,-19836,-3.66451813138395,3.66451813138395
"37","083","050","Halifax County",48622,49660,55248,1038,2.13483608243182,2.13483608243182,6626,13.6275759944058,13.6275759944058
"37","085","050","Harnett County",133568,136902,131281,3334,2.49610685194058,2.49610685194058,-2287,-1.71223646382367,1.71223646382367
"37","087","050","Haywood County",62089,62889,60847,800,1.28847299843773,1.28847299843773,-1242,-2.00035433007457,2.00035433007457
"37","089","050","Henderson County",116281,118252,115617,1971,1.69503186247108,1.69503186247108,-664,-0.571030520893353,0.571030520893353
"37","091","050","Hertford County",21552,23264,24679,1712,7.94357832219748,7.94357832219748,3127,14.5090942835932,14.5090942835932
"37","093","050","Hoke County",52082,55708,55515,3626,6.96209822971468,6.96209822971468,3433,6.59152874313582,6.59152874313582
"37","095","050","Hyde County",4589,4865,5918,276,6.01438221834822,6.01438221834822,1329,28.960557855742,28.960557855742
"37","097","050","Iredell County",186693,184874,181009,-1819,-0.974326836035631,0.974326836035631,-5684,-3.04457049809045,3.04457049809045
"37","099","050","Jackson County",43109,43973,44090,864,2.00422185622492,2.00422185622492,981,2.27562689925538,2.27562689925538
"37","101","050","Johnston County",215999,214730,204150,-1269,-0.58750271992,0.58750271992,-11849,-5.48567354478493,5.48567354478493
"37","103","050","Jones County",9172,9289,10566,117,1.27562145660707,1.27562145660707,1394,15.1984300043611,15.1984300043611
"37","105","050","Lee County",63285,62248,59539,-1037,-1.63861894603777,1.63861894603777,-3746,-5.91925416765426,5.91925416765426
"37","107","050","Lenoir County",55122,55840,60233,718,1.30256521896883,1.30256521896883,5111,9.27215993614165,9.27215993614165
"37","109","050","Lincoln County",86810,87765,88546,955,1.10010367469186,1.10010367469186,1736,1.99976961179588,1.99976961179588
"37","111","050","McDowell County",44578,45806,46919,1228,2.75472206020907,2.75472206020907,2341,5.25146933464938,5.25146933464938
"37","113","050","Macon County",37014,35944,34497,-1070,-2.89079807640352,2.89079807640352,-2517,-6.80012968066137,6.80012968066137
"37","115","050","Madison County",21193,21730,21999,537,2.53385551833152,2.53385551833152,806,3.80314254706743,3.80314254706743
"37","117","050","Martin County",22031,22253,24247,222,1.00767100903273,1.00767100903273,2216,10.0585538559303,10.0585538559303
"37","119","050","Mecklenburg County",1115482,1125666,1097960,10184,0.912968564261907,0.912968564261907,-17522,-1.57080078387639,1.57080078387639
"37","121","050","Mitchell County",14903,14904,15831,1,0.00671005837750788,0.00671005837750788,928,6.22693417432732,6.22693417432732
"37","123","050","Montgomery County",25751,27256,28564,1505,5.84443322589414,5.84443322589414,2813,10.9238476175682,10.9238476175682
"37","125","050","Moore County",99727,102879,98903,3152,3.16062851584827,3.16062851584827,-824,-0.826255678000943,0.826255678000943
"37","127","050","Nash County",94970,94751,98467,-219,-0.230599136569443,0.230599136569443,3497,3.68221543645362,3.68221543645362
"37","129","050","New Hanover County",225702,236121,233650,10419,4.6162639232262,4.6162639232262,7948,3.52145749705364,3.52145749705364
"37","131","050","Northampton County",17471,19198,22087,1727,9.88495220651365,9.88495220651365,4616,26.4209261061187,26.4209261061187
"37","133","050","Onslow County",204576,203718,213793,-858,-0.419404035664007,0.419404035664007,9217,4.5054160800876,4.5054160800876
"37","135","050","Orange County",148696,148921,145939,225,0.151315435519449,0.151315435519449,-2757,-1.85411846989832,1.85411846989832
"37","137","050","Pamlico County",12276,12702,13672,426,3.47018572825024,3.47018572825024,1396,11.3717823395243,11.3717823395243
"37","139","050","Pasquotank County",40568,40286,42142,-282,-0.695129165845001,0.695129165845001,1574,3.87990534411359,3.87990534411359
"37","141","050","Pender County",60203,64280,59420,4077,6.77208776971247,6.77208776971247,-783,-1.3005996378918,1.3005996378918
"37","143","050","Perquimans County",13005,13632,13916,627,4.82122260668973,4.82122260668973,911,7.00499807766244,7.00499807766244
"37","145","050","Person County",39097,39865,40550,768,1.96434509041614,1.96434509041614,1453,3.71639767757117,3.71639767757117
"37","147","050","Pitt County",170243,182581,183795,12338,7.24728770052219,7.24728770052219,13552,7.96038603643028,7.96038603643028
"37","149","050","Polk County",19328,20968,21343,1640,8.48509933774834,8.48509933774834,2015,10.4252897350993,10.4252897350993
"37","151","050","Randolph County",144171,144360,146607,189,0.131094325488482,0.131094325488482,2436,1.68966019518488,1.68966019518488
"37","153","050","Richmond County",42946,44446,49782,1500,3.49275834769245,3.49275834769245,6836,15.9176640432171,15.9176640432171
"37","155","050","Robeson County",116530,130152,136599,13622,11.6896936411225,11.6896936411225,20069,17.2221745473269,17.2221745473269
"37","157","050","Rockingham County",91096,91298,95393,202,0.221744094142443,0.221744094142443,4297,4.71700184420831,4.71700184420831
"37","159","050","Rowan County",146875,142373,144595,-4502,-3.0651914893617,3.0651914893617,-2280,-1.55234042553191,1.55234042553191
"37","161","050","Rutherford County",64444,67072,69364,2628,4.07795915833902,4.07795915833902,4920,7.63453541058904,7.63453541058904
"37","163","050","Sampson County",59036,63399,65428,4363,7.39040585405515,7.39040585405515,6392,10.8272918219392,10.8272918219392
"37","165","050","Scotland County",34174,34659,36493,485,1.41920758471352,1.41920758471352,2319,6.78586059577457,6.78586059577457
"37","167","050","Stanly County",62504,63104,63504,600,0.959938563931908,0.959938563931908,1000,1.59989760655318,1.59989760655318
"37","169","050","Stokes County",44520,45729,48414,1209,2.71563342318059,2.71563342318059,3894,8.7466307277628,8.7466307277628
"37","171","050","Surry County",71359,71716,75342,357,0.500287279810535,0.500287279810535,3983,5.5816365139646,5.5816365139646
"37","173","050","Swain County",14117,14208,14730,91,0.644612878090246,0.644612878090246,613,4.34228235460792,4.34228235460792
"37","175","050","Transylvania County",32986,34446,34349,1460,4.42612017219426,4.42612017219426,1363,4.13205602376766,4.13205602376766
"37","177","050","Tyrrell County",3245,3779,4460,534,16.4560862865948,16.4560862865948,1215,37.442218798151,37.442218798151
"37","179","050","Union County",238267,243504,235202,5237,2.19795439569894,2.19795439569894,-3065,-1.2863720112311,1.2863720112311
"37","181","050","Vance County",42578,44696,45620,2118,4.97439992484382,4.97439992484382,3042,7.14453473624877,7.14453473624877
"37","183","050","Wake County",1129410,1127989,1115212,-1421,-0.12581790492381,0.12581790492381,-14198,-1.25711654757794,1.25711654757794
"37","185","050","Warren County",18642,19542,21557,900,4.82780817508851,4.82780817508851,2915,15.6367342559811,15.6367342559811
"37","187","050","Washington County",11003,11532,13124,529,4.80777969644642,4.80777969644642,2121,19.276560937926,19.276560937926
"37","189","050","Watauga County",54086,56381,55007,2295,4.24324224383389,4.24324224383389,921,1.70284361942092,1.70284361942092
"37","191","050","Wayne County",117333,123990,127225,6657,5.67359566362404,5.67359566362404,9892,8.43070576905048,8.43070576905048
"37","193","050","Wilkes County",65969,68116,70843,2147,3.25455895951129,3.25455895951129,4874,7.38831875577923,7.38831875577923
"37","195","050","Wilson County",78784,81963,83737,3179,4.03508326563769,4.03508326563769,4953,6.28680950446791,6.28680950446791
"37","197","050","Yadkin County",37214,37630,38727,416,1.11785887031762,1.11785887031762,1513,4.06567420863116,4.06567420863116
"37","199","050","Yancey County",18470,18078,18293,-392,-2.122360584732,2.122360584732,-177,-0.958310774228479,0.958310774228479
"38","001","050","Adams County",2200,2219,2464,19,0.863636363636364,0.863636363636364,264,12,12
"38","003","050","Barnes County",10853,10437,11692,-416,-3.83304155533032,3.83304155533032,839,7.73058140606284,7.73058140606284
"38","005","050","Benson County",5964,6794,6963,830,13.9168343393695,13.9168343393695,999,16.7505030181086,16.7505030181086
"38","007","050","Billings County",945,897,910,-48,-5.07936507936508,5.07936507936508,-35,-3.7037037037037,3.7037037037037
"38","009","050","Bottineau County",6379,6316,6682,-63,-0.98761561373256,0.98761561373256,303,4.74996080890422,4.74996080890422
"38","011","050","Bowman County",2993,3009,3323,16,0.534580688272636,0.534580688272636,330,11.0257266956231,11.0257266956231
"38","013","050","Burke County",2201,2131,2140,-70,-3.18037255792821,3.18037255792821,-61,-2.77146751476602,2.77146751476602
"38","015","050","Burleigh County",98458,96190,99418,-2268,-2.30352028276016,2.30352028276016,960,0.975035040321761,0.975035040321761
"38","017","050","Cass County",184525,183584,190196,-941,-0.509958000270966,0.509958000270966,5671,3.07329630131419,3.07329630131419
"38","019","050","Cavalier County",3704,3719,4082,15,0.404967602591793,0.404967602591793,378,10.2051835853132,10.2051835853132
"38","021","050","Dickey County",4999,4747,5313,-252,-5.04100820164033,5.04100820164033,314,6.28125625125025,6.28125625125025
"38","023","050","Divide County",2195,2283,2398,88,4.00911161731207,4.00911161731207,203,9.24829157175399,9.24829157175399
"38","025","050","Dunn County",4095,4469,4269,374,9.13308913308913,9.13308913308913,174,4.24908424908425,4.24908424908425
"38","027","050","Eddy County",2347,2195,2439,-152,-6.47635279079676,6.47635279079676,92,3.91989774179804,3.91989774179804
"38","029","050","Emmons County",3301,3213,3681,-88,-2.66585883065738,2.66585883065738,380,11.5116631323841,11.5116631323841
"38","031","050","Foster County",3397,3177,3385,-220,-6.47630261995879,6.47630261995879,-12,-0.35325287017957,0.35325287017957
"38","033","050","Golden Valley County",1736,1747,1831,11,0.633640552995392,0.633640552995392,95,5.47235023041475,5.47235023041475
"38","035","050","Grand Forks County",73170,69540,76637,-3630,-4.96104961049611,4.96104961049611,3467,4.73828071614049,4.73828071614049
"38","037","050","Grant County",2301,2232,2490,-69,-2.9986962190352,2.9986962190352,189,8.21382007822686,8.21382007822686
"38","039","050","Griggs County",2306,2213,2416,-93,-4.03295750216826,4.03295750216826,110,4.77016478751084,4.77016478751084
"38","041","050","Hettinger County",2489,2456,2511,-33,-1.32583366813982,1.32583366813982,22,0.88388911209321,0.88388911209321
"38","043","050","Kidder County",2394,2470,2531,76,3.17460317460317,3.17460317460317,137,5.72263993316625,5.72263993316625
"38","045","050","LaMoure County",4093,4046,4182,-47,-1.14830197898852,1.14830197898852,89,2.17444417297826,2.17444417297826
"38","047","050","Logan County",1876,1883,2021,7,0.373134328358209,0.373134328358209,145,7.72921108742004,7.72921108742004
"38","049","050","McHenry County",5345,5721,5818,376,7.03461178671656,7.03461178671656,473,8.84939195509822,8.84939195509822
"38","051","050","McIntosh County",2530,2447,2810,-83,-3.28063241106719,3.28063241106719,280,11.0671936758893,11.0671936758893
"38","053","050","McKenzie County",14704,15212,14313,508,3.45484221980414,3.45484221980414,-391,-2.65914036996736,2.65914036996736
"38","055","050","McLean County",9771,9427,10137,-344,-3.52062224951387,3.52062224951387,366,3.74577832361068,3.74577832361068
"38","057","050","Mercer County",8350,8203,9144,-147,-1.76047904191617,1.76047904191617,794,9.50898203592814,9.50898203592814
"38","059","050","Morton County",33291,31467,35395,-1824,-5.47895827701181,5.47895827701181,2104,6.32002643357063,6.32002643357063
"38","061","050","Mountrail County",9809,10499,9742,690,7.03435620348659,7.03435620348659,-67,-0.683046182077684,0.683046182077684
"38","063","050","Nelson County",3015,2805,3165,-210,-6.96517412935323,6.96517412935323,150,4.97512437810945,4.97512437810945
"38","065","050","Oliver County",1877,1927,1995,50,2.6638252530634,2.6638252530634,118,6.28662759722962,6.28662759722962
"38","067","050","Pembina County",6844,6697,7418,-147,-2.1478667445938,2.1478667445938,574,8.38690824079486,8.38690824079486
"38","069","050","Pierce County",3990,3946,4476,-44,-1.10275689223058,1.10275689223058,486,12.1804511278195,12.1804511278195
"38","071","050","Ramsey County",11605,11407,11951,-198,-1.70616113744076,1.70616113744076,346,2.98147350280052,2.98147350280052
"38","073","050","Ransom County",5703,5186,5535,-517,-9.06540417324215,9.06540417324215,-168,-2.9458179905313,2.9458179905313
"38","075","050","Renville County",2282,2294,2563,12,0.525854513584575,0.525854513584575,281,12.3137598597721,12.3137598597721
"38","077","050","Richland County",16529,16175,16978,-354,-2.14169036239337,2.14169036239337,449,2.71643777603001,2.71643777603001
"38","079","050","Rolette County",12187,14183,14492,1996,16.378107819808,16.378107819808,2305,18.9135964552392,18.9135964552392
"38","081","050","Sargent County",3862,3914,4202,52,1.34645261522527,1.34645261522527,340,8.80372863801139,8.80372863801139
"38","083","050","Sheridan County",1265,1280,1382,15,1.18577075098814,1.18577075098814,117,9.24901185770751,9.24901185770751
"38","085","050","Sioux County",3898,4178,4268,280,7.18317085684967,7.18317085684967,370,9.4920472036942,9.4920472036942
"38","087","050","Slope County",706,742,757,36,5.09915014164306,5.09915014164306,51,7.22379603399433,7.22379603399433
"38","089","050","Stark County",33646,31939,33633,-1707,-5.07341140105808,5.07341140105808,-13,-0.0386375795042501,0.0386375795042501
"38","091","050","Steele County",1798,1896,2027,98,5.45050055617353,5.45050055617353,229,12.7363737486096,12.7363737486096
"38","093","050","Stutsman County",21593,20524,21913,-1069,-4.95067846061224,4.95067846061224,320,1.48196174686241,1.48196174686241
"38","095","050","Towner County",2162,2114,2248,-48,-2.22016651248844,2.22016651248844,86,3.97779833487512,3.97779833487512
"38","097","050","Traill County",7997,7975,8295,-22,-0.275103163686382,0.275103163686382,298,3.72639739902463,3.72639739902463
"38","099","050","Walsh County",10563,10451,11365,-112,-1.06030483764082,1.06030483764082,802,7.5925399981066,7.5925399981066
"38","101","050","Ward County",69919,68446,76559,-1473,-2.10672349432915,2.10672349432915,6640,9.49670332813684,9.49670332813684
"38","103","050","Wells County",3982,3730,4243,-252,-6.32847815168257,6.32847815168257,261,6.55449522852838,6.55449522852838
"38","105","050","Williams County",40950,38472,42114,-2478,-6.05128205128205,6.05128205128205,1164,2.84249084249084,2.84249084249084
"39","001","050","Adams County",27477,27580,28486,103,0.374858972959202,0.374858972959202,1009,3.6721621719984,3.6721621719984
"39","003","050","Allen County",102206,102184,106942,-22,-0.0215251550789582,0.0215251550789582,4736,4.63377883881573,4.63377883881573
"39","005","050","Ashland County",52447,53426,53765,979,1.86664632867466,1.86664632867466,1318,2.51301313707171,2.51301313707171
"39","007","050","Ashtabula County",97574,96751,101999,-823,-0.843462397769898,0.843462397769898,4425,4.53501957488675,4.53501957488675
"39","009","050","Athens County",62431,65557,65482,3126,5.00712786916756,5.00712786916756,3051,4.88699524274799,4.88699524274799
"39","011","050","Auglaize County",46422,45709,47423,-713,-1.53590969798802,1.53590969798802,1001,2.15630520012063,2.15630520012063
"39","013","050","Belmont County",66497,66233,69860,-264,-0.397010391446231,0.397010391446231,3363,5.05737100921846,5.05737100921846
"39","015","050","Brown County",43676,43482,48076,-194,-0.444179869951461,0.444179869951461,4400,10.0741826174558,10.0741826174558
"39","017","050","Butler County",390357,385348,381577,-5009,-1.2831843671306,1.2831843671306,-8780,-2.24922314701671,2.24922314701671
"39","019","050","Carroll County",26721,26937,28668,216,0.808352980801617,0.808352980801617,1947,7.28640395194791,7.28640395194791
"39","021","050","Champaign County",38714,38984,40395,270,0.697422121196466,0.697422121196466,1681,4.34209846567133,4.34209846567133
"39","023","050","Clark County",136001,133888,137922,-2113,-1.55366504658054,1.55366504658054,1921,1.41248961404696,1.41248961404696
"39","025","050","Clermont County",208601,207391,206701,-1210,-0.580054745662772,0.580054745662772,-1900,-0.91082976591675,0.91082976591675
"39","027","050","Clinton County",42018,41980,42320,-38,-0.0904374315769432,0.0904374315769432,302,0.718739587795707,0.718739587795707
"39","029","050","Columbiana County",101877,101351,107280,-526,-0.516308882279612,0.516308882279612,5403,5.303454165317,5.303454165317
"39","031","050","Coshocton County",36612,36500,36626,-112,-0.305910630394406,0.305910630394406,14,0.0382388287993008,0.0382388287993008
"39","033","050","Crawford County",42025,41385,43377,-640,-1.52290303390839,1.52290303390839,1352,3.21713265913147,3.21713265913147
"39","035","050","Cuyahoga County",1264817,1230610,1270020,-34207,-2.70450191608747,2.70450191608747,5203,0.411363857380159,0.411363857380159
"39","037","050","Darke County",51881,51240,53818,-641,-1.23551974711359,1.23551974711359,1937,3.73354407201095,3.73354407201095
"39","039","050","Defiance County",38286,37859,39280,-427,-1.11529018440161,1.11529018440161,994,2.59624928172178,2.59624928172178
"39","041","050","Delaware County",214124,212722,203645,-1402,-0.654760792811642,0.654760792811642,-10479,-4.89389325811212,4.89389325811212
"39","043","050","Erie County",75622,73888,77222,-1734,-2.29298352331332,2.29298352331332,1600,2.11578641136177,2.11578641136177
"39","045","050","Fairfield County",158921,159298,155840,377,0.237224784641426,0.237224784641426,-3081,-1.93869910206958,1.93869910206958
"39","047","050","Fayette County",28951,28573,29533,-378,-1.30565438154122,1.30565438154122,582,2.01029325411903,2.01029325411903
"39","049","050","Franklin County",1323807,1323855,1251143,48,0.0036259061932744,0.0036259061932744,-72664,-5.48901765891856,5.48901765891856
"39","051","050","Fulton County",42713,41985,43247,-728,-1.70439912907077,1.70439912907077,534,1.25020485566455,1.25020485566455
"39","053","050","Gallia County",29220,29826,30908,606,2.07392197125257,2.07392197125257,1688,5.77686516084873,5.77686516084873
"39","055","050","Geauga County",95397,93369,95736,-2028,-2.12585301424573,2.12585301424573,339,0.35535708670084,0.35535708670084
"39","057","050","Greene County",167966,170008,169742,2042,1.21572222949883,1.21572222949883,1776,1.05735684602836,1.05735684602836
"39","059","050","Guernsey County",38438,38816,40497,378,0.983401841927259,0.983401841927259,2059,5.35667828711171,5.35667828711171
"39","061","050","Hamilton County",830639,818621,811248,-12018,-1.44683791635115,1.44683791635115,-19391,-2.33446780129515,2.33446780129515
"39","063","050","Hancock County",74920,75519,78320,599,0.799519487453284,0.799519487453284,3400,4.53817405232248,4.53817405232248
"39","065","050","Hardin County",30696,31460,32437,764,2.48892363825906,2.48892363825906,1741,5.67174876205369,5.67174876205369
"39","067","050","Harrison County",14483,15030,15683,547,3.77684181454119,3.77684181454119,1200,8.28557619277774,8.28557619277774
"39","069","050","Henry County",27662,26925,28698,-737,-2.66430482250018,2.66430482250018,1036,3.74521003542766,3.74521003542766
"39","071","050","Highland County",43317,43282,43475,-35,-0.0807996860355057,0.0807996860355057,158,0.364752868388854,0.364752868388854
"39","073","050","Hocking County",28050,28151,29404,101,0.360071301247772,0.360071301247772,1354,4.8270944741533,4.8270944741533
"39","075","050","Holmes County",44223,44016,42039,-207,-0.468082219659453,0.468082219659453,-2184,-4.93860660742148,4.93860660742148
"39","077","050","Huron County",58565,58064,59907,-501,-0.855459745581832,0.855459745581832,1342,2.29147101511141,2.29147101511141
"39","079","050","Jackson County",32653,32476,34196,-177,-0.542063516369093,0.542063516369093,1543,4.72544636021192,4.72544636021192
"39","081","050","Jefferson County",65249,65121,68726,-128,-0.196171588836611,0.196171588836611,3477,5.32881729988199,5.32881729988199
"39","083","050","Knox County",62721,62401,63257,-320,-0.510195947130945,0.510195947130945,536,0.854578211444333,0.854578211444333
"39","085","050","Lake County",232603,229745,235709,-2858,-1.22870298319454,1.22870298319454,3106,1.33532241630589,1.33532241630589
"39","087","050","Lawrence County",58240,59214,62327,974,1.67239010989011,1.67239010989011,4087,7.01751373626374,7.01751373626374
"39","089","050","Licking County",178519,177945,171430,-574,-0.321534402500574,0.321534402500574,-7089,-3.97100588732852,3.97100588732852
"39","091","050","Logan County",46150,45419,46610,-731,-1.5839653304442,1.5839653304442,460,0.996749729144095,0.996749729144095
"39","093","050","Lorain County",312964,311797,316751,-1167,-0.372886338364796,0.372886338364796,3787,1.21004332766708,1.21004332766708
"39","095","050","Lucas County",431279,428666,445223,-2613,-0.605872300761224,0.605872300761224,13944,3.23317388511845,3.23317388511845
"39","097","050","Madison County",43824,44634,44427,810,1.84830230010953,1.84830230010953,603,1.37595837897043,1.37595837897043
"39","099","050","Mahoning County",228614,226551,237432,-2063,-0.902394429037592,0.902394429037592,8818,3.8571566045824,3.8571566045824
"39","101","050","Marion County",65359,64911,66603,-448,-0.685445003748527,0.685445003748527,1244,1.90333389433743,1.90333389433743
"39","103","050","Medina County",182470,180792,184037,-1678,-0.919603222447526,0.919603222447526,1567,0.858771304872034,0.858771304872034
"39","105","050","Meigs County",22210,22728,23884,518,2.33228275551553,2.33228275551553,1674,7.53714542998649,7.53714542998649
"39","107","050","Mercer County",42528,41272,42424,-1256,-2.95334838224229,2.95334838224229,-104,-0.244544770504138,0.244544770504138
"39","109","050","Miami County",108774,107428,102892,-1346,-1.23742806185302,1.23742806185302,-5882,-5.40754224355085,5.40754224355085
"39","111","050","Monroe County",13385,13625,14467,240,1.79305192379529,1.79305192379529,1082,8.08367575644378,8.08367575644378
"39","113","050","Montgomery County",537309,532022,535835,-5287,-0.983977562259333,0.983977562259333,-1474,-0.274330041000616,0.274330041000616
"39","115","050","Morgan County",13802,14347,15381,545,3.9487030865092,3.9487030865092,1579,11.4403709607303,11.4403709607303
"39","117","050","Morrow County",34950,35392,35524,442,1.26466380543634,1.26466380543634,574,1.64234620886981,1.64234620886981
"39","119","050","Muskingum County",86410,86058,85758,-352,-0.407360259229256,0.407360259229256,-652,-0.754542298345099,0.754542298345099
"39","121","050","Noble County",14115,14389,15101,274,1.94119730782855,1.94119730782855,986,6.98547644349982,6.98547644349982
"39","123","050","Ottawa County",40364,40342,42753,-22,-0.0545040134773561,0.0545040134773561,2389,5.91864037260926,5.91864037260926
"39","125","050","Paulding County",18806,18659,19767,-147,-0.781665425927895,0.781665425927895,961,5.11007125385515,5.11007125385515
"39","127","050","Perry County",35408,36201,36541,793,2.23960686850429,2.23960686850429,1133,3.19984184365115,3.19984184365115
"39","129","050","Pickaway County",58539,58636,57044,97,0.165701498146535,0.165701498146535,-1495,-2.55385298689762,2.55385298689762
"39","131","050","Pike County",27088,27730,30085,642,2.37005316007088,2.37005316007088,2997,11.0639397519197,11.0639397519197
"39","133","050","Portage County",161791,162597,167416,806,0.498173569605231,0.498173569605231,5625,3.47670760425487,3.47670760425487
"39","135","050","Preble County",40999,40848,42391,-151,-0.36830166589429,0.36830166589429,1392,3.39520476109173,3.39520476109173
"39","137","050","Putnam County",34451,33711,35242,-740,-2.14797828800325,2.14797828800325,791,2.29601462947375,2.29601462947375
"39","139","050","Richland County",124936,121065,123239,-3871,-3.0983863738234,3.0983863738234,-1697,-1.358295447269,1.358295447269
"39","141","050","Ross County",77093,76485,77754,-608,-0.78865785479875,0.78865785479875,661,0.857405990167719,0.857405990167719
"39","143","050","Sandusky County",58896,58409,60884,-487,-0.826881282260255,0.826881282260255,1988,3.37544145612605,3.37544145612605
"39","145","050","Scioto County",74008,74543,80509,535,0.722894822181386,0.722894822181386,6501,8.78418549346017,8.78418549346017
"39","147","050","Seneca County",55069,55015,56969,-54,-0.0980587989613031,0.0980587989613031,1900,3.45021700049029,3.45021700049029
"39","149","050","Shelby County",48230,48403,50320,173,0.358697905867717,0.358697905867717,2090,4.33340244660999,4.33340244660999
"39","151","050","Stark County",374853,370173,380630,-4680,-1.24848940784788,1.24848940784788,5777,1.54113745921735,1.54113745921735
"39","153","050","Summit County",540428,539638,544915,-790,-0.146180434766518,0.146180434766518,4487,0.83026786176882,0.83026786176882
"39","155","050","Trumbull County",201977,197194,209062,-4783,-2.36809141634939,2.36809141634939,7085,3.50782514840799,3.50782514840799
"39","157","050","Tuscarawas County",93263,91853,92652,-1410,-1.51185357537287,1.51185357537287,-611,-0.655136549328244,0.655136549328244
"39","159","050","Union County",62784,59754,61503,-3030,-4.82607033639144,4.82607033639144,-1281,-2.04032874617737,2.04032874617737
"39","161","050","Van Wert County",28931,28179,28955,-752,-2.59928796101068,2.59928796101068,24,0.08295599875566,0.08295599875566
"39","163","050","Vinton County",12800,12987,13421,187,1.4609375,1.4609375,621,4.8515625,4.8515625
"39","165","050","Warren County",242337,237769,239179,-4568,-1.88497835658608,1.88497835658608,-3158,-1.30314396893582,1.30314396893582
"39","167","050","Washington County",59771,59747,61443,-24,-0.0401532515768517,0.0401532515768517,1672,2.79734319318733,2.79734319318733
"39","169","050","Wayne County",116894,115747,117576,-1147,-0.98123085872671,0.98123085872671,682,0.583434564648314,0.583434564648314
"39","171","050","Williams County",37102,36611,37641,-491,-1.32337879359603,1.32337879359603,539,1.45275187321438,1.45275187321438
"39","173","050","Wood County",132248,131111,127484,-1137,-0.859748351581876,0.859748351581876,-4764,-3.60232290847499,3.60232290847499
"39","175","050","Wyandot County",21900,21712,22850,-188,-0.858447488584475,0.858447488584475,950,4.337899543379,4.337899543379
"40","001","050","Adair County",19495,22051,23393,2556,13.1110541164401,13.1110541164401,3898,19.9948704796102,19.9948704796102
"40","003","050","Alfalfa County",5699,5719,5543,20,0.350938761186173,0.350938761186173,-156,-2.73732233725215,2.73732233725215
"40","005","050","Atoka County",14143,13899,14448,-244,-1.72523509863537,1.72523509863537,305,2.15654387329421,2.15654387329421
"40","007","050","Beaver County",5049,5248,5674,199,3.94137452960982,3.94137452960982,625,12.3786888492771,12.3786888492771
"40","009","050","Beckham County",22410,21603,23089,-807,-3.60107095046854,3.60107095046854,679,3.02989736724676,3.02989736724676
"40","011","050","Blaine County",8735,9474,11945,739,8.46021751574127,8.46021751574127,3210,36.7487120778477,36.7487120778477
"40","013","050","Bryan County",46067,48804,44876,2737,5.94134629995441,5.94134629995441,-1191,-2.58536479475546,2.58536479475546
"40","015","050","Caddo County",26945,28777,29855,1832,6.79903507144183,6.79903507144183,2910,10.7997773241789,10.7997773241789
"40","017","050","Canadian County",154405,152155,126080,-2250,-1.45720669667433,1.45720669667433,-28325,-18.344613192578,18.344613192578
"40","019","050","Carter County",48003,48407,49424,404,0.841614065787555,0.841614065787555,1421,2.9602316521884,2.9602316521884
"40","021","050","Cherokee County",47078,49028,49264,1950,4.1420621096903,4.1420621096903,2186,4.64335783168359,4.64335783168359
"40","023","050","Choctaw County",14204,14673,15431,469,3.30188679245283,3.30188679245283,1227,8.63841171500986,8.63841171500986
"40","025","050","Cimarron County",2296,2161,2455,-135,-5.87979094076655,5.87979094076655,159,6.92508710801394,6.92508710801394
"40","027","050","Cleveland County",295528,286588,287394,-8940,-3.02509406892071,3.02509406892071,-8134,-2.75236187434016,2.75236187434016
"40","029","050","Coal County",5266,5581,5988,315,5.98176984428409,5.98176984428409,722,13.7105962780099,13.7105962780099
"40","031","050","Comanche County",121125,121182,126255,57,0.0470588235294118,0.0470588235294118,5130,4.23529411764706,4.23529411764706
"40","033","050","Cotton County",5527,5683,6131,156,2.82250768952415,2.82250768952415,604,10.9281707979012,10.9281707979012
"40","035","050","Craig County",14107,14192,15014,85,0.602537747217693,0.602537747217693,907,6.42943219678174,6.42943219678174
"40","037","050","Creek County",71754,71524,72651,-230,-0.320539621484517,0.320539621484517,897,1.25010452378961,1.25010452378961
"40","039","050","Custer County",28513,28757,28685,244,0.85575000876793,0.85575000876793,172,0.603233612738049,0.603233612738049
"40","041","050","Delaware County",40397,43138,43041,2741,6.78515731366191,6.78515731366191,2644,6.54504047330247,6.54504047330247
"40","043","050","Dewey County",4484,4848,4824,364,8.11775200713648,8.11775200713648,340,7.58251561106155,7.58251561106155
"40","045","050","Ellis County",3749,3843,4116,94,2.50733528941051,2.50733528941051,367,9.78927714057082,9.78927714057082
"40","047","050","Garfield County",62846,61044,60406,-1802,-2.86732648060338,2.86732648060338,-2440,-3.88250644432422,3.88250644432422
"40","049","050","Garvin County",25656,27697,27663,2041,7.95525413158715,7.95525413158715,2007,7.82273152478952,7.82273152478952
"40","051","050","Grady County",54795,55911,54443,1116,2.03668217903093,2.03668217903093,-352,-0.642394379049183,0.642394379049183
"40","053","050","Grant County",4169,4361,4490,192,4.60542096426001,4.60542096426001,321,7.69968817462221,7.69968817462221
"40","055","050","Greer County",5491,5721,6134,230,4.18867237297396,4.18867237297396,643,11.7100710253142,11.7100710253142
"40","057","050","Harmon County",2488,2580,2884,92,3.69774919614148,3.69774919614148,396,15.9163987138264,15.9163987138264
"40","059","050","Harper County",3272,3636,3628,364,11.1246943765281,11.1246943765281,356,10.880195599022,10.880195599022
"40","061","050","Haskell County",11561,12668,13162,1107,9.57529625464925,9.57529625464925,1601,13.8482830205,13.8482830205
"40","063","050","Hughes County",13367,13154,14194,-213,-1.59347647190843,1.59347647190843,827,6.1868781327149,6.1868781327149
"40","065","050","Jackson County",24785,24363,26564,-422,-1.70264272745612,1.70264272745612,1779,7.17772846479726,7.17772846479726
"40","067","050","Jefferson County",5337,5968,6506,631,11.8231216038973,11.8231216038973,1169,21.9036912122915,21.9036912122915
"40","069","050","Johnston County",10272,10890,11184,618,6.01635514018692,6.01635514018692,912,8.8785046728972,8.8785046728972
"40","071","050","Kay County",43700,43410,45921,-290,-0.663615560640732,0.663615560640732,2221,5.08237986270023,5.08237986270023
"40","073","050","Kingfisher County",15184,15832,15496,648,4.26765015806112,4.26765015806112,312,2.05479452054794,2.05479452054794
"40","075","050","Kiowa County",8509,8757,9270,248,2.9145610530027,2.9145610530027,761,8.94347161828652,8.94347161828652
"40","077","050","Latimer County",9444,10113,11331,669,7.08386277001271,7.08386277001271,1887,19.9809402795426,19.9809402795426
"40","079","050","Le Flore County",48129,49925,52325,1796,3.73163788983773,3.73163788983773,4196,8.71823640632467,8.71823640632467
"40","081","050","Lincoln County",33458,35027,34849,1569,4.68946141431048,4.68946141431048,1391,4.15745113276346,4.15745113276346
"40","083","050","Logan County",49555,48638,42877,-917,-1.8504691756634,1.8504691756634,-6678,-13.475935828877,13.475935828877
"40","085","050","Love County",10146,10200,9553,54,0.532229450029568,0.532229450029568,-593,-5.84466784939878,5.84466784939878
"40","087","050","McClain County",41662,41159,40990,-503,-1.20733522154481,1.20733522154481,-672,-1.61298065383323,1.61298065383323
"40","089","050","McCurtain County",30814,32773,33703,1959,6.35749983773609,6.35749983773609,2889,9.37560848964756,9.37560848964756
"40","091","050","McIntosh County",18941,19620,21151,679,3.58481600760256,3.58481600760256,2210,11.6678105696637,11.6678105696637
"40","093","050","Major County",7782,7582,7585,-200,-2.57003341043434,2.57003341043434,-197,-2.53148290927782,2.53148290927782
"40","095","050","Marshall County",15312,17070,16492,1758,11.4811912225705,11.4811912225705,1180,7.70637408568443,7.70637408568443
"40","097","050","Mayes County",39046,41162,42053,2116,5.41924909081596,5.41924909081596,3007,7.70117297546484,7.70117297546484
"40","099","050","Murray County",13904,13982,13808,78,0.560989643268124,0.560989643268124,-96,-0.690448791714614,0.690448791714614
"40","101","050","Muskogee County",66339,67760,71064,1421,2.14202806795399,2.14202806795399,4725,7.12250712250712,7.12250712250712
"40","103","050","Noble County",10924,11110,11562,186,1.70267301354815,1.70267301354815,638,5.84035151958989,5.84035151958989
"40","105","050","Nowata County",9320,10057,10682,737,7.90772532188841,7.90772532188841,1362,14.6137339055794,14.6137339055794
"40","107","050","Okfuskee County",11310,11812,12323,502,4.43854995579134,4.43854995579134,1013,8.95667550839965,8.95667550839965
"40","109","050","Oklahoma County",796292,802847,778167,6555,0.82319048791147,0.82319048791147,-18125,-2.2761750714562,2.2761750714562
"40","111","050","Okmulgee County",36706,38291,40030,1585,4.31809513431047,4.31809513431047,3324,9.05574020596088,9.05574020596088
"40","113","050","Osage County",45818,46713,49635,895,1.953380767384,1.953380767384,3817,8.33078702693265,8.33078702693265
"40","115","050","Ottawa County",30285,30955,31941,670,2.21231632821529,2.21231632821529,1656,5.46805349182764,5.46805349182764
"40","117","050","Pawnee County",15553,16377,16847,824,5.29801324503311,5.29801324503311,1294,8.31993827557385,8.31993827557385
"40","119","050","Payne County",81646,81769,84073,123,0.150650368664723,0.150650368664723,2427,2.97258898170149,2.97258898170149
"40","121","050","Pittsburg County",43773,43676,46893,-97,-0.221597788591141,0.221597788591141,3120,7.12768144746762,7.12768144746762
"40","123","050","Pontotoc County",38065,38381,38247,316,0.830158938657559,0.830158938657559,182,0.478129515302772,0.478129515302772
"40","125","050","Pottawatomie County",72454,72955,71511,501,0.691473210588787,0.691473210588787,-943,-1.30151544428189,1.30151544428189
"40","127","050","Pushmataha County",10812,10953,11787,141,1.30410654827969,1.30410654827969,975,9.01775804661487,9.01775804661487
"40","129","050","Roger Mills County",3442,3557,3651,115,3.34108076699593,3.34108076699593,209,6.07205113306217,6.07205113306217
"40","131","050","Rogers County",95240,93049,97729,-2191,-2.3005039899202,2.3005039899202,2489,2.61339773204536,2.61339773204536
"40","133","050","Seminole County",23556,24258,25684,702,2.98013245033113,2.98013245033113,2128,9.03379181524877,9.03379181524877
"40","135","050","Sequoyah County",39281,41558,44488,2277,5.79669560347242,5.79669560347242,5207,13.2557725108831,13.2557725108831
"40","137","050","Stephens County",42848,43141,45066,293,0.683812546676624,0.683812546676624,2218,5.17643764002987,5.17643764002987
"40","139","050","Texas County",21384,20026,20803,-1358,-6.35054246165357,6.35054246165357,-581,-2.71698466142911,2.71698466142911
"40","141","050","Tillman County",6968,7237,7803,269,3.86050516647532,3.86050516647532,835,11.9833524684271,11.9833524684271
"40","143","050","Tulsa County",669279,656547,645949,-12732,-1.90234565853702,1.90234565853702,-23330,-3.4858407330874,3.4858407330874
"40","145","050","Wagoner County",80981,82568,82803,1587,1.95971894641953,1.95971894641953,1822,2.24991047282696,2.24991047282696
"40","147","050","Washington County",52455,52094,51738,-361,-0.688208940997045,0.688208940997045,-717,-1.36688590220189,1.36688590220189
"40","149","050","Washita County",10924,10846,11454,-78,-0.714024166971805,0.714024166971805,530,4.85170267301355,4.85170267301355
"40","151","050","Woods County",8624,8698,8729,74,0.858070500927644,0.858070500927644,105,1.21753246753247,1.21753246753247
"40","153","050","Woodward County",20470,19869,20632,-601,-2.93600390815828,2.93600390815828,162,0.791402051783097,0.791402051783097
"41","001","050","Baker County",16668,16261,16683,-407,-2.44180465562755,2.44180465562755,15,0.0899928005759539,0.0899928005759539
"41","003","050","Benton County",95184,93292,93398,-1892,-1.98772903008909,1.98772903008909,-1786,-1.87636577576063,1.87636577576063
"41","005","050","Clackamas County",421401,420976,412071,-425,-0.10085405587552,0.10085405587552,-9330,-2.21404315604377,2.21404315604377
"41","007","050","Clatsop County",41072,40419,39376,-653,-1.58989092325672,1.58989092325672,-1696,-4.1293338527464,4.1293338527464
"41","009","050","Columbia County",52589,52864,51819,275,0.522923044743197,0.522923044743197,-770,-1.46418452528095,1.46418452528095
"41","011","050","Coos County",64929,64768,65025,-161,-0.247963159759122,0.247963159759122,96,0.147853809545812,0.147853809545812
"41","013","050","Crook County",24738,24939,23645,201,0.812515158864904,0.812515158864904,-1093,-4.41830382407632,4.41830382407632
"41","015","050","Curry County",23446,23252,23291,-194,-0.82743325087435,0.82743325087435,-155,-0.661093576729506,0.661093576729506
"41","017","050","Deschutes County",198253,200798,185714,2545,1.28371323510867,1.28371323510867,-12539,-6.32474666209339,6.32474666209339
"41","019","050","Douglas County",111201,111322,112855,121,0.108811971115368,0.108811971115368,1654,1.48739669607288,1.48739669607288
"41","021","050","Gilliam County",1995,1956,1934,-39,-1.95488721804511,1.95488721804511,-61,-3.05764411027569,3.05764411027569
"41","023","050","Grant County",7233,7186,7703,-47,-0.649799529932255,0.649799529932255,470,6.49799529932255,6.49799529932255
"41","025","050","Harney County",7495,7388,7614,-107,-1.42761841227485,1.42761841227485,119,1.58772515010007,1.58772515010007
"41","027","050","Hood River County",23977,23322,24677,-655,-2.73178462693415,2.73178462693415,700,2.91946448679985,2.91946448679985
"41","029","050","Jackson County",223259,221706,218975,-1553,-0.695604656475215,0.695604656475215,-4284,-1.91884761644547,1.91884761644547
"41","031","050","Jefferson County",24502,24841,23042,339,1.38356052567137,1.38356052567137,-1460,-5.95869724920415,5.95869724920415
"41","033","050","Josephine County",88090,88020,86697,-70,-0.0794641843569077,0.0794641843569077,-1393,-1.58133726870246,1.58133726870246
"41","035","050","Klamath County",69413,68688,68840,-725,-1.04447293734603,1.04447293734603,-573,-0.825493783585207,0.825493783585207
"41","037","050","Lake County",8160,7955,8105,-205,-2.51225490196078,2.51225490196078,-55,-0.674019607843137,0.674019607843137
"41","039","050","Lane County",382971,382958,373284,-13,-0.0033945129004546,0.0033945129004546,-9687,-2.5294343435926,2.5294343435926
"41","041","050","Lincoln County",50395,50506,48450,111,0.220259946423256,0.220259946423256,-1945,-3.85950987201111,3.85950987201111
"41","043","050","Linn County",128610,130731,124077,2121,1.64917191509214,1.64917191509214,-4533,-3.5246092838815,3.5246092838815
"41","045","050","Malheur County",31571,30921,32103,-650,-2.05885147762187,2.05885147762187,532,1.68509074783821,1.68509074783821
"41","047","050","Marion County",345920,348993,338249,3073,0.888355689176688,0.888355689176688,-7671,-2.21756475485661,2.21756475485661
"41","049","050","Morrow County",12186,11661,12138,-525,-4.30822255046775,4.30822255046775,-48,-0.393894633185623,0.393894633185623
"41","051","050","Multnomah County",815428,815194,824596,-234,-0.0286965863325763,0.0286965863325763,9168,1.12431753631222,1.12431753631222
"41","053","050","Polk County",87433,87279,83107,-154,-0.176134868985395,0.176134868985395,-4326,-4.9477885924079,4.9477885924079
"41","055","050","Sherman County",1870,1805,1826,-65,-3.47593582887701,3.47593582887701,-44,-2.35294117647059,2.35294117647059
"41","057","050","Tillamook County",27390,27348,26678,-42,-0.153340635268346,0.153340635268346,-712,-2.59948886454911,2.59948886454911
"41","059","050","Umatilla County",80075,77782,79723,-2293,-2.86356540743053,2.86356540743053,-352,-0.439587886356541,0.439587886356541
"41","061","050","Union County",26196,26580,26810,384,1.46587265231333,1.46587265231333,614,2.34386929302184,2.34386929302184
"41","063","050","Wallowa County",7391,7177,7347,-214,-2.89541334054932,2.89541334054932,-44,-0.595318630767149,0.595318630767149
"41","065","050","Wasco County",26670,26446,25881,-224,-0.83989501312336,0.83989501312336,-789,-2.95838020247469,2.95838020247469
"41","067","050","Washington County",600372,603195,590087,2823,0.470208470748136,0.470208470748136,-10285,-1.71310454185072,1.71310454185072
"41","069","050","Wheeler County",1451,1383,1493,-68,-4.68642315644383,4.68642315644383,42,2.89455547898001,2.89455547898001
"41","071","050","Yamhill County",107722,107496,107773,-226,-0.209799298193498,0.209799298193498,51,0.0473440894153469,0.0473440894153469
"42","001","050","Adams County",103852,102835,106611,-1017,-0.979278203597427,0.979278203597427,2759,2.65666525440049,2.65666525440049
"42","003","050","Allegheny County",1250578,1213154,1257135,-37424,-2.99253625123743,2.99253625123743,6557,0.524317555562308,0.524317555562308
"42","005","050","Armstrong County",65558,64348,69657,-1210,-1.8456938893804,1.8456938893804,4099,6.25247872113243,6.25247872113243
"42","007","050","Beaver County",168215,163041,174158,-5174,-3.07582558035847,3.07582558035847,5943,3.53297862854086,3.53297862854086
"42","009","050","Bedford County",47577,47880,50913,303,0.636862349454568,0.636862349454568,3336,7.01179141181663,7.01179141181663
"42","011","050","Berks County",428849,421131,420194,-7718,-1.79970106027996,1.79970106027996,-8655,-2.0181928837423,2.0181928837423
"42","013","050","Blair County",122822,121310,128980,-1512,-1.23104981192295,1.23104981192295,6158,5.01375974988194,5.01375974988194
"42","015","050","Bradford County",59967,60331,64371,364,0.60700051695099,0.60700051695099,4404,7.34403922157186,7.34403922157186
"42","017","050","Bucks County",646538,628474,642552,-18064,-2.79395797308124,2.79395797308124,-3986,-0.616514419879419,0.616514419879419
"42","019","050","Butler County",193763,189029,200975,-4734,-2.44319090848098,2.44319090848098,7212,3.72207284156418,3.72207284156418
"42","021","050","Cambria County",133472,129107,144592,-4365,-3.2703488372093,3.2703488372093,11120,8.33133541117238,8.33133541117238
"42","023","050","Cameron County",4547,4361,5047,-186,-4.09060919287442,4.09060919287442,500,10.9962612711678,10.9962612711678
"42","025","050","Carbon County",64749,64132,66422,-617,-0.952910469659763,0.952910469659763,1673,2.58382368839673,2.58382368839673
"42","027","050","Centre County",158172,161754,164679,3582,2.26462332144754,2.26462332144754,6507,4.11387603368485,4.11387603368485
"42","029","050","Chester County",534413,526641,530124,-7772,-1.4543059394139,1.4543059394139,-4289,-0.802562811907644,0.802562811907644
"42","031","050","Clarion County",37241,38375,41240,1134,3.04503101420477,3.04503101420477,3999,10.7381649257539,10.7381649257539
"42","033","050","Clearfield County",80562,78789,83293,-1773,-2.20078945408505,2.20078945408505,2731,3.38993570169559,3.38993570169559
"42","035","050","Clinton County",37450,38062,39713,612,1.63417890520694,1.63417890520694,2263,6.04272363150868,6.04272363150868
"42","037","050","Columbia County",64727,64929,69559,202,0.312079966629073,0.312079966629073,4832,7.4651999938202,7.4651999938202
"42","039","050","Crawford County",83938,83935,89439,-3,-0.0035740665729467,0.0035740665729467,5501,6.55364673925993,6.55364673925993
"42","041","050","Cumberland County",259469,255297,256286,-4172,-1.60789920953948,1.60789920953948,-3183,-1.22673614188978,1.22673614188978
"42","043","050","Dauphin County",286401,279717,280300,-6684,-2.3337907339709,2.3337907339709,-6101,-2.13022999221371,2.13022999221371
"42","045","050","Delaware County",576830,567039,564421,-9791,-1.6973805107224,1.6973805107224,-12409,-2.15124040011789,2.15124040011789
"42","047","050","Elk County",30990,29702,32415,-1288,-4.15617941271378,4.15617941271378,1425,4.59825750242014,4.59825750242014
"42","049","050","Erie County",270876,268831,287154,-2045,-0.754957988156943,0.754957988156943,16278,6.00939175120719,6.00939175120719
"42","051","050","Fayette County",128804,128505,139657,-299,-0.232135647961243,0.232135647961243,10853,8.42598055960995,8.42598055960995
"42","053","050","Forest County",6973,6987,7679,14,0.20077441560304,0.20077441560304,706,10.1247669582676,10.1247669582676
"42","055","050","Franklin County",155932,155680,157113,-252,-0.1616089064464,0.1616089064464,1181,0.757381422671421,0.757381422671421
"42","057","050","Fulton County",14556,14513,15221,-43,-0.295410827150316,0.295410827150316,665,4.56856279197582,4.56856279197582
"42","059","050","Greene County",35954,35748,39562,-206,-0.572954330533459,0.572954330533459,3608,10.0350447794404,10.0350447794404
"42","061","050","Huntingdon County",44092,44709,46976,617,1.39934682028486,1.39934682028486,2884,6.54086909189876,6.54086909189876
"42","063","050","Indiana County",83246,83801,90782,555,0.666698700237849,0.666698700237849,7536,9.05268721620258,9.05268721620258
"42","065","050","Jefferson County",44492,43177,45842,-1315,-2.95558752135215,2.95558752135215,1350,3.03425334891666,3.03425334891666
"42","067","050","Juniata County",23509,24666,25395,1157,4.9215194180952,4.9215194180952,1886,8.02245948360203,8.02245948360203
"42","069","050","Lackawanna County",215896,209301,223562,-6595,-3.05471152777263,3.05471152777263,7666,3.55078371067551,3.55078371067551
"42","071","050","Lancaster County",552984,546297,548595,-6687,-1.20925741070266,1.20925741070266,-4389,-0.793693850093312,0.793693850093312
"42","073","050","Lawrence County",86070,85233,92086,-837,-0.972464273265946,0.972464273265946,6016,6.98965957941211,6.98965957941211
"42","075","050","Lebanon County",143257,141645,140545,-1612,-1.12525042406305,1.12525042406305,-2712,-1.89310120971401,1.89310120971401
"42","077","050","Lehigh County",374557,370652,361285,-3905,-1.04256495006101,1.04256495006101,-13272,-3.54338591990004,3.54338591990004
"42","079","050","Luzerne County",325594,317231,325072,-8363,-2.56853627523849,2.56853627523849,-522,-0.160322364662739,0.160322364662739
"42","081","050","Lycoming County",114188,113342,118711,-846,-0.740883455354328,0.740883455354328,4523,3.96101166497355,3.96101166497355
"42","083","050","McKean County",40432,40411,43627,-21,-0.0519390581717452,0.0519390581717452,3195,7.90215670755837,7.90215670755837
"42","085","050","Mercer County",110652,108770,118330,-1882,-1.70082782055453,1.70082782055453,7678,6.93887141669378,6.93887141669378
"42","087","050","Mifflin County",46143,46089,47657,-54,-0.117027501462844,0.117027501462844,1514,3.28110439286566,3.28110439286566
"42","089","050","Monroe County",168327,170227,173170,1900,1.1287553393098,1.1287553393098,4843,2.87713795172492,2.87713795172492
"42","091","050","Montgomery County",856553,833505,833731,-23048,-2.69078504190634,2.69078504190634,-22822,-2.66440021808341,2.66440021808341
"42","093","050","Montour County",18136,18096,19015,-40,-0.220555800617556,0.220555800617556,879,4.8467137185708,4.8467137185708
"42","095","050","Northampton County",312951,305965,307452,-6986,-2.23229834702557,2.23229834702557,-5499,-1.75714408964982,1.75714408964982
"42","097","050","Northumberland County",91647,90393,95622,-1254,-1.36829356116403,1.36829356116403,3975,4.33729418311565,4.33729418311565
"42","099","050","Perry County",45842,46259,47460,417,0.909646175995812,0.909646175995812,1618,3.52951441909166,3.52951441909166
"42","101","050","Philadelphia County",1603797,1581124,1582031,-22673,-1.41370759516323,1.41370759516323,-21766,-1.35715430319423,1.35715430319423
"42","103","050","Pike County",58535,56036,58613,-2499,-4.26924062526694,4.26924062526694,78,0.133253608951909,0.133253608951909
"42","105","050","Potter County",16396,16486,17544,90,0.54891436935838,0.54891436935838,1148,7.00170773359356,7.00170773359356
"42","107","050","Schuylkill County",143049,140865,149834,-2184,-1.52674957532034,1.52674957532034,6785,4.74312997644164,4.74312997644164
"42","109","050","Snyder County",39736,40339,41012,603,1.51751560297967,1.51751560297967,1276,3.2111938796054,3.2111938796054
"42","111","050","Somerset County",74129,73070,78785,-1059,-1.42859069999595,1.42859069999595,4656,6.28094268100204,6.28094268100204
"42","113","050","Sullivan County",5840,5927,6516,87,1.48972602739726,1.48972602739726,676,11.5753424657534,11.5753424657534
"42","115","050","Susquehanna County",38434,40072,44217,1638,4.26185148566374,4.26185148566374,5783,15.0465733465161,15.0465733465161
"42","117","050","Tioga County",41045,40464,42978,-581,-1.41551955171154,1.41551955171154,1933,4.70946522109879,4.70946522109879
"42","119","050","Union County",42681,44363,46367,1682,3.94086361612896,3.94086361612896,3686,8.63616128956679,8.63616128956679
"42","121","050","Venango County",50454,50470,55372,16,0.0317120545447338,0.0317120545447338,4918,9.74749276568756,9.74749276568756
"42","123","050","Warren County",38587,38982,41917,395,1.02366081841035,1.02366081841035,3330,8.62984943115557,8.62984943115557
"42","125","050","Washington County",209349,206894,216460,-2455,-1.17268293614968,1.17268293614968,7111,3.39672030914884,3.39672030914884
"42","127","050","Wayne County",51155,51197,54293,42,0.0821034112012511,0.0821034112012511,3138,6.13429772260776,6.13429772260776
"42","129","050","Westmoreland County",354663,347721,371610,-6942,-1.95735106283994,1.95735106283994,16947,4.77833887380415,4.77833887380415
"42","131","050","Wyoming County",26069,26614,28874,545,2.09060570025701,2.09060570025701,2805,10.7599064022402,10.7599064022402
"42","133","050","York County",456438,450374,454233,-6064,-1.32854845565006,1.32854845565006,-2205,-0.483088612254019,0.483088612254019
"44","001","050","Bristol County",50793,48435,50852,-2358,-4.642371980391,4.642371980391,59,0.116157738271022,0.116157738271022
"44","003","050","Kent County",170363,164657,168517,-5706,-3.34931880748754,3.34931880748754,-1846,-1.08356861525096,1.08356861525096
"44","005","050","Newport County",85643,82046,85281,-3597,-4.19999299417349,4.19999299417349,-362,-0.422684866247096,0.422684866247096
"44","007","050","Providence County",660741,637043,632151,-23698,-3.5865793101987,3.5865793101987,-28590,-4.32696018560979,4.32696018560979
"44","009","050","Washington County",129839,125823,132821,-4016,-3.09306140681921,3.09306140681921,2982,2.29669051671686,2.29669051671686
"45","001","050","Abbeville County",24295,24475,25833,180,0.740893187898745,0.740893187898745,1538,6.33052068326816,6.33052068326816
"45","003","050","Aiken County",168808,172652,175516,3844,2.27714326335245,2.27714326335245,6708,3.97374532012701,3.97374532012701
"45","005","050","Allendale County",8039,8426,10479,387,4.81403159596965,4.81403159596965,2440,30.3520338350541,30.3520338350541
"45","007","050","Anderson County",203718,204004,200166,286,0.140390147164217,0.140390147164217,-3552,-1.74358672282273,1.74358672282273
"45","009","050","Bamberg County",13311,13973,15983,662,4.9733303282999,4.9733303282999,2672,20.0736233190594,20.0736233190594
"45","011","050","Barnwell County",20589,20858,22908,269,1.30652290057798,1.30652290057798,2319,11.2632959347224,11.2632959347224
"45","013","050","Beaufort County",187117,195068,182098,7951,4.24921305920894,4.24921305920894,-5019,-2.6822790019079,2.6822790019079
"45","015","050","Berkeley County",229861,234392,218525,4531,1.97119128516799,1.97119128516799,-11336,-4.93167609990385,4.93167609990385
"45","017","050","Calhoun County",14119,14572,15624,453,3.20844252425809,3.20844252425809,1505,10.659395141299,10.659395141299
"45","019","050","Charleston County",408235,416901,406913,8666,2.12279691844158,2.12279691844158,-1322,-0.323833086335077,0.323833086335077
"45","021","050","Cherokee County",56216,57367,57645,1151,2.0474597979223,2.0474597979223,1429,2.54198093069589,2.54198093069589
"45","023","050","Chester County",32294,32274,33436,-20,-0.0619310088561343,0.0619310088561343,1142,3.53626060568527,3.53626060568527
"45","025","050","Chesterfield County",43273,45686,47757,2413,5.5762253599242,5.5762253599242,4484,10.3621195664733,10.3621195664733
"45","027","050","Clarendon County",31144,33564,36114,2420,7.77035705111739,7.77035705111739,4970,15.9581299768816,15.9581299768816
"45","029","050","Colleton County",38604,37557,39755,-1047,-2.71215418091389,2.71215418091389,1151,2.98155631540773,2.98155631540773
"45","031","050","Darlington County",62905,66587,70507,3682,5.85327080518242,5.85327080518242,7602,12.0848899133614,12.0848899133614
"45","033","050","Dillon County",28292,30393,32369,2101,7.42612752721617,7.42612752721617,4077,14.4104340449597,14.4104340449597
"45","035","050","Dorchester County",161540,165277,156018,3737,2.31335892039123,2.31335892039123,-5522,-3.41834839668194,3.41834839668194
"45","037","050","Edgefield County",25657,27188,28826,1531,5.96718244533656,5.96718244533656,3169,12.3514050746385,12.3514050746385
"45","039","050","Fairfield County",20948,22142,24717,1194,5.69982814588505,5.69982814588505,3769,17.9921710903189,17.9921710903189
"45","041","050","Florence County",137059,137820,145992,761,0.555235336606863,0.555235336606863,8933,6.51763109317885,6.51763109317885
"45","043","050","Georgetown County",63404,63317,65100,-87,-0.137215317645574,0.137215317645574,1696,2.67491010030913,2.67491010030913
"45","045","050","Greenville County",525534,530807,510741,5273,1.00336039152557,1.00336039152557,-14793,-2.81485117994269,2.81485117994269
"45","047","050","Greenwood County",69351,71085,71090,1734,2.50032443656184,2.50032443656184,1739,2.50753413793601,2.50753413793601
"45","049","050","Hampton County",18561,18369,21300,-192,-1.03442702440601,1.03442702440601,2739,14.756748020042,14.756748020042
"45","051","050","Horry County",351029,362898,315894,11869,3.38120212290153,3.38120212290153,-35135,-10.0091445436132,10.0091445436132
"45","053","050","Jasper County",28791,31281,31200,2490,8.64853600083359,8.64853600083359,2409,8.36719808273419,8.36719808273419
"45","055","050","Kershaw County",65403,67330,67161,1927,2.94634802684892,2.94634802684892,1758,2.68795009403238,2.68795009403238
"45","057","050","Lancaster County",96016,100306,94932,4290,4.46800533244459,4.46800533244459,-1084,-1.12897850358274,1.12897850358274
"45","059","050","Laurens County",67539,67816,69120,277,0.410133404403382,0.410133404403382,1581,2.3408697197175,2.3408697197175
"45","061","050","Lee County",16531,16754,19312,223,1.34898070292178,1.34898070292178,2781,16.8229387211905,16.8229387211905
"45","063","050","Lexington County",293991,302953,298553,8962,3.04839263786987,3.04839263786987,4562,1.5517481827675,1.5517481827675
"45","065","050","McCormick County",9526,9436,10860,-90,-0.944782699979005,0.944782699979005,1334,14.0037791307999,14.0037791307999
"45","067","050","Marion County",29183,30274,33546,1091,3.73847788095809,3.73847788095809,4363,14.9504848713292,14.9504848713292
"45","069","050","Marlboro County",26667,25723,28940,-944,-3.53995575055312,3.53995575055312,2273,8.52364345445682,8.52364345445682
"45","071","050","Newberry County",37719,38442,38747,723,1.91680585381373,1.91680585381373,1028,2.72541689864524,2.72541689864524
"45","073","050","Oconee County",78607,79902,79587,1295,1.64743597898406,1.64743597898406,980,1.24670830842037,1.24670830842037
"45","075","050","Orangeburg County",84223,85609,93557,1386,1.64563124087245,1.64563124087245,9334,11.0824834071453,11.0824834071453
"45","077","050","Pickens County",131404,127756,130478,-3648,-2.77617119722383,2.77617119722383,-926,-0.704696965084777,0.704696965084777
"45","079","050","Richland County",416147,418767,424317,2620,0.629585218684744,0.629585218684744,8170,1.96324856360853,1.96324856360853
"45","081","050","Saluda County",18862,20320,20417,1458,7.72982716573004,7.72982716573004,1555,8.24408864383416,8.24408864383416
"45","083","050","Spartanburg County",327997,324825,315413,-3172,-0.967082015994049,0.967082015994049,-12584,-3.83662045689442,3.83662045689442
"45","085","050","Sumter County",105556,106470,114155,914,0.86589109098488,0.86589109098488,8599,8.14638675205578,8.14638675205578
"45","087","050","Union County",27244,27039,28888,-205,-0.752459257084129,0.752459257084129,1644,6.03435618851857,6.03435618851857
"45","089","050","Williamsburg County",31026,29936,35140,-1090,-3.5131824921034,3.5131824921034,4114,13.2598465802875,13.2598465802875
"45","091","050","York County",282090,287273,274972,5183,1.83735687192031,1.83735687192031,-7118,-2.52330816406112,2.52330816406112
"46","003","050","Aurora County",2747,2743,2843,-4,-0.145613396432472,0.145613396432472,96,3.49472151437932,3.49472151437932
"46","005","050","Beadle County",19149,18553,17965,-596,-3.11243406966421,3.11243406966421,-1184,-6.18309050080944,6.18309050080944
"46","007","050","Bennett County",3381,3414,3439,33,0.976042590949423,0.976042590949423,58,1.71546879621414,1.71546879621414
"46","009","050","Bon Homme County",7003,6875,7241,-128,-1.82778809081822,1.82778809081822,238,3.39854348136513,3.39854348136513
"46","011","050","Brookings County",34375,35614,36837,1239,3.60436363636364,3.60436363636364,2462,7.16218181818182,7.16218181818182
"46","013","050","Brown County",38301,38820,39840,519,1.35505600375969,1.35505600375969,1539,4.01817184929897,4.01817184929897
"46","015","050","Brule County",5247,5269,5616,22,0.419287211740042,0.419287211740042,369,7.03259005145798,7.03259005145798
"46","017","050","Buffalo County",1948,1969,1932,21,1.07802874743326,1.07802874743326,-16,-0.82135523613963,0.82135523613963
"46","019","050","Butte County",10243,10535,10786,292,2.85072732597872,2.85072732597872,543,5.30118129454261,5.30118129454261
"46","021","050","Campbell County",1377,1386,1470,9,0.65359477124183,0.65359477124183,93,6.75381263616558,6.75381263616558
"46","023","050","Charles Mix County",9373,9287,9325,-86,-0.917529072868879,0.917529072868879,-48,-0.512109249973328,0.512109249973328
"46","025","050","Clark County",3837,3791,3991,-46,-1.19885327078447,1.19885327078447,154,4.01355225436539,4.01355225436539
"46","027","050","Clay County",14967,14239,15528,-728,-4.86403420859224,4.86403420859224,561,3.74824614151133,3.74824614151133
"46","029","050","Codington County",28325,28198,29432,-127,-0.448367166813769,0.448367166813769,1107,3.90820829655781,3.90820829655781
"46","031","050","Corson County",3902,4057,4056,155,3.9723218862122,3.9723218862122,154,3.94669400307535,3.94669400307535
"46","033","050","Custer County",8318,9020,9671,702,8.43952873286848,8.43952873286848,1353,16.2659293099303,16.2659293099303
"46","035","050","Davison County",19956,19862,21231,-94,-0.471036279815594,0.471036279815594,1275,6.38905592303067,6.38905592303067
"46","037","050","Day County",5449,5386,6054,-63,-1.15617544503579,1.15617544503579,605,11.1029546705818,11.1029546705818
"46","039","050","Deuel County",4295,4351,4372,56,1.30384167636787,1.30384167636787,77,1.79278230500582,1.79278230500582
"46","041","050","Dewey County",5239,5824,5380,585,11.166253101737,11.166253101737,141,2.69135331170071,2.69135331170071
"46","043","050","Douglas County",2835,2905,3101,70,2.46913580246914,2.46913580246914,266,9.38271604938272,9.38271604938272
"46","045","050","Edmunds County",3986,3830,4355,-156,-3.9136979427998,3.9136979427998,369,9.25740090316106,9.25740090316106
"46","047","050","Fall River County",6973,6718,7175,-255,-3.65696256991252,3.65696256991252,202,2.89688799655815,2.89688799655815
"46","049","050","Faulk County",2125,2307,2510,182,8.56470588235294,8.56470588235294,385,18.1176470588235,18.1176470588235
"46","051","050","Grant County",7556,7020,7594,-536,-7.09370037056644,7.09370037056644,38,0.50291159343568,0.50291159343568
"46","053","050","Gregory County",3994,4210,4351,216,5.40811216825238,5.40811216825238,357,8.93840761141713,8.93840761141713
"46","055","050","Haakon County",1872,1870,1981,-2,-0.106837606837607,0.106837606837607,109,5.82264957264957,5.82264957264957
"46","057","050","Hamlin County",6164,6229,6461,65,1.05451005840363,1.05451005840363,297,4.81829980532122,4.81829980532122
"46","059","050","Hand County",3145,3135,3509,-10,-0.317965023847377,0.317965023847377,364,11.5739268680445,11.5739268680445
"46","061","050","Hanson County",3461,3486,3468,25,0.722334585379948,0.722334585379948,7,0.202253683906385,0.202253683906385
"46","063","050","Harding County",1311,1316,1305,5,0.3813882532418,0.3813882532418,-6,-0.45766590389016,0.45766590389016
"46","065","050","Hughes County",17765,17384,18056,-381,-2.1446664790318,2.1446664790318,291,1.63805235012665,1.63805235012665
"46","067","050","Hutchinson County",7427,7297,7493,-130,-1.75037027063417,1.75037027063417,66,0.888649522014272,0.888649522014272
"46","069","050","Hyde County",1262,1286,1410,24,1.90174326465927,1.90174326465927,148,11.7274167987322,11.7274167987322
"46","071","050","Jackson County",2806,3330,3078,524,18.6742694226657,18.6742694226657,272,9.69351389878831,9.69351389878831
"46","073","050","Jerauld County",1663,1991,2094,328,19.7233914612147,19.7233914612147,431,25.9170174383644,25.9170174383644
"46","075","050","Jones County",917,936,1127,19,2.07197382769902,2.07197382769902,210,22.9007633587786,22.9007633587786
"46","077","050","Kingsbury County",5187,4976,5378,-211,-4.0678619625988,4.0678619625988,191,3.68228262965105,3.68228262965105
"46","079","050","Lake County",11059,12545,11845,1486,13.4370196220273,13.4370196220273,786,7.10733339361606,7.10733339361606
"46","081","050","Lawrence County",25768,26159,27470,391,1.51738590499845,1.51738590499845,1702,6.60509158646383,6.60509158646383
"46","083","050","Lincoln County",65161,62594,54873,-2567,-3.93947299765197,3.93947299765197,-10288,-15.7885851966667,15.7885851966667
"46","085","050","Lyman County",3718,3796,3861,78,2.0979020979021,2.0979020979021,143,3.84615384615385,3.84615384615385
"46","087","050","McCook County",5682,5533,5909,-149,-2.62231608588525,2.62231608588525,227,3.99507215769095,3.99507215769095
"46","089","050","McPherson County",2411,2365,2502,-46,-1.90792202405641,1.90792202405641,91,3.77436748237246,3.77436748237246
"46","091","050","Marshall County",4306,4883,4895,577,13.3999071063632,13.3999071063632,589,13.6785880167209,13.6785880167209
"46","093","050","Meade County",29852,28536,28965,-1316,-4.40841484657644,4.40841484657644,-887,-2.97132520434142,2.97132520434142
"46","095","050","Mellette County",1918,2083,2106,165,8.60271115745568,8.60271115745568,188,9.80187695516163,9.80187695516163
"46","097","050","Miner County",2298,2200,2475,-98,-4.26457789382071,4.26457789382071,177,7.7023498694517,7.7023498694517
"46","099","050","Minnehaha County",197214,196078,205565,-1136,-0.576024014522296,0.576024014522296,8351,4.23448639548916,4.23448639548916
"46","101","050","Moody County",6336,6534,6734,198,3.125,3.125,398,6.28156565656566,6.28156565656566
"46","102","050","Oglala Lakota County",13672,14070,13832,398,2.91105909888824,2.91105909888824,160,1.17027501462844,1.17027501462844
"46","103","050","Pennington County",109222,115569,112626,6347,5.81110032777279,5.81110032777279,3404,3.11658823313984,3.11658823313984
"46","105","050","Perkins County",2835,2835,2986,0,0,0,151,5.32627865961199,5.32627865961199
"46","107","050","Potter County",2472,2158,2381,-314,-12.7022653721683,12.7022653721683,-91,-3.68122977346278,3.68122977346278
"46","109","050","Roberts County",10280,10334,10586,54,0.525291828793774,0.525291828793774,306,2.97665369649805,2.97665369649805
"46","111","050","Sanborn County",2330,2319,2447,-11,-0.472103004291845,0.472103004291845,117,5.02145922746781,5.02145922746781
"46","115","050","Spink County",6361,6333,6685,-28,-0.440182361263952,0.440182361263952,324,5.09353875176859,5.09353875176859
"46","117","050","Stanley County",2980,3105,3338,125,4.19463087248322,4.19463087248322,358,12.0134228187919,12.0134228187919
"46","119","050","Sully County",1446,1393,1490,-53,-3.66528354080221,3.66528354080221,44,3.04287690179806,3.04287690179806
"46","121","050","Todd County",9319,10284,9757,965,10.3551883249276,10.3551883249276,438,4.70007511535572,4.70007511535572
"46","123","050","Tripp County",5624,5369,5713,-255,-4.53413940256046,4.53413940256046,89,1.58250355618777,1.58250355618777
"46","125","050","Turner County",8673,8339,8675,-334,-3.85103193819901,3.85103193819901,2,0.0230600714862216,0.0230600714862216
"46","127","050","Union County",16811,16113,17237,-698,-4.15204330497888,4.15204330497888,426,2.53405508298138,2.53405508298138
"46","129","050","Walworth County",5315,5322,5581,7,0.13170272812794,0.13170272812794,266,5.00470366886171,5.00470366886171
"46","135","050","Yankton County",23310,22732,24202,-578,-2.47962247962248,2.47962247962248,892,3.82668382668383,3.82668382668383
"46","137","050","Ziebach County",2413,2688,2852,275,11.3966017405719,11.3966017405719,439,18.1931205967675,18.1931205967675
"47","001","050","Anderson County",77123,77491,76201,368,0.47715986151991,0.47715986151991,-922,-1.19549291391673,1.19549291391673
"47","003","050","Bedford County",50237,50136,48484,-101,-0.201047037044409,0.201047037044409,-1753,-3.48945995979059,3.48945995979059
"47","005","050","Benton County",15864,16173,16925,309,1.94780635400908,1.94780635400908,1061,6.6880988401412,6.6880988401412
"47","007","050","Bledsoe County",14913,15194,13055,281,1.88426205324214,1.88426205324214,-1858,-12.4589284516864,12.4589284516864
"47","009","050","Blount County",135280,134505,132586,-775,-0.572885866351271,0.572885866351271,-2694,-1.99142519219397,1.99142519219397
"47","011","050","Bradley County",108620,108938,107373,318,0.292763763579451,0.292763763579451,-1247,-1.14803903516848,1.14803903516848
"47","013","050","Campbell County",39272,39855,44040,583,1.48451823181911,1.48451823181911,4768,12.1409655734365,12.1409655734365
"47","015","050","Cannon County",14506,14802,14124,296,2.04053495105474,2.04053495105474,-382,-2.63339307872604,2.63339307872604
"47","017","050","Carroll County",28440,27806,28713,-634,-2.22925457102672,2.22925457102672,273,0.959915611814346,0.959915611814346
"47","019","050","Carter County",56356,56471,58805,115,0.20405990489034,0.20405990489034,2449,4.34558875718646,4.34558875718646
"47","021","050","Cheatham County",41072,41078,42334,6,0.014608492403584,0.014608492403584,1262,3.07265290222049,3.07265290222049
"47","023","050","Chester County",17341,17412,17670,71,0.409434288680007,0.409434288680007,329,1.89723776022144,1.89723776022144
"47","025","050","Claiborne County",32043,32012,34006,-31,-0.0967449989077178,0.0967449989077178,1963,6.12614299535,6.12614299535
"47","027","050","Clay County",7581,7621,8078,40,0.527634876665348,0.527634876665348,497,6.55586334256694,6.55586334256694
"47","029","050","Cocke County",35999,36214,36134,215,0.597238812189227,0.597238812189227,135,0.375010416956027,0.375010416956027
"47","031","050","Coffee County",57889,57454,55687,-435,-0.751438097047798,0.751438097047798,-2202,-3.80383147057299,3.80383147057299
"47","033","050","Crockett County",13911,14202,14648,291,2.09186974336856,2.09186974336856,737,5.29796563870318,5.29796563870318
"47","035","050","Cumberland County",61145,61470,61708,325,0.531523427917246,0.531523427917246,563,0.920762122822798,0.920762122822798
"47","037","050","Davidson County",715884,694243,733314,-21641,-3.0229757893737,3.0229757893737,17430,2.4347519989272,2.4347519989272
"47","039","050","Decatur County",11435,11607,11866,172,1.5041539134237,1.5041539134237,431,3.76912986445125,3.76912986445125
"47","041","050","DeKalb County",20080,20751,19574,671,3.34163346613546,3.34163346613546,-506,-2.5199203187251,2.5199203187251
"47","043","050","Dickson County",54315,54292,54007,-23,-0.0423455767283439,0.0423455767283439,-308,-0.567062505753475,0.567062505753475
"47","045","050","Dyer County",36801,36848,39017,47,0.127713920817369,0.127713920817369,2216,6.02157550066574,6.02157550066574
"47","047","050","Fayette County",41990,41527,44201,-463,-1.10264348654442,1.10264348654442,2211,5.26553941414623,5.26553941414623
"47","049","050","Fentress County",18489,18751,18162,262,1.41705879171399,1.41705879171399,-327,-1.76861917897128,1.76861917897128
"47","051","050","Franklin County",42774,42465,43541,-309,-0.72240145883013,0.72240145883013,767,1.79314536868191,1.79314536868191
"47","053","050","Gibson County",50429,49173,51461,-1256,-2.49063039124313,2.49063039124313,1032,2.04644153165837,2.04644153165837
"47","055","050","Giles County",30346,29537,30481,-809,-2.66591972582877,2.66591972582877,135,0.444869175509128,0.444869175509128
"47","057","050","Grainger County",23527,23548,23396,21,0.0892591490627789,0.0892591490627789,-131,-0.556807072724954,0.556807072724954
"47","059","050","Greene County",70152,69503,70643,-649,-0.925133994754248,0.925133994754248,491,0.699908769529023,0.699908769529023
"47","061","050","Grundy County",13529,13489,13910,-40,-0.295661172296548,0.295661172296548,381,2.81617266612462,2.81617266612462
"47","063","050","Hamblen County",64499,65121,63541,622,0.964356036527698,0.964356036527698,-958,-1.48529434564877,1.48529434564877
"47","065","050","Hamilton County",366207,370913,371235,4706,1.28506555035813,1.28506555035813,5028,1.37299396243108,1.37299396243108
"47","067","050","Hancock County",6662,6525,6785,-137,-2.05643950765536,2.05643950765536,123,1.84629240468328,1.84629240468328
"47","069","050","Hardeman County",25462,24922,27782,-540,-2.12080747781007,2.12080747781007,2320,9.11161731207289,9.11161731207289
"47","071","050","Hardin County",26831,25606,26405,-1225,-4.56561440125228,4.56561440125228,-426,-1.58771570198651,1.58771570198651
"47","073","050","Hawkins County",56721,56801,58410,80,0.141041236931648,0.141041236931648,1689,2.97773311471942,2.97773311471942
"47","075","050","Haywood County",17864,17061,19006,-803,-4.49507389162562,4.49507389162562,1142,6.39274518584863,6.39274518584863
"47","077","050","Henderson County",27842,28090,28403,248,0.890740607714963,0.890740607714963,561,2.01494145535522,2.01494145535522
"47","079","050","Henry County",32199,32141,32914,-58,-0.180129817696202,0.180129817696202,715,2.22056585608249,2.22056585608249
"47","081","050","Hickman County",24925,25355,25549,430,1.72517552657974,1.72517552657974,624,2.50351053159478,2.50351053159478
"47","083","050","Houston County",8283,8273,8543,-10,-0.120729204394543,0.120729204394543,260,3.13895931425812,3.13895931425812
"47","085","050","Humphreys County",18990,18599,18806,-391,-2.05897840968931,2.05897840968931,-184,-0.968931016324381,0.968931016324381
"47","087","050","Jackson County",11617,11866,11829,249,2.14341051906688,2.14341051906688,212,1.82491176723767,1.82491176723767
"47","089","050","Jefferson County",54683,55133,54143,450,0.822924857816872,0.822924857816872,-540,-0.987509829380246,0.987509829380246
"47","091","050","Johnson County",17948,17832,18370,-116,-0.646311566748384,0.646311566748384,422,2.35123690661912,2.35123690661912
"47","093","050","Knox County",478971,474445,468561,-4526,-0.944942386908602,0.944942386908602,-10410,-2.17340924607127,2.17340924607127
"47","095","050","Lake County",7005,6984,7823,-21,-0.299785867237687,0.299785867237687,818,11.6773733047823,11.6773733047823
"47","097","050","Lauderdale County",25143,25506,28052,363,1.44374179692161,1.44374179692161,2909,11.5698206260192,11.5698206260192
"47","099","050","Lawrence County",44159,44390,42094,231,0.52310967186757,0.52310967186757,-2065,-4.6762834303313,4.6762834303313
"47","101","050","Lewis County",12582,12352,12719,-230,-1.82800826577651,1.82800826577651,137,1.08885709744079,1.08885709744079
"47","103","050","Lincoln County",35319,34536,34579,-783,-2.21693705937314,2.21693705937314,-740,-2.09518955802826,2.09518955802826
"47","105","050","Loudon County",54886,54723,53634,-163,-0.296979193236891,0.296979193236891,-1252,-2.28109171737784,2.28109171737784
"47","107","050","McMinn County",53276,54141,52626,865,1.62362039192132,1.62362039192132,-650,-1.22006156618365,1.22006156618365
"47","109","050","McNairy County",25866,25701,26416,-165,-0.637903038738112,0.637903038738112,550,2.12634346246037,2.12634346246037
"47","111","050","Macon County",25216,24800,24122,-416,-1.6497461928934,1.6497461928934,-1094,-4.3385152284264,4.3385152284264
"47","113","050","Madison County",98823,98329,102431,-494,-0.499883630328972,0.499883630328972,3608,3.65097193973063,3.65097193973063
"47","115","050","Marion County",28837,28918,29837,81,0.280889135485661,0.280889135485661,1000,3.46776710476124,3.46776710476124
"47","117","050","Marshall County",34318,34893,32746,575,1.6755055655924,1.6755055655924,-1572,-4.58068652019348,4.58068652019348
"47","119","050","Maury County",100974,98921,91709,-2053,-2.03319666448789,2.03319666448789,-9265,-9.17562936993681,9.17562936993681
"47","121","050","Meigs County",12758,12492,12566,-266,-2.08496629565763,2.08496629565763,-192,-1.50493807806866,1.50493807806866
"47","123","050","Monroe County",46250,47043,46119,793,1.71459459459459,1.71459459459459,-131,-0.283243243243243,0.283243243243243
"47","125","050","Montgomery County",220069,213211,211256,-6858,-3.1162953437331,3.1162953437331,-8813,-4.00465308607755,4.00465308607755
"47","127","050","Moore County",6461,6439,6761,-22,-0.340504565856679,0.340504565856679,300,4.6432440798638,4.6432440798638
"47","129","050","Morgan County",21035,21412,22414,377,1.79225101022106,1.79225101022106,1379,6.55574043261231,6.55574043261231
"47","131","050","Obion County",30787,30183,31651,-604,-1.96186702179491,1.96186702179491,864,2.80637931594504,2.80637931594504
"47","133","050","Overton County",22511,22484,22327,-27,-0.1199413620008,0.1199413620008,-184,-0.817378170672116,0.817378170672116
"47","135","050","Perry County",8366,8109,8114,-257,-3.07195792493426,3.07195792493426,-252,-3.01219220655032,3.01219220655032
"47","137","050","Pickett County",5001,5066,5174,65,1.2997400519896,1.2997400519896,173,3.45930813837233,3.45930813837233
"47","139","050","Polk County",17544,16813,19790,-731,-4.16666666666667,4.16666666666667,2246,12.8020975832193,12.8020975832193
"47","141","050","Putnam County",79854,80696,80979,842,1.05442432439202,1.05442432439202,1125,1.40882109850477,1.40882109850477
"47","143","050","Rhea County",32870,33383,33208,513,1.5606936416185,1.5606936416185,338,1.02829327654396,1.02829327654396
"47","145","050","Roane County",53404,53761,54264,357,0.668489251741443,0.668489251741443,860,1.61036626469927,1.61036626469927
"47","147","050","Robertson County",72803,72127,72085,-676,-0.928533164842108,0.928533164842108,-718,-0.986223095202121,0.986223095202121
"47","149","050","Rutherford County",341486,337582,327120,-3904,-1.14323866864235,1.14323866864235,-14366,-4.20690745740675,4.20690745740675
"47","151","050","Scott County",21850,22094,22582,244,1.11670480549199,1.11670480549199,732,3.35011441647597,3.35011441647597
"47","153","050","Sequatchie County",15826,15149,14518,-677,-4.27777075698218,4.27777075698218,-1308,-8.2648805762669,8.2648805762669
"47","155","050","Sevier County",98380,99082,96257,702,0.713559666598902,0.713559666598902,-2123,-2.15795893474283,2.15795893474283
"47","157","050","Shelby County",929744,936830,949006,7086,0.762145278700374,0.762145278700374,19262,2.0717530847201,2.0717530847201
"47","159","050","Smith County",19904,20250,20100,346,1.73834405144695,1.73834405144695,196,0.984726688102894,0.984726688102894
"47","161","050","Stewart County",13657,13810,13563,153,1.12030460569671,1.12030460569671,-94,-0.688291718532621,0.688291718532621
"47","163","050","Sullivan County",158163,158718,161721,555,0.350903814419302,0.350903814419302,3558,2.24957796703401,2.24957796703401
"47","165","050","Sumner County",196281,194576,186173,-1705,-0.868652595004101,0.868652595004101,-10108,-5.14975978316801,5.14975978316801
"47","167","050","Tipton County",60970,61849,63698,879,1.44169263572249,1.44169263572249,2728,4.47433163851074,4.47433163851074
"47","169","050","Trousdale County",11615,11399,8993,-216,-1.85966422729229,1.85966422729229,-2622,-22.5742574257426,22.5742574257426
"47","171","050","Unicoi County",17928,17793,18487,-135,-0.753012048192771,0.753012048192771,559,3.11802766622044,3.11802766622044
"47","173","050","Union County",19802,20107,20584,305,1.54024845975154,1.54024845975154,782,3.94909605090395,3.94909605090395
"47","175","050","Van Buren County",6168,5918,5642,-250,-4.05317769130999,4.05317769130999,-526,-8.52788586251621,8.52788586251621
"47","177","050","Warren County",40953,41506,40499,553,1.35032842526799,1.35032842526799,-454,-1.10858789343882,1.10858789343882
"47","179","050","Washington County",133001,130217,132226,-2784,-2.09321734423049,2.09321734423049,-775,-0.582702385696348,0.582702385696348
"47","181","050","Wayne County",16232,16535,17248,303,1.86668309512075,1.86668309512075,1016,6.25924100542139,6.25924100542139
"47","183","050","Weakley County",32902,33303,35433,401,1.2187708953863,1.2187708953863,2531,7.69254148683971,7.69254148683971
"47","185","050","White County",27351,27609,27429,258,0.943292749808051,0.943292749808051,78,0.285181529011736,0.285181529011736
"47","187","050","Williamson County",247726,243711,239981,-4015,-1.62074227170341,1.62074227170341,-7745,-3.1264380807828,3.1264380807828
"47","189","050","Wilson County",147737,147237,144618,-500,-0.338439253538382,0.338439253538382,-3119,-2.11118406357243,2.11118406357243
"48","001","050","Anderson County",57922,57863,60599,-59,-0.101861123579987,0.101861123579987,2677,4.62173267497669,4.62173267497669
"48","003","050","Andrews County",18610,18902,16485,292,1.5690488984417,1.5690488984417,-2125,-11.4185921547555,11.4185921547555
"48","005","050","Angelina County",86395,86874,91306,479,0.55443023323109,0.55443023323109,4911,5.68435673360727,5.68435673360727
"48","007","050","Aransas County",23830,23753,24753,-77,-0.323122114981116,0.323122114981116,923,3.87326898866974,3.87326898866974
"48","009","050","Archer County",8560,8731,9288,171,1.99766355140187,1.99766355140187,728,8.50467289719626,8.50467289719626
"48","011","050","Armstrong County",1848,1873,1966,25,1.35281385281385,1.35281385281385,118,6.38528138528139,6.38528138528139
"48","013","050","Atascosa County",48981,51644,48120,2663,5.43680202527511,5.43680202527511,-861,-1.7578244625467,1.7578244625467
"48","015","050","Austin County",30167,30058,29784,-109,-0.361321974342825,0.361321974342825,-383,-1.26959923094772,1.26959923094772
"48","017","050","Bailey County",6904,6756,7178,-148,-2.14368482039397,2.14368482039397,274,3.96871378910776,3.96871378910776
"48","019","050","Bandera County",20851,23732,21472,2881,13.8170831135197,13.8170831135197,621,2.97827442328905,2.97827442328905
"48","021","050","Bastrop County",97216,90986,79178,-6230,-6.40841013824885,6.40841013824885,-18038,-18.5545589203423,18.5545589203423
"48","023","050","Baylor County",3465,3531,3692,66,1.9047619047619,1.9047619047619,227,6.55122655122655,6.55122655122655
"48","025","050","Bee County",31047,32579,32211,1532,4.9344542145779,4.9344542145779,1164,3.7491545076819,3.7491545076819
"48","027","050","Bell County",370647,368582,360915,-2065,-0.557133876707487,0.557133876707487,-9732,-2.6256788804442,2.6256788804442
"48","029","050","Bexar County",2009324,2022160,1842570,12836,0.63882181270915,0.63882181270915,-166754,-8.29901001530863,8.29901001530863
"48","031","050","Blanco County",11374,12217,11141,843,7.41164058378759,7.41164058378759,-233,-2.04853173905398,2.04853173905398
"48","033","050","Borden County",631,700,651,69,10.9350237717908,10.9350237717908,20,3.16957210776545,3.16957210776545
"48","035","050","Bosque County",18235,18635,18602,400,2.19358376748012,2.19358376748012,367,2.01261310666301,2.01261310666301
"48","037","050","Bowie County",92893,93571,96780,678,0.729872003272583,0.729872003272583,3887,4.18438418395358,4.18438418395358
"48","039","050","Brazoria County",372031,379317,383923,7286,1.95843894729203,1.95843894729203,11892,3.1965078178969,3.1965078178969
"48","041","050","Brazos County",233849,231939,239014,-1910,-0.816766374882937,0.816766374882937,5165,2.2086902231782,2.2086902231782
"48","043","050","Brewster County",9546,9248,9584,-298,-3.12172637754033,3.12172637754033,38,0.398072491095747,0.398072491095747
"48","045","050","Briscoe County",1435,1505,1644,70,4.8780487804878,4.8780487804878,209,14.5644599303136,14.5644599303136
"48","047","050","Brooks County",7076,7019,7229,-57,-0.805539853024308,0.805539853024308,153,2.16223855285472,2.16223855285472
"48","049","050","Brown County",38095,37704,40544,-391,-1.02638141488384,1.02638141488384,2449,6.42866517915737,6.42866517915737
"48","051","050","Burleson County",17642,18519,18320,877,4.97109171295771,4.97109171295771,678,3.84310168915089,3.84310168915089
"48","053","050","Burnet County",49130,49372,50016,242,0.492570730714431,0.492570730714431,886,1.80337879096275,1.80337879096275
"48","055","050","Caldwell County",45883,43930,44191,-1953,-4.25647843427849,4.25647843427849,-1692,-3.68764030250855,3.68764030250855
"48","057","050","Calhoun County",20106,21099,22892,993,4.93882423157267,4.93882423157267,2786,13.8565602307769,13.8565602307769
"48","059","050","Callahan County",13708,14089,14058,381,2.77939889115845,2.77939889115845,350,2.553253574555,2.553253574555
"48","061","050","Cameron County",421017,424174,444712,3157,0.749850956137163,0.749850956137163,23695,5.62803877278115,5.62803877278115
"48","063","050","Camp County",12464,13078,12870,614,4.92618741976893,4.92618741976893,406,3.25738125802311,3.25738125802311
"48","065","050","Carson County",5807,5866,6186,59,1.01601515412433,1.01601515412433,379,6.52660582056139,6.52660582056139
"48","067","050","Cass County",28454,29956,31325,1502,5.27869543825121,5.27869543825121,2871,10.0899697757784,10.0899697757784
"48","069","050","Castro County",7371,7437,8088,66,0.895400895400895,0.895400895400895,717,9.72730972730973,9.72730972730973
"48","071","050","Chambers County",46571,45172,45930,-1399,-3.00401537437461,3.00401537437461,-641,-1.37639303429173,1.37639303429173
"48","073","050","Cherokee County",50412,52844,52343,2432,4.82424819487424,4.82424819487424,1931,3.83043719749266,3.83043719749266
"48","075","050","Childress County",6664,7175,6958,511,7.66806722689076,7.66806722689076,294,4.41176470588235,4.41176470588235
"48","077","050","Clay County",10218,10545,11121,327,3.20023487962419,3.20023487962419,903,8.83734586024662,8.83734586024662
"48","079","050","Cochran County",2547,2882,3104,335,13.1527287004319,13.1527287004319,557,21.8688653317629,21.8688653317629
"48","081","050","Coke County",3285,3336,3417,51,1.55251141552511,1.55251141552511,132,4.01826484018265,4.01826484018265
"48","083","050","Coleman County",7684,8118,8912,434,5.64809994794378,5.64809994794378,1228,15.9812597605414,15.9812597605414
"48","085","050","Collin County",1064465,1063523,1039718,-942,-0.0884951595402385,0.0884951595402385,-24747,-2.32482984410009,2.32482984410009
"48","087","050","Collingsworth County",2652,2893,3019,241,9.08748114630468,9.08748114630468,367,13.8386123680241,13.8386123680241
"48","089","050","Colorado County",20557,21607,21481,1050,5.10774918519239,5.10774918519239,924,4.4948192829693,4.4948192829693
"48","091","050","Comal County",161501,162805,150649,1304,0.80742534101956,0.80742534101956,-10852,-6.71946303738057,6.71946303738057
"48","093","050","Comanche County",13594,13747,14397,153,1.12549654259232,1.12549654259232,803,5.90701780197146,5.90701780197146
"48","095","050","Concho County",3303,2814,4159,-489,-14.8047229791099,14.8047229791099,856,25.915834090221,25.915834090221
"48","097","050","Cooke County",41668,41318,39658,-350,-0.839973120860132,0.839973120860132,-2010,-4.82384563693962,4.82384563693962
"48","099","050","Coryell County",83093,76729,81529,-6364,-7.65888823366589,7.65888823366589,-1564,-1.88222834655145,1.88222834655145
"48","101","050","Cottle County",1380,1372,1470,-8,-0.579710144927536,0.579710144927536,90,6.52173913043478,6.52173913043478
"48","103","050","Crane County",4675,4787,4528,112,2.39572192513369,2.39572192513369,-147,-3.14438502673797,3.14438502673797
"48","105","050","Crockett County",3098,3509,3769,411,13.2666236281472,13.2666236281472,671,21.6591349257586,21.6591349257586
"48","107","050","Crosby County",5133,5613,6073,480,9.35125657510228,9.35125657510228,940,18.3128774595753,18.3128774595753
"48","109","050","Culberson County",2188,2150,2491,-38,-1.73674588665448,1.73674588665448,303,13.8482632541133,13.8482632541133
"48","111","050","Dallam County",7115,7280,7044,165,2.31904427266339,2.31904427266339,-71,-0.997891777933942,0.997891777933942
"48","113","050","Dallas County",2613539,2637743,2640855,24204,0.92610058621662,0.92610058621662,27316,1.04517284800418,1.04517284800418
"48","115","050","Dawson County",12456,12994,13671,538,4.31920359666024,4.31920359666024,1215,9.75433526011561,9.75433526011561
"48","117","050","Deaf Smith County",18583,18371,19369,-212,-1.14082763816391,1.14082763816391,786,4.22967228111715,4.22967228111715
"48","119","050","Delta County",5230,5354,5332,124,2.37093690248566,2.37093690248566,102,1.95028680688337,1.95028680688337
"48","121","050","Denton County",906422,912175,869768,5753,0.6346933326861,0.6346933326861,-36654,-4.04381182274923,4.04381182274923
"48","123","050","DeWitt County",19824,20174,20356,350,1.76553672316384,1.76553672316384,532,2.68361581920904,2.68361581920904
"48","125","050","Dickens County",1770,2154,2451,384,21.6949152542373,21.6949152542373,681,38.4745762711864,38.4745762711864
"48","127","050","Dimmit County",8615,9981,10281,1366,15.8560650029019,15.8560650029019,1666,19.3383633197911,19.3383633197911
"48","129","050","Donley County",3258,3305,3763,47,1.44260282381829,1.44260282381829,505,15.500306936771,15.500306936771
"48","131","050","Duval County",9831,11096,11969,1265,12.8674600752721,12.8674600752721,2138,21.7475333129895,21.7475333129895
"48","133","050","Eastland County",17725,18372,18986,647,3.65021156558533,3.65021156558533,1261,7.11424541607898,7.11424541607898
"48","135","050","Ector County",165171,167431,157386,2260,1.36827893516416,1.36827893516416,-7785,-4.71329712843054,4.71329712843054
"48","137","050","Edwards County",1422,1927,2082,505,35.5133614627285,35.5133614627285,660,46.4135021097046,46.4135021097046
"48","139","050","Ellis County",192455,190121,185884,-2334,-1.21275103270895,1.21275103270895,-6571,-3.41430464264373,3.41430464264373
"48","141","050","El Paso County",865657,841015,899294,-24642,-2.8466240092785,2.8466240092785,33637,3.88571917052597,3.88571917052597
"48","143","050","Erath County",42545,43089,42164,544,1.27864613938183,1.27864613938183,-381,-0.895522388059702,0.895522388059702
"48","145","050","Falls County",16968,17293,18035,325,1.91537010843942,1.91537010843942,1067,6.28830740216879,6.28830740216879
"48","147","050","Fannin County",35662,35852,34904,190,0.532779989905221,0.532779989905221,-758,-2.12551174920083,2.12551174920083
"48","149","050","Fayette County",24435,25510,24884,1075,4.39942705136075,4.39942705136075,449,1.83752813587068,1.83752813587068
"48","151","050","Fisher County",3672,3803,3956,131,3.56753812636166,3.56753812636166,284,7.73420479302832,7.73420479302832
"48","153","050","Floyd County",5402,5697,6337,295,5.46094039244724,5.46094039244724,935,17.3084042947057,17.3084042947057
"48","155","050","Foard County",1095,1132,1348,37,3.37899543378995,3.37899543378995,253,23.1050228310502,23.1050228310502
"48","157","050","Fort Bend County",822779,833674,824527,10895,1.3241708891452,1.3241708891452,1748,0.212450730998239,0.212450730998239
"48","159","050","Franklin County",10359,10804,10767,445,4.29578144608553,4.29578144608553,408,3.93860411236606,3.93860411236606
"48","161","050","Freestone County",19435,19876,20594,441,2.26910213532287,2.26910213532287,1159,5.96346797015693,5.96346797015693
"48","163","050","Frio County",18385,20368,17747,1983,10.7859668207778,10.7859668207778,-638,-3.47022028827849,3.47022028827849
"48","165","050","Gaines County",21598,21906,18202,308,1.4260579683304,1.4260579683304,-3396,-15.7236781183443,15.7236781183443
"48","167","050","Galveston County",350682,344408,334448,-6274,-1.78908526813466,1.78908526813466,-16234,-4.62926526026428,4.62926526026428
"48","169","050","Garza County",5816,6239,6400,423,7.27303988995873,7.27303988995873,584,10.041265474553,10.041265474553
"48","171","050","Gillespie County",26725,26990,25973,265,0.991580916744621,0.991580916744621,-752,-2.81384471468662,2.81384471468662
"48","173","050","Glasscock County",1116,1433,1239,317,28.405017921147,28.405017921147,123,11.0215053763441,11.0215053763441
"48","175","050","Goliad County",7012,7631,7381,619,8.82772390188249,8.82772390188249,369,5.2624073017684,5.2624073017684
"48","177","050","Gonzales County",19653,20977,20532,1324,6.73688495395105,6.73688495395105,879,4.47259960311403,4.47259960311403
"48","179","050","Gray County",21227,21725,22051,498,2.34606868610732,2.34606868610732,824,3.8818485890611,3.8818485890611
"48","181","050","Grayson County",135543,137863,131059,2320,1.71163394642291,1.71163394642291,-4484,-3.30817526541393,3.30817526541393
"48","183","050","Gregg County",124239,124290,129286,51,0.0410499118634245,0.0410499118634245,5047,4.0623314740138,4.0623314740138
"48","185","050","Grimes County",29268,29468,28323,200,0.683340166735001,0.683340166735001,-945,-3.22878228782288,3.22878228782288
"48","187","050","Guadalupe County",172706,169821,164975,-2885,-1.67046888932637,1.67046888932637,-7731,-4.47639340845136,4.47639340845136
"48","189","050","Hale County",32522,32861,35762,339,1.04237131787713,1.04237131787713,3240,9.96248693192301,9.96248693192301
"48","191","050","Hall County",2825,2949,3294,124,4.38938053097345,4.38938053097345,469,16.6017699115044,16.6017699115044
"48","193","050","Hamilton County",8222,8552,8474,330,4.01362198978351,4.01362198978351,252,3.06494770128922,3.06494770128922
"48","195","050","Hansford County",5285,5297,5611,12,0.227057710501419,0.227057710501419,326,6.16840113528855,6.16840113528855
"48","197","050","Hardeman County",3549,3995,4093,446,12.566920259228,12.566920259228,544,15.3282614821076,15.3282614821076
"48","199","050","Hardin County",56231,58224,62198,1993,3.54430829969234,3.54430829969234,5967,10.6115843573829,10.6115843573829
"48","201","050","Harris County",4731145,4734392,4721383,3247,0.0686303209899506,0.0686303209899506,-9762,-0.206334830152109,0.206334830152109
"48","203","050","Harrison County",68839,66445,68925,-2394,-3.4776798035997,3.4776798035997,86,0.124929182585453,0.124929182585453
"48","205","050","Hartley County",5382,5459,6435,77,1.43069490895578,1.43069490895578,1053,19.5652173913043,19.5652173913043
"48","207","050","Haskell County",5416,5726,5964,310,5.72378138847858,5.72378138847858,548,10.1181683899557,10.1181683899557
"48","209","050","Hays County",241067,238769,230670,-2298,-0.95326195621964,0.95326195621964,-10397,-4.31290885936275,4.31290885936275
"48","211","050","Hemphill County",3382,3788,4005,406,12.0047309284447,12.0047309284447,623,18.4210526315789,18.4210526315789
"48","213","050","Henderson County",82150,83622,83538,1472,1.79184418746196,1.79184418746196,1388,1.6895922093731,1.6895922093731
"48","215","050","Hidalgo County",870781,873940,906275,3159,0.362777782243756,0.362777782243756,35494,4.07611098542573,4.07611098542573
"48","217","050","Hill County",35874,36919,35963,1045,2.9129731839215,2.9129731839215,89,0.248090539109104,0.248090539109104
"48","219","050","Hockley County",21537,22974,23285,1437,6.67223847332498,6.67223847332498,1748,8.11626503227005,8.11626503227005
"48","221","050","Hood County",61598,63142,55593,1544,2.50657488879509,2.50657488879509,-6005,-9.74869313938764,9.74869313938764
"48","223","050","Hopkins County",36787,37181,36312,394,1.07103052708837,1.07103052708837,-475,-1.29121700600756,1.29121700600756
"48","225","050","Houston County",22066,22873,24489,807,3.65721018761896,3.65721018761896,2423,10.980694280794,10.980694280794
"48","227","050","Howard County",34860,36608,35270,1748,5.01434308663224,5.01434308663224,410,1.17613310384395,1.17613310384395
"48","229","050","Hudspeth County",3202,4915,3681,1713,53.4978138663335,53.4978138663335,479,14.9594003747658,14.9594003747658
"48","231","050","Hunt County",99956,99570,90776,-386,-0.386169914762496,0.386169914762496,-9180,-9.18404097803033,9.18404097803033
"48","233","050","Hutchinson County",20617,20728,22289,111,0.538390648493961,0.538390648493961,1672,8.10981229082796,8.10981229082796
"48","235","050","Irion County",1513,1572,1624,59,3.8995373430271,3.8995373430271,111,7.33641771315268,7.33641771315268
"48","237","050","Jack County",8472,9027,9260,555,6.55099150141643,6.55099150141643,788,9.30122757318225,9.30122757318225
"48","239","050","Jackson County",14988,14845,14528,-143,-0.954096610621831,0.954096610621831,-460,-3.06912196423806,3.06912196423806
"48","241","050","Jasper County",32980,35462,37358,2482,7.52577319587629,7.52577319587629,4378,13.2747119466343,13.2747119466343
"48","243","050","Jeff Davis County",1996,2230,2415,234,11.7234468937876,11.7234468937876,419,20.9919839679359,20.9919839679359
"48","245","050","Jefferson County",256526,250584,264815,-5942,-2.31633440664884,2.31633440664884,8289,3.23125141311212,3.23125141311212
"48","247","050","Jim Hogg County",4838,5175,5352,337,6.96568830095081,6.96568830095081,514,10.6242248863167,10.6242248863167
"48","249","050","Jim Wells County",38891,40504,41590,1613,4.14748913630403,4.14748913630403,2699,6.93990897636985,6.93990897636985
"48","251","050","Johnson County",179927,178772,171708,-1155,-0.64192700372929,0.64192700372929,-8219,-4.56796367415674,4.56796367415674
"48","253","050","Jones County",19663,19879,20336,216,1.09850989167472,1.09850989167472,673,3.42267202359762,3.42267202359762
"48","255","050","Karnes County",14710,15531,16171,821,5.581237253569,5.581237253569,1461,9.93201903467029,9.93201903467029
"48","257","050","Kaufman County",145310,141585,118689,-3725,-2.56348496318216,2.56348496318216,-26621,-18.3201431422476,18.3201431422476
"48","259","050","Kendall County",44279,48268,40869,3989,9.00878520291786,9.00878520291786,-3410,-7.70116759637752,7.70116759637752
"48","261","050","Kenedy County",350,382,411,32,9.14285714285714,9.14285714285714,61,17.4285714285714,17.4285714285714
"48","263","050","Kent County",753,779,808,26,3.45285524568393,3.45285524568393,55,7.30411686586985,7.30411686586985
"48","265","050","Kerr County",52598,52795,52279,197,0.374538955853835,0.374538955853835,-319,-0.60648693866687,0.60648693866687
"48","267","050","Kimble County",4286,4384,4687,98,2.28651423238451,2.28651423238451,401,9.3560429304713,9.3560429304713
"48","269","050","King County",265,282,285,17,6.41509433962264,6.41509433962264,20,7.54716981132075,7.54716981132075
"48","271","050","Kinney County",3129,3672,3702,543,17.3537871524449,17.3537871524449,573,18.3125599232982,18.3125599232982
"48","273","050","Kleberg County",31040,30408,33382,-632,-2.0360824742268,2.0360824742268,2342,7.5451030927835,7.5451030927835
"48","275","050","Knox County",3353,3679,3694,326,9.72263644497465,9.72263644497465,341,10.1699970175962,10.1699970175962
"48","277","050","Lamar County",50088,49903,50810,-185,-0.369349944098387,0.369349944098387,722,1.44146302507587,1.44146302507587
"48","279","050","Lamb County",13045,12761,13823,-284,-2.17707934074358,2.17707934074358,778,5.96397087006516,5.96397087006516
"48","281","050","Lampasas County",21627,21685,21617,58,0.26818328940676,0.26818328940676,-10,-0.0462384981735793,0.0462384981735793
"48","283","050","La Salle County",6664,7517,7606,853,12.8001200480192,12.8001200480192,942,14.1356542617047,14.1356542617047
"48","285","050","Lavaca County",20337,20205,19662,-132,-0.649063283670158,0.649063283670158,-675,-3.31907360967694,3.31907360967694
"48","287","050","Lee County",17478,17396,17433,-82,-0.469161231262158,0.469161231262158,-45,-0.257466529351184,0.257466529351184
"48","289","050","Leon County",15719,17481,17654,1762,11.2093644633883,11.2093644633883,1935,12.3099433806222,12.3099433806222
"48","291","050","Liberty County",91628,90825,87941,-803,-0.876369668660235,0.876369668660235,-3687,-4.02387916357445,4.02387916357445
"48","293","050","Limestone County",22146,23381,24034,1235,5.5766278334688,5.5766278334688,1888,8.52524157861465,8.52524157861465
"48","295","050","Lipscomb County",3059,3142,3280,83,2.71330500163452,2.71330500163452,221,7.22458319712324,7.22458319712324
"48","297","050","Live Oak County",11335,12309,12025,974,8.59285399205999,8.59285399205999,690,6.08734009704455,6.08734009704455
"48","299","050","Llano County",21243,21947,21456,704,3.3140328578826,3.3140328578826,213,1.00268323683096,1.00268323683096
"48","301","050","Loving County",64,172,92,108,168.75,168.75,28,43.75,43.75
"48","303","050","Lubbock County",310639,314034,320755,3395,1.0929084886315,1.0929084886315,10116,3.25651318733321,3.25651318733321
"48","305","050","Lynn County",5596,6017,5882,421,7.52323087919943,7.52323087919943,286,5.1107934238742,5.1107934238742
"48","307","050","McCulloch County",7630,7877,8371,247,3.23722149410223,3.23722149410223,741,9.71166448230668,9.71166448230668
"48","309","050","McLennan County",260579,259203,256930,-1376,-0.528054831740086,0.528054831740086,-3649,-1.40034308213632,1.40034308213632
"48","311","050","McMullen County",600,729,730,129,21.5,21.5,130,21.6666666666667,21.6666666666667
"48","313","050","Madison County",13455,14414,14452,959,7.1274619100706,7.1274619100706,997,7.40988480118915,7.40988480118915
"48","315","050","Marion County",9725,9922,11076,197,2.02570694087404,2.02570694087404,1351,13.892030848329,13.892030848329
"48","317","050","Martin County",5237,5793,4957,556,10.6167653236586,10.6167653236586,-280,-5.3465724651518,5.3465724651518
"48","319","050","Mason County",3953,4323,4139,370,9.35997976220592,9.35997976220592,186,4.70528712370352,4.70528712370352
"48","321","050","Matagorda County",36255,36734,39021,479,1.32119707626534,1.32119707626534,2766,7.62929251137774,7.62929251137774
"48","323","050","Maverick County",57887,58417,58039,530,0.915576899822067,0.915576899822067,152,0.262580544854631,0.262580544854631
"48","325","050","Medina County",50748,52193,48329,1445,2.84740285331442,2.84740285331442,-2419,-4.76669031291874,4.76669031291874
"48","327","050","Menard County",1962,2116,2284,154,7.84913353720693,7.84913353720693,322,16.4118246687054,16.4118246687054
"48","329","050","Midland County",169983,177595,161684,7612,4.47809486831036,4.47809486831036,-8299,-4.88225293117547,4.88225293117547
"48","331","050","Milam County",24754,24726,25210,-28,-0.113113032237214,0.113113032237214,456,1.84212652500606,1.84212652500606
"48","333","050","Mills County",4456,4841,4991,385,8.64003590664273,8.64003590664273,535,12.0062836624776,12.0062836624776
"48","335","050","Mitchell County",8990,8188,9493,-802,-8.9210233592881,8.9210233592881,503,5.59510567296997,5.59510567296997
"48","337","050","Montague County",19965,19934,20113,-31,-0.155271725519659,0.155271725519659,148,0.74129727022289,0.74129727022289
"48","339","050","Montgomery County",620443,621953,604795,1510,0.243374492096776,0.243374492096776,-15648,-2.52206890882805,2.52206890882805
"48","341","050","Moore County",21358,20707,22657,-651,-3.04803820582452,3.04803820582452,1299,6.08203015263601,6.08203015263601
"48","343","050","Morris County",11973,12384,13001,411,3.43272362816337,3.43272362816337,1028,8.5859851332164,8.5859851332164
"48","345","050","Motley County",1063,1189,1199,126,11.8532455315146,11.8532455315146,136,12.793979303857,12.793979303857
"48","347","050","Nacogdoches County",64653,64802,67415,149,0.230461076825515,0.230461076825515,2762,4.27203687377229,4.27203687377229
"48","349","050","Navarro County",52624,50539,51164,-2085,-3.96207053815749,3.96207053815749,-1460,-2.77439951352995,2.77439951352995
"48","351","050","Newton County",12217,13488,15127,1271,10.403536056315,10.403536056315,2910,23.8192682327904,23.8192682327904
"48","353","050","Nolan County",14738,14819,15033,81,0.549599674311304,0.549599674311304,295,2.00162844347944,2.00162844347944
"48","355","050","Nueces County",353178,363196,365652,10018,2.83653002168878,2.83653002168878,12474,3.53193007491973,3.53193007491973
"48","357","050","Ochiltree County",10015,9648,10497,-367,-3.6645032451323,3.6645032451323,482,4.81278082875686,4.81278082875686
"48","359","050","Oldham County",1758,2126,2103,368,20.9328782707622,20.9328782707622,345,19.6245733788396,19.6245733788396
"48","361","050","Orange County",84808,82953,89602,-1855,-2.18729365154231,2.18729365154231,4794,5.65276860673521,5.65276860673521
"48","363","050","Palo Pinto County",28409,29280,28803,871,3.06592981097539,3.06592981097539,394,1.3868844380302,1.3868844380302
"48","365","050","Panola County",22491,23170,24980,679,3.01898537192655,3.01898537192655,2489,11.0666488817749,11.0666488817749
"48","367","050","Parker County",148222,146987,131172,-1235,-0.833209644991971,0.833209644991971,-17050,-11.5030157466503,11.5030157466503
"48","369","050","Parmer County",9869,9525,10239,-344,-3.48566217448576,3.48566217448576,370,3.74911338534806,3.74911338534806
"48","371","050","Pecos County",15193,15725,16234,532,3.50161258474297,3.50161258474297,1041,6.8518396630027,6.8518396630027
"48","373","050","Polk County",50123,52560,53774,2437,4.86203938311753,4.86203938311753,3651,7.28408116034555,7.28408116034555
"48","375","050","Potter County",118525,116271,129488,-2254,-1.90170850031639,1.90170850031639,10963,9.24952541657878,9.24952541657878
"48","377","050","Presidio County",6131,6528,8132,397,6.47528951231447,6.47528951231447,2001,32.6374164084163,32.6374164084163
"48","379","050","Rains County",12164,12521,11329,357,2.93488983886879,2.93488983886879,-835,-6.86451825057547,6.86451825057547
"48","381","050","Randall County",140753,139430,130262,-1323,-0.939944441681527,0.939944441681527,-10491,-7.45348234140658,7.45348234140658
"48","383","050","Reagan County",3385,3832,3502,447,13.205317577548,13.205317577548,117,3.45642540620384,3.45642540620384
"48","385","050","Real County",2758,3427,3433,669,24.2567077592458,24.2567077592458,675,24.4742567077592,24.4742567077592
"48","387","050","Red River County",11587,12023,13179,436,3.76283766289808,3.76283766289808,1592,13.7395356865453,13.7395356865453
"48","389","050","Reeves County",14748,15940,13997,1192,8.08245185787903,8.08245185787903,-751,-5.0922158936805,5.0922158936805
"48","391","050","Refugio County",6741,6860,7421,119,1.76531671858775,1.76531671858775,680,10.0875241062157,10.0875241062157
"48","393","050","Roberts County",827,817,929,-10,-1.20918984280532,1.20918984280532,102,12.3337363966143,12.3337363966143
"48","395","050","Robertson County",16757,17148,17855,391,2.33335322551769,2.33335322551769,1098,6.55248552843588,6.55248552843588
"48","397","050","Rockwall County",107819,108680,107763,861,0.798560550552315,0.798560550552315,-56,-0.0519388975968985,0.0519388975968985
"48","399","050","Runnels County",9900,10371,10377,471,4.75757575757576,4.75757575757576,477,4.81818181818182,4.81818181818182
"48","401","050","Rusk County",52214,54368,54973,2154,4.12533037116482,4.12533037116482,2759,5.28402344198874,5.28402344198874
"48","403","050","Sabine County",9894,10506,11525,612,6.18556701030928,6.18556701030928,1631,16.484738225187,16.484738225187
"48","405","050","San Augustine County",7918,8237,9136,319,4.02879515029048,4.02879515029048,1218,15.3826723920182,15.3826723920182
"48","407","050","San Jacinto County",27402,29197,30003,1795,6.55061674330341,6.55061674330341,2601,9.4920078826363,9.4920078826363
"48","409","050","San Patricio County",68755,66969,71426,-1786,-2.5976292633263,2.5976292633263,2671,3.88480837757254,3.88480837757254
"48","411","050","San Saba County",5730,6028,6194,298,5.20069808027923,5.20069808027923,464,8.09773123909249,8.09773123909249
"48","413","050","Schleicher County",2451,2764,3514,313,12.7702978376173,12.7702978376173,1063,43.3700530395757,43.3700530395757
"48","415","050","Scurry County",16932,16654,17500,-278,-1.64186156390267,1.64186156390267,568,3.35459484998819,3.35459484998819
"48","417","050","Shackelford County",3105,3298,3426,193,6.21578099838969,6.21578099838969,321,10.3381642512077,10.3381642512077
"48","419","050","Shelby County",24022,25034,26785,1012,4.21280492881525,4.21280492881525,2763,11.5019565398385,11.5019565398385
"48","421","050","Sherman County",2782,3025,3284,243,8.73472322070453,8.73472322070453,502,18.0445722501797,18.0445722501797
"48","423","050","Smith County",233479,235217,221955,1738,0.74439242929771,0.74439242929771,-11524,-4.93577580853096,4.93577580853096
"48","425","050","Somervell County",9205,9127,9018,-78,-0.847365562194459,0.847365562194459,-187,-2.03150461705595,2.03150461705595
"48","427","050","Starr County",65920,64313,62284,-1607,-2.43780339805825,2.43780339805825,-3636,-5.51577669902913,5.51577669902913
"48","429","050","Stephens County",9101,9335,9694,234,2.57114602790902,2.57114602790902,593,6.51576749807713,6.51576749807713
"48","431","050","Sterling County",1372,1306,1184,-66,-4.81049562682216,4.81049562682216,-188,-13.7026239067055,13.7026239067055
"48","433","050","Stonewall County",1245,1352,1509,107,8.59437751004016,8.59437751004016,264,21.2048192771084,21.2048192771084
"48","435","050","Sutton County",3372,3758,4201,386,11.4472123368921,11.4472123368921,829,24.5848161328588,24.5848161328588
"48","437","050","Swisher County",6971,7331,7732,360,5.1642519007316,5.1642519007316,761,10.9166547123799,10.9166547123799
"48","439","050","Tarrant County",2110640,2119134,2035408,8494,0.402437175453891,0.402437175453891,-75232,-3.56441648030929,3.56441648030929
"48","441","050","Taylor County",143208,138998,137193,-4210,-2.93977990056421,2.93977990056421,-6015,-4.20018434724317,4.20018434724317
"48","443","050","Terrell County",760,717,977,-43,-5.65789473684211,5.65789473684211,217,28.5526315789474,28.5526315789474
"48","445","050","Terry County",11831,12225,12730,394,3.33023413067365,3.33023413067365,899,7.59868143014115,7.59868143014115
"48","447","050","Throckmorton County",1440,1475,1649,35,2.43055555555556,2.43055555555556,209,14.5138888888889,14.5138888888889
"48","449","050","Titus County",31247,32886,33804,1639,5.24530354914072,5.24530354914072,2557,8.18318558581624,8.18318558581624
"48","451","050","Tom Green County",120003,119919,116222,-84,-0.0699982500437489,0.0699982500437489,-3781,-3.15075456446922,3.15075456446922
"48","453","050","Travis County",1290188,1294483,1301879,4295,0.332897221180169,0.332897221180169,11691,0.906147011133261,0.906147011133261
"48","455","050","Trinity County",13602,14828,15450,1226,9.01338038523746,9.01338038523746,1848,13.5862373180415,13.5862373180415
"48","457","050","Tyler County",19798,21562,22678,1764,8.90999090817254,8.90999090817254,2880,14.5469239317103,14.5469239317103
"48","459","050","Upshur County",40892,42039,40686,1147,2.80494962339822,2.80494962339822,-206,-0.503766017802993,0.503766017802993
"48","461","050","Upton County",3308,3622,3399,314,9.49214026602177,9.49214026602177,91,2.7509068923821,2.7509068923821
"48","463","050","Uvalde County",24564,26753,27480,2189,8.91141507897736,8.91141507897736,2916,11.8710307767465,11.8710307767465
"48","465","050","Val Verde County",47586,49031,50868,1445,3.03660740553944,3.03660740553944,3282,6.89698650863699,6.89698650863699
"48","467","050","Van Zandt County",59541,57327,54699,-2214,-3.71844611276263,3.71844611276263,-4842,-8.13221141734267,8.13221141734267
"48","469","050","Victoria County",91319,91975,91789,656,0.718360910653862,0.718360910653862,470,0.514679310986761,0.514679310986761
"48","471","050","Walker County",76400,72061,77778,-4339,-5.67931937172775,5.67931937172775,1378,1.80366492146597,1.80366492146597
"48","473","050","Waller County",56794,56929,48488,135,0.237701165616086,0.237701165616086,-8306,-14.6247843082016,14.6247843082016
"48","475","050","Ward County",11644,12048,11005,404,3.46959807626245,3.46959807626245,-639,-5.48780487804878,5.48780487804878
"48","477","050","Washington County",35805,35742,36068,-63,-0.175953079178886,0.175953079178886,263,0.73453428292138,0.73453428292138
"48","479","050","Webb County",267114,277567,296360,10453,3.91331042176749,3.91331042176749,29246,10.9488832483509,10.9488832483509
"48","481","050","Wharton County",41570,41684,43109,114,0.274236228049074,0.274236228049074,1539,3.7021890786625,3.7021890786625
"48","483","050","Wheeler County",4990,4952,5382,-38,-0.761523046092184,0.761523046092184,392,7.85571142284569,7.85571142284569
"48","485","050","Wichita County",129350,133036,133140,3686,2.84963277928102,2.84963277928102,3790,2.93003478933127,2.93003478933127
"48","487","050","Wilbarger County",12887,12579,13331,-308,-2.39000543183053,2.39000543183053,444,3.44533250562582,3.44533250562582
"48","489","050","Willacy County",20164,21186,23391,1022,5.06843880182504,5.06843880182504,3227,16.0037690934338,16.0037690934338
"48","491","050","Williamson County",609017,611682,548147,2665,0.437590412090303,0.437590412090303,-60870,-9.99479489078302,9.99479489078302
"48","493","050","Wilson County",49753,51753,45823,2000,4.01985809900911,4.01985809900911,-3930,-7.89902116455289,7.89902116455289
"48","495","050","Winkler County",7791,7888,7284,97,1.24502631241176,1.24502631241176,-507,-6.50750866384289,6.50750866384289
"48","497","050","Wise County",68632,70786,63117,2154,3.13847767805105,3.13847767805105,-5515,-8.0356102109803,8.0356102109803
"48","499","050","Wood County",44843,46095,43317,1252,2.79196307115938,2.79196307115938,-1526,-3.40298374328212,3.40298374328212
"48","501","050","Yoakum County",7694,8679,8109,985,12.8021835196257,12.8021835196257,415,5.39381336106057,5.39381336106057
"48","503","050","Young County",17867,17905,18785,38,0.212682599205239,0.212682599205239,918,5.13796384395813,5.13796384395813
"48","505","050","Zapata County",13889,14186,14768,297,2.13838289293686,2.13838289293686,879,6.32874937000504,6.32874937000504
"48","507","050","Zavala County",9670,11813,12127,2143,22.1613236814891,22.1613236814891,2457,25.4084798345398,25.4084798345398
"49","001","050","Beaver County",7072,6766,7001,-306,-4.32692307692308,4.32692307692308,-71,-1.0039592760181,1.0039592760181
"49","003","050","Box Elder County",57666,56805,56516,-861,-1.49308084486526,1.49308084486526,-1150,-1.99424270800819,1.99424270800819
"49","005","050","Cache County",133154,129656,134835,-3498,-2.62703335986902,2.62703335986902,1681,1.26244799254998,1.26244799254998
"49","007","050","Carbon County",20412,20725,22156,313,1.5334117185969,1.5334117185969,1744,8.54399372917891,8.54399372917891
"49","009","050","Daggett County",935,1013,1158,78,8.34224598930481,8.34224598930481,223,23.8502673796791,23.8502673796791
"49","011","050","Davis County",362679,358385,357370,-4294,-1.1839670893545,1.1839670893545,-5309,-1.46382889552469,1.46382889552469
"49","013","050","Duchesne County",19596,19910,20781,314,1.60236783016942,1.60236783016942,1185,6.04715248009798,6.04715248009798
"49","015","050","Emery County",9825,10127,11372,302,3.07379134860051,3.07379134860051,1547,15.7455470737914,15.7455470737914
"49","017","050","Garfield County",5083,5042,5444,-41,-0.806610269525871,0.806610269525871,361,7.10210505606925,7.10210505606925
"49","019","050","Grand County",9669,9803,11135,134,1.38587237563347,1.38587237563347,1466,15.1618574826766,15.1618574826766
"49","021","050","Iron County",57289,56481,53721,-808,-1.41039292010683,1.41039292010683,-3568,-6.22807170661034,6.22807170661034
"49","023","050","Juab County",11786,12108,11539,322,2.73205498048532,2.73205498048532,-247,-2.09570677074495,2.09570677074495
"49","025","050","Kane County",7667,7899,7665,232,3.02595539324377,3.02595539324377,-2,-0.0260858223555498,0.0260858223555498
"49","027","050","Millard County",12975,13280,13088,305,2.35067437379576,2.35067437379576,113,0.870905587668593,0.870905587668593
"49","029","050","Morgan County",12295,12377,11920,82,0.666937779585197,0.666937779585197,-375,-3.05002033346889,3.05002033346889
"49","031","050","Piute County",1438,1472,1801,34,2.3643949930459,2.3643949930459,363,25.2433936022253,25.2433936022253
"49","033","050","Rich County",2510,2458,2588,-52,-2.07171314741036,2.07171314741036,78,3.10756972111554,3.10756972111554
"49","035","050","Salt Lake County",1185238,1164301,1184039,-20937,-1.76648065620576,1.76648065620576,-1199,-0.101161117007723,0.101161117007723
"49","037","050","San Juan County",14518,15274,15693,756,5.20732883317261,5.20732883317261,1175,8.09340129494421,8.09340129494421
"49","039","050","Sanpete County",28437,31301,29213,2864,10.0713858705208,10.0713858705208,776,2.72883918838133,2.72883918838133
"49","041","050","Sevier County",21522,21755,22233,233,1.08261314004275,1.08261314004275,711,3.30359632004461,3.30359632004461
"49","043","050","Summit County",42357,42389,39601,32,0.0755483155086527,0.0755483155086527,-2756,-6.50659867318271,6.50659867318271
"49","045","050","Tooele County",72698,73920,71130,1222,1.68092657294561,1.68092657294561,-1568,-2.15686813942612,2.15686813942612
"49","047","050","Uintah County",35620,35922,37747,302,0.847838293093768,0.847838293093768,2127,5.97136440202134,5.97136440202134
"49","049","050","Utah County",659399,647412,667376,-11987,-1.81786748235894,1.81786748235894,7977,1.20973795835299,1.20973795835299
"49","051","050","Wasatch County",34788,35010,32748,222,0.63815108658158,0.63815108658158,-2040,-5.86409106588479,5.86409106588479
"49","053","050","Washington County",180279,183252,183724,2973,1.64911054532142,1.64911054532142,3445,1.91092695211311,1.91092695211311
"49","055","050","Wayne County",2486,2736,3005,250,10.0563153660499,10.0563153660499,519,20.8769106999195,20.8769106999195
"49","057","050","Weber County",262223,261963,256483,-260,-0.0991522482772297,0.0991522482772297,-5740,-2.18897655812038,2.18897655812038
"50","001","050","Addison County",37363,36937,38990,-426,-1.14016540427696,1.14016540427696,1627,4.35457538206247,4.35457538206247
"50","003","050","Bennington County",37347,35446,37662,-1901,-5.09010094518971,5.09010094518971,315,0.843441240260262,0.843441240260262
"50","005","050","Caledonia County",30233,29773,32451,-460,-1.52151622399365,1.52151622399365,2218,7.33635431482155,7.33635431482155
"50","007","050","Chittenden County",168323,164323,171022,-4000,-2.37638350076935,2.37638350076935,2699,1.60346476714412,1.60346476714412
"50","009","050","Essex County",5920,6133,6594,213,3.59797297297297,3.59797297297297,674,11.3851351351351,11.3851351351351
"50","011","050","Franklin County",49946,49647,50694,-299,-0.598646538261322,0.598646538261322,748,1.49761742682097,1.49761742682097
"50","013","050","Grand Isle County",7293,7179,7471,-114,-1.56314273961333,1.56314273961333,178,2.44069655834362,2.44069655834362
"50","015","050","Lamoille County",25945,25364,26583,-581,-2.23935247639237,2.23935247639237,638,2.45904798612449,2.45904798612449
"50","017","050","Orange County",29277,28835,30531,-442,-1.50971752570277,1.50971752570277,1254,4.28322574034225,4.28322574034225
"50","019","050","Orleans County",27393,26901,30496,-492,-1.79607929032965,1.79607929032965,3103,11.3277114591319,11.3277114591319
"50","021","050","Rutland County",60572,57879,63346,-2693,-4.4459486231262,4.4459486231262,2774,4.57967377666248,4.57967377666248
"50","023","050","Washington County",59807,58363,61857,-1444,-2.41443309311619,2.41443309311619,2050,3.42769241058739,3.42769241058739
"50","025","050","Windham County",45905,42064,46480,-3841,-8.36728025269578,8.36728025269578,575,1.25258686417602,1.25258686417602
"50","027","050","Windsor County",57753,54977,58570,-2776,-4.80667670943501,4.80667670943501,817,1.41464512666009,1.41464512666009
"51","001","050","Accomack County",33413,32315,33707,-1098,-3.2861461107952,3.2861461107952,294,0.879897046059917,0.879897046059917
"51","003","050","Albemarle County",112395,110549,112176,-1846,-1.64242181591708,1.64242181591708,-219,-0.194848525290271,0.194848525290271
"51","005","050","Alleghany County",15223,14767,16133,-456,-2.99546738487815,2.99546738487815,910,5.97779675491033,5.97779675491033
"51","007","050","Amelia County",13265,13047,13519,-218,-1.64342254052017,1.64342254052017,254,1.9148134187712,1.9148134187712
"51","009","050","Amherst County",31307,31714,33067,407,1.30002874756444,1.30002874756444,1760,5.6217459354138,5.6217459354138
"51","011","050","Appomattox County",16119,16033,16164,-86,-0.533531856814939,0.533531856814939,45,0.279173646007817,0.279173646007817
"51","013","050","Arlington County",238643,239850,234816,1207,0.505776410789338,0.505776410789338,-3827,-1.60365064133455,1.60365064133455
"51","015","050","Augusta County",77487,76522,78273,-965,-1.24537019112883,1.24537019112883,786,1.01436369971737,1.01436369971737
"51","017","050","Bath County",4209,4137,4773,-72,-1.71062009978617,1.71062009978617,564,13.399857448325,13.399857448325
"51","019","050","Bedford County",79462,79800,79610,338,0.42536054969671,0.42536054969671,148,0.186252548387909,0.186252548387909
"51","021","050","Bland County",6270,6261,7043,-9,-0.143540669856459,0.143540669856459,773,12.3285486443381,12.3285486443381
"51","023","050","Botetourt County",33596,33646,34310,50,0.148827241338255,0.148827241338255,714,2.12525300631028,2.12525300631028
"51","025","050","Brunswick County",15849,16084,17593,235,1.48274339075021,1.48274339075021,1744,11.0038488232696,11.0038488232696
"51","027","050","Buchanan County",20355,20726,24024,371,1.82264799803488,1.82264799803488,3669,18.0250552689757,18.0250552689757
"51","029","050","Buckingham County",16824,17174,17767,350,2.08036138849263,2.08036138849263,943,5.60508796956729,5.60508796956729
"51","031","050","Campbell County",55696,55391,57860,-305,-0.547615627693192,0.547615627693192,2164,3.88537776501005,3.88537776501005
"51","033","050","Caroline County",30887,30866,30363,-21,-0.0679897691585457,0.0679897691585457,-524,-1.69650662090847,1.69650662090847
"51","035","050","Carroll County",29155,30092,30253,937,3.21385697135997,3.21385697135997,1098,3.76607785971531,3.76607785971531
"51","036","050","Charles City County",6773,6876,7636,103,1.52074413110881,1.52074413110881,863,12.741768787834,12.741768787834
"51","037","050","Charlotte County",11529,11855,12753,326,2.82765200797988,2.82765200797988,1224,10.6167056986729,10.6167056986729
"51","041","050","Chesterfield County",364548,357241,352190,-7307,-2.00439996927702,2.00439996927702,-12358,-3.38995139186061,3.38995139186061
"51","043","050","Clarke County",14783,14613,14663,-170,-1.1499695596293,1.1499695596293,-120,-0.811743218561862,0.811743218561862
"51","045","050","Craig County",4892,5094,5371,202,4.12919051512674,4.12919051512674,479,9.7914963205233,9.7914963205233
"51","047","050","Culpeper County",52552,53390,51379,838,1.59461105191049,1.59461105191049,-1173,-2.23207489724463,2.23207489724463
"51","049","050","Cumberland County",9675,9948,10380,273,2.82170542635659,2.82170542635659,705,7.28682170542636,7.28682170542636
"51","051","050","Dickenson County",14124,14140,15846,16,0.11328235627301,0.11328235627301,1722,12.1920135938828,12.1920135938828
"51","053","050","Dinwiddie County",27947,28747,29198,800,2.86256127670233,2.86256127670233,1251,4.47633019644327,4.47633019644327
"51","057","050","Essex County",10599,10957,11441,358,3.37767713935277,3.37767713935277,842,7.9441456741202,7.9441456741202
"51","059","050","Fairfax County",1150309,1152138,1105456,1829,0.159000755449188,0.159000755449188,-44853,-3.89921316794009,3.89921316794009
"51","061","050","Fauquier County",72972,71408,70032,-1564,-2.14328783643041,2.14328783643041,-2940,-4.02894260812366,4.02894260812366
"51","063","050","Floyd County",15476,15797,15929,321,2.07417937451538,2.07417937451538,453,2.92711294908245,2.92711294908245
"51","065","050","Fluvanna County",27249,27417,27817,168,0.616536386656391,0.616536386656391,568,2.0844801644097,2.0844801644097
"51","067","050","Franklin County",54477,56242,57726,1765,3.23989940708923,3.23989940708923,3249,5.96398480092516,5.96398480092516
"51","069","050","Frederick County",91419,90784,89894,-635,-0.694603966352728,0.694603966352728,-1525,-1.66814338376049,1.66814338376049
"51","071","050","Giles County",16787,16681,17392,-106,-0.631440996008816,0.631440996008816,605,3.60397926967296,3.60397926967296
"51","073","050","Gloucester County",38711,37501,39307,-1210,-3.12572653767663,3.12572653767663,596,1.53961406318617,1.53961406318617
"51","075","050","Goochland County",24727,24353,24764,-374,-1.51251668216929,1.51251668216929,37,0.149634003316213,0.149634003316213
"51","077","050","Grayson County",15333,15530,15728,197,1.28481053935955,1.28481053935955,395,2.57614295962956,2.57614295962956
"51","079","050","Greene County",20552,20112,21104,-440,-2.14091086025691,2.14091086025691,552,2.6858699883223,2.6858699883223
"51","081","050","Greensville County",11391,11296,12587,-95,-0.833991747871126,0.833991747871126,1196,10.4995171626723,10.4995171626723
"51","083","050","Halifax County",34022,33761,36736,-261,-0.767150667215331,0.767150667215331,2714,7.97719122920463,7.97719122920463
"51","085","050","Hanover County",109979,108158,111814,-1821,-1.65577064712354,1.65577064712354,1835,1.66850035006683,1.66850035006683
"51","087","050","Henrico County",334389,333715,324433,-674,-0.201561654241019,0.201561654241019,-9956,-2.9773706670973,2.9773706670973
"51","089","050","Henry County",50948,50472,53897,-476,-0.934285938604067,0.934285938604067,2949,5.78825469105755,5.78825469105755
"51","091","050","Highland County",2232,2200,2397,-32,-1.4336917562724,1.4336917562724,165,7.39247311827957,7.39247311827957
"51","093","050","Isle of Wight County",38606,37673,38940,-933,-2.41672278920375,2.41672278920375,334,0.86515049474175,0.86515049474175
"51","095","050","James City County",78254,77492,77021,-762,-0.973752140465663,0.973752140465663,-1233,-1.57563830602908,1.57563830602908
"51","097","050","King and Queen County",6608,6961,7176,353,5.34200968523002,5.34200968523002,568,8.5956416464891,8.5956416464891
"51","099","050","King George County",26723,27293,25790,570,2.13299405006923,2.13299405006923,-933,-3.49137447142911,3.49137447142911
"51","101","050","King William County",17810,17545,17950,-265,-1.4879281302639,1.4879281302639,140,0.786075238629983,0.786075238629983
"51","103","050","Lancaster County",10919,10636,11833,-283,-2.59181243703636,2.59181243703636,914,8.37072992032237,8.37072992032237
"51","105","050","Lee County",22173,23327,25676,1154,5.20452802958553,5.20452802958553,3503,15.7984936634646,15.7984936634646
"51","107","050","Loudoun County",420959,421074,405533,115,0.0273185749681085,0.0273185749681085,-15426,-3.6644898909395,3.6644898909395
"51","109","050","Louisa County",37596,37974,36661,378,1.00542610916055,1.00542610916055,-935,-2.48696669858496,2.48696669858496
"51","111","050","Lunenburg County",11936,12271,13055,335,2.80663538873995,2.80663538873995,1119,9.375,9.375
"51","113","050","Madison County",13837,13308,13858,-529,-3.82308303823083,3.82308303823083,21,0.15176700151767,0.15176700151767
"51","115","050","Mathews County",8533,8786,9123,253,2.96495956873315,2.96495956873315,590,6.91433259111684,6.91433259111684
"51","117","050","Mecklenburg County",30319,30710,33675,391,1.28962037006498,1.28962037006498,3356,11.068966654573,11.068966654573
"51","119","050","Middlesex County",10625,10575,11348,-50,-0.470588235294118,0.470588235294118,723,6.80470588235294,6.80470588235294
"51","121","050","Montgomery County",99721,98560,101354,-1161,-1.16424825262482,1.16424825262482,1633,1.63756881699943,1.63756881699943
"51","125","050","Nelson County",14775,14797,15531,22,0.148900169204738,0.148900169204738,756,5.11675126903553,5.11675126903553
"51","127","050","New Kent County",22945,23500,22959,555,2.41882763129222,2.41882763129222,14,0.0610154717803443,0.0610154717803443
"51","131","050","Northampton County",12282,11730,12693,-552,-4.49438202247191,4.49438202247191,411,3.34636052760137,3.34636052760137
"51","133","050","Northumberland County",11839,12077,12864,238,2.0103049244024,2.0103049244024,1025,8.65782582988428,8.65782582988428
"51","135","050","Nottoway County",15642,15179,16371,-463,-2.95997954225802,2.95997954225802,729,4.66052934407365,4.66052934407365
"51","137","050","Orange County",36254,37535,35625,1281,3.5334032106802,3.5334032106802,-629,-1.73498096761737,1.73498096761737
"51","139","050","Page County",23709,23945,24562,236,0.995402589733856,0.995402589733856,853,3.59778986882618,3.59778986882618
"51","141","050","Patrick County",17608,17533,18830,-75,-0.425942753293957,0.425942753293957,1222,6.94002726033621,6.94002726033621
"51","143","050","Pittsylvania County",60501,60032,64216,-469,-0.775193798449612,0.775193798449612,3715,6.14039437364672,6.14039437364672
"51","145","050","Powhatan County",30333,30033,31982,-300,-0.989021857383048,0.989021857383048,1649,5.43632347608215,5.43632347608215
"51","147","050","Prince Edward County",21849,22975,24336,1126,5.15355393839535,5.15355393839535,2487,11.3826719758341,11.3826719758341
"51","149","050","Prince George County",43010,38663,37515,-4347,-10.1069518716578,10.1069518716578,-5495,-12.7760985817252,12.7760985817252
"51","153","050","Prince William County",482204,474887,447625,-7317,-1.51740757023998,1.51740757023998,-34579,-7.17103134772835,7.17103134772835
"51","155","050","Pulaski County",33800,33976,35025,176,0.520710059171598,0.520710059171598,1225,3.62426035502959,3.62426035502959
"51","157","050","Rappahannock County",7348,7304,7717,-44,-0.598802395209581,0.598802395209581,369,5.02177463255308,5.02177463255308
"51","159","050","Richmond County",8923,9077,9603,154,1.72587694721506,1.72587694721506,680,7.62075535133923,7.62075535133923
"51","161","050","Roanoke County",96929,94525,94931,-2404,-2.4801658946239,2.4801658946239,-1998,-2.06130260293617,2.06130260293617
"51","163","050","Rockbridge County",22650,22772,23162,122,0.538631346578366,0.538631346578366,512,2.26048565121413,2.26048565121413
"51","165","050","Rockingham County",83757,82335,82333,-1422,-1.69776854471865,1.69776854471865,-1424,-1.7001564048378,1.7001564048378
"51","167","050","Russell County",25781,26679,28983,898,3.48318529149374,3.48318529149374,3202,12.4199992242349,12.4199992242349
"51","169","050","Scott County",21576,21615,23232,39,0.180756395995551,0.180756395995551,1656,7.67519466073415,7.67519466073415
"51","171","050","Shenandoah County",44186,43853,43015,-333,-0.753632372244602,0.753632372244602,-1171,-2.65016068437967,2.65016068437967
"51","173","050","Smyth County",29800,30120,31998,320,1.0738255033557,1.0738255033557,2198,7.3758389261745,7.3758389261745
"51","175","050","Southampton County",17996,17687,19107,-309,-1.71704823294065,1.71704823294065,1111,6.17359413202934,6.17359413202934
"51","177","050","Spotsylvania County",140032,138009,136961,-2023,-1.44466978976234,1.44466978976234,-3071,-2.19307015539305,2.19307015539305
"51","179","050","Stafford County",156927,156063,152550,-864,-0.550574470932344,0.550574470932344,-4377,-2.78919497600795,2.78919497600795
"51","181","050","Surry County",6561,6380,7441,-181,-2.75872580399329,2.75872580399329,880,13.4125895442768,13.4125895442768
"51","183","050","Sussex County",10829,10969,12490,140,1.29282482223659,1.29282482223659,1661,15.3384430695355,15.3384430695355
"51","185","050","Tazewell County",40429,40583,44753,154,0.380914689950283,0.380914689950283,4324,10.6952929827599,10.6952929827599
"51","187","050","Warren County",40727,40426,39118,-301,-0.739067449112382,0.739067449112382,-1609,-3.95069609841137,3.95069609841137
"51","191","050","Washington County",53935,53747,55806,-188,-0.34856772040419,0.34856772040419,1871,3.46899045146936,3.46899045146936
"51","193","050","Westmoreland County",18477,18121,18276,-356,-1.92671970557991,1.92671970557991,-201,-1.08783893489203,1.08783893489203
"51","195","050","Wise County",36130,37263,41394,1133,3.13589814558539,3.13589814558539,5264,14.5696097425962,14.5696097425962
"51","197","050","Wythe County",28290,28610,29991,320,1.13114174620007,1.13114174620007,1701,6.01272534464475,6.01272534464475
"51","199","050","York County",70045,69075,70061,-970,-1.38482404168749,1.38482404168749,16,0.0228424584195874,0.0228424584195874
"51","510","050","Alexandria city",159467,158872,147561,-595,-0.373117949168166,0.373117949168166,-11906,-7.46612151730452,7.46612151730452
"51","520","050","Bristol city",17219,17250,17534,31,0.18003368372147,0.18003368372147,315,1.82937452813752,1.82937452813752
"51","530","050","Buena Vista city",6641,6420,6452,-221,-3.3278120764945,3.3278120764945,-189,-2.84595693419666,2.84595693419666
"51","540","050","Charlottesville city",46553,47053,47323,500,1.07404463729513,1.07404463729513,770,1.65402874143449,1.65402874143449
"51","550","050","Chesapeake city",249422,246720,248944,-2702,-1.08330460023574,1.08330460023574,-478,-0.191643078798181,0.191643078798181
"51","570","050","Colonial Heights city",18170,17178,17098,-992,-5.45954870665933,5.45954870665933,-1072,-5.89983489268024,5.89983489268024
"51","580","050","Covington city",5737,5634,5772,-103,-1.7953634303643,1.7953634303643,35,0.610074952065539,0.610074952065539
"51","590","050","Danville city",42590,39923,41987,-2667,-6.2620333411599,6.2620333411599,-603,-1.41582531110589,1.41582531110589
"51","595","050","Emporia city",5766,5284,5992,-482,-8.3593479014915,8.3593479014915,226,3.91952826916407,3.91952826916407
"51","600","050","Fairfax city",24146,23394,23576,-752,-3.11438747618653,3.11438747618653,-570,-2.36063944338607,2.36063944338607
"51","610","050","Falls Church city",14658,14598,14100,-60,-0.409332787556283,0.409332787556283,-558,-3.80679492427343,3.80679492427343
"51","620","050","Franklin city",8180,7836,8466,-344,-4.20537897310513,4.20537897310513,286,3.49633251833741,3.49633251833741
"51","630","050","Fredericksburg city",27982,29451,28454,1469,5.24980344507183,5.24980344507183,472,1.68679865627904,1.68679865627904
"51","640","050","Galax city",6720,6296,6859,-424,-6.30952380952381,6.30952380952381,139,2.06845238095238,2.06845238095238
"51","650","050","Hampton city",137148,135430,138787,-1718,-1.25266135853239,1.25266135853239,1639,1.19505935194097,1.19505935194097
"51","660","050","Harrisonburg city",51814,53284,51570,1470,2.83707106187517,2.83707106187517,-244,-0.470915196664994,0.470915196664994
"51","670","050","Hopewell city",23033,22385,23261,-648,-2.81335475187774,2.81335475187774,228,0.98988407936439,0.98988407936439
"51","678","050","Lexington city",7320,7270,7037,-50,-0.683060109289617,0.683060109289617,-283,-3.86612021857924,3.86612021857924
"51","680","050","Lynchburg city",79009,81635,77245,2626,3.32367198673569,3.32367198673569,-1764,-2.2326570390715,2.2326570390715
"51","683","050","Manassas city",42772,40899,40344,-1873,-4.37903301225101,4.37903301225101,-2428,-5.67661086692229,5.67661086692229
"51","685","050","Manassas Park city",17219,18001,14130,782,4.54149486032871,4.54149486032871,-3089,-17.9394854521168,17.9394854521168
"51","690","050","Martinsville city",13485,12368,13479,-1117,-8.28327771598072,8.28327771598072,-6,-0.0444938820912125,0.0444938820912125
"51","700","050","Newport News city",186247,179309,184765,-6938,-3.72516067372897,3.72516067372897,-1482,-0.795717514912992,0.795717514912992
"51","710","050","Norfolk city",238005,243089,252533,5084,2.13608957795004,2.13608957795004,14528,6.10407344383521,6.10407344383521
"51","720","050","Norton city",3687,3976,3951,289,7.83835096284242,7.83835096284242,264,7.16029292107404,7.16029292107404
"51","730","050","Petersburg city",33458,30465,32312,-2993,-8.94554366668659,8.94554366668659,-1146,-3.42518979018471,3.42518979018471
"51","735","050","Poquoson city",12460,12246,12501,-214,-1.71749598715891,1.71749598715891,41,0.329052969502408,0.329052969502408
"51","740","050","Portsmouth city",97915,94993,95686,-2922,-2.98422100801716,2.98422100801716,-2229,-2.27646428024307,2.27646428024307
"51","750","050","Radford city",16070,18214,16650,2144,13.3416303671437,13.3416303671437,580,3.60920970752956,3.60920970752956
"51","760","050","Richmond city",226610,232056,211630,5446,2.40324787079123,2.40324787079123,-14980,-6.61047614844888,6.61047614844888
"51","770","050","Roanoke city",100011,99138,96168,-873,-0.872903980562138,0.872903980562138,-3843,-3.84257731649519,3.84257731649519
"51","775","050","Salem city",25346,25306,24804,-40,-0.157815828927641,0.157815828927641,-542,-2.13840448196954,2.13840448196954
"51","790","050","Staunton city",25750,25120,23978,-630,-2.44660194174757,2.44660194174757,-1772,-6.88155339805825,6.88155339805825
"51","800","050","Suffolk city",94324,93537,98439,-787,-0.834358169712904,0.834358169712904,4115,4.36262245027777,4.36262245027777
"51","810","050","Virginia Beach city",459470,451340,460900,-8130,-1.76942999542952,1.76942999542952,1430,0.311228154177639,0.311228154177639
"51","820","050","Waynesboro city",22196,22621,21997,425,1.91475941611101,1.91475941611101,-199,-0.896557938367273,0.896557938367273
"51","830","050","Williamsburg city",15425,15185,14796,-240,-1.55591572123177,1.55591572123177,-629,-4.07779578606159,4.07779578606159
"51","840","050","Winchester city",28120,27781,26702,-339,-1.20554765291607,1.20554765291607,-1418,-5.04267425320057,5.04267425320057
"53","001","050","Adams County",20613,20052,20342,-561,-2.72158346674429,2.72158346674429,-271,-1.3147043128123,1.3147043128123
"53","003","050","Asotin County",22285,22812,22306,527,2.36481938523671,2.36481938523671,21,0.0942337895445367,0.0942337895445367
"53","005","050","Benton County",206873,206007,203666,-866,-0.418614318929972,0.418614318929972,-3207,-1.55022646744621,1.55022646744621
"53","007","050","Chelan County",79074,77498,79909,-1576,-1.99306978273516,1.99306978273516,835,1.05597288615727,1.05597288615727
"53","009","050","Clallam County",77155,77979,76148,824,1.06798004017886,1.06798004017886,-1007,-1.30516492774286,1.30516492774286
"53","011","050","Clark County",503311,495223,490623,-8088,-1.6069587193604,1.6069587193604,-12688,-2.520906556781,2.520906556781
"53","013","050","Columbia County",3952,4045,4162,93,2.35323886639676,2.35323886639676,210,5.31376518218624,5.31376518218624
"53","015","050","Cowlitz County",110730,111187,107327,457,0.412715614557934,0.412715614557934,-3403,-3.0732412173756,3.0732412173756
"53","017","050","Douglas County",42938,43538,42435,600,1.39736364059807,1.39736364059807,-503,-1.17145651870138,1.17145651870138
"53","019","050","Ferry County",7178,7763,7815,585,8.14990247979939,8.14990247979939,637,8.87433825578156,8.87433825578156
"53","021","050","Franklin County",96749,96749,95208,0,0,0,-1541,-1.59278132073717,1.59278132073717
"53","023","050","Garfield County",2286,2294,2303,8,0.349956255468067,0.349956255468067,17,0.743657042869641,0.743657042869641
"53","025","050","Grant County",99123,99107,99219,-16,-0.0161415614943051,0.0161415614943051,96,0.0968493689658303,0.0968493689658303
"53","027","050","Grays Harbor County",75636,75781,76955,145,0.191707652440637,0.191707652440637,1319,1.74387857633931,1.74387857633931
"53","029","050","Island County",86857,85923,83763,-934,-1.07533071600447,1.07533071600447,-3094,-3.56217691147518,3.56217691147518
"53","031","050","Jefferson County",32977,32659,32113,-318,-0.96430845740971,0.96430845740971,-864,-2.62000788428299,2.62000788428299
"53","033","050","King County",2269675,2269880,2229511,205,0.00903213015079251,0.00903213015079251,-40164,-1.76959256281186,1.76959256281186
"53","035","050","Kitsap County",275611,272796,270688,-2815,-1.02136707170614,1.02136707170614,-4923,-1.78621317726796,1.78621317726796
"53","037","050","Kittitas County",44337,48899,46898,4562,10.2893745630061,10.2893745630061,2561,5.77621399733857,5.77621399733857
"53","039","050","Klickitat County",22735,22641,22513,-94,-0.413459423795909,0.413459423795909,-222,-0.976468000879701,0.976468000879701
"53","041","050","Lewis County",82149,81766,79592,-383,-0.466226003968399,0.466226003968399,-2557,-3.11263679411801,3.11263679411801
"53","043","050","Lincoln County",10876,11064,11341,188,1.7285766826039,1.7285766826039,465,4.27546892239794,4.27546892239794
"53","045","050","Mason County",65726,67929,63903,2203,3.35179381066853,3.35179381066853,-1823,-2.77363600401668,2.77363600401668
"53","047","050","Okanogan County",42104,42601,43602,497,1.18041041231237,1.18041041231237,1498,3.55785673570207,3.55785673570207
"53","049","050","Pacific County",23365,22873,22191,-492,-2.10571367429917,2.10571367429917,-1174,-5.02460945859191,5.02460945859191
"53","051","050","Pend Oreille County",13401,14039,13776,638,4.76083874337736,4.76083874337736,375,2.79829863443027,2.79829863443027
"53","053","050","Pierce County",921130,912328,878480,-8802,-0.955565446788184,0.955565446788184,-42650,-4.630182493242,4.630182493242
"53","055","050","San Juan County",17788,17457,17148,-331,-1.86080503710367,1.86080503710367,-640,-3.597931189566,3.597931189566
"53","057","050","Skagit County",129523,130439,125592,916,0.707210302417331,0.707210302417331,-3931,-3.03498220393289,3.03498220393289
"53","059","050","Skamania County",12036,12095,11886,59,0.490196078431373,0.490196078431373,-150,-1.24626121635095,1.24626121635095
"53","061","050","Snohomish County",827957,828858,799920,901,0.108822076508804,0.108822076508804,-28037,-3.38628696900926,3.38628696900926
"53","063","050","Spokane County",539339,526920,527289,-12419,-2.30263340867247,2.30263340867247,-12050,-2.23421632776417,2.23421632776417
"53","065","050","Stevens County",46445,46241,45933,-204,-0.439229195823017,0.439229195823017,-512,-1.10237915814404,1.10237915814404
"53","067","050","Thurston County",294793,293104,281828,-1689,-0.572944405057108,0.572944405057108,-12965,-4.39800130939337,4.39800130939337
"53","069","050","Wahkiakum County",4422,4483,4216,61,1.37946630483944,1.37946630483944,-206,-4.65852555404794,4.65852555404794
"53","071","050","Walla Walla County",62584,61259,63258,-1325,-2.11715454429247,2.11715454429247,674,1.07695257573821,1.07695257573821
"53","073","050","Whatcom County",226847,230501,223422,3654,1.61077730805345,1.61077730805345,-3425,-1.50982821020335,1.50982821020335
"53","075","050","Whitman County",47973,49664,49994,1691,3.52489942259187,3.52489942259187,2021,4.2127863589936,4.2127863589936
"53","077","050","Yakima County",256728,251925,257750,-4803,-1.87085164064691,1.87085164064691,1022,0.398086690972547,0.398086690972547
"54","001","050","Barbour County",15465,16474,16753,1009,6.52440995796961,6.52440995796961,1288,8.32848367280957,8.32848367280957
"54","003","050","Berkeley County",122076,121579,119232,-497,-0.407123431305089,0.407123431305089,-2844,-2.3296962547921,2.3296962547921
"54","005","050","Boone County",21809,21161,24922,-648,-2.97125040121051,2.97125040121051,3113,14.273923609519,14.273923609519
"54","007","050","Braxton County",12447,13777,14550,1330,10.6853056961517,10.6853056961517,2103,16.8956375030128,16.8956375030128
"54","009","050","Brooke County",22559,21769,23546,-790,-3.50192827696263,3.50192827696263,987,4.37519393590141,4.37519393590141
"54","011","050","Cabell County",94350,91745,96567,-2605,-2.76099629040806,2.76099629040806,2217,2.34976152623211,2.34976152623211
"54","013","050","Calhoun County",6229,6987,7719,758,12.1688874618719,12.1688874618719,1490,23.9203724514368,23.9203724514368
"54","015","050","Clay County",8051,8404,9595,353,4.38454850329152,4.38454850329152,1544,19.1777418954167,19.1777418954167
"54","017","050","Doddridge County",7808,8395,8120,587,7.51793032786885,7.51793032786885,312,3.99590163934426,3.99590163934426
"54","019","050","Fayette County",40488,42210,45600,1722,4.25311203319502,4.25311203319502,5112,12.6259632483699,12.6259632483699
"54","021","050","Gilmer County",7408,7848,9189,440,5.93952483801296,5.93952483801296,1781,24.0415766738661,24.0415766738661
"54","023","050","Grant County",10976,11516,12754,540,4.9198250728863,4.9198250728863,1778,16.1989795918367,16.1989795918367
"54","025","050","Greenbrier County",32977,34442,36203,1465,4.44249022045668,4.44249022045668,3226,9.7825757346029,9.7825757346029
"54","027","050","Hampshire County",23093,23207,24759,114,0.493656086259906,0.493656086259906,1666,7.21430736586845,7.21430736586845
"54","029","050","Hancock County",29095,28681,30134,-414,-1.42292490118577,1.42292490118577,1039,3.57106031964255,3.57106031964255
"54","031","050","Hardy County",14299,13709,14635,-590,-4.12616266871809,4.12616266871809,336,2.34981467235471,2.34981467235471
"54","033","050","Harrison County",65921,67008,69819,1087,1.64894343229017,1.64894343229017,3898,5.91313845360356,5.91313845360356
"54","035","050","Jackson County",27791,28534,29393,743,2.67352740095714,2.67352740095714,1602,5.76445611888741,5.76445611888741
"54","037","050","Jefferson County",57701,57486,57502,-215,-0.372610526680647,0.372610526680647,-199,-0.344881371206738,0.344881371206738
"54","039","050","Kanawha County",180745,176887,192143,-3858,-2.13449887963706,2.13449887963706,11398,6.30612188442281,6.30612188442281
"54","041","050","Lewis County",17033,15843,16377,-1190,-6.98643809076499,6.98643809076499,-656,-3.85134738448893,3.85134738448893
"54","043","050","Lincoln County",20463,20161,21964,-302,-1.47583443287885,1.47583443287885,1501,7.33519034354689,7.33519034354689
"54","045","050","Logan County",32567,31770,37040,-797,-2.44726256640157,2.44726256640157,4473,13.7347621825775,13.7347621825775
"54","047","050","McDowell County",19111,17103,21805,-2008,-10.5070378316153,10.5070378316153,2694,14.0965935848464,14.0965935848464
"54","049","050","Marion County",56205,56017,56282,-188,-0.334489814073481,0.334489814073481,77,0.136998487679032,0.136998487679032
"54","051","050","Marshall County",30591,30226,32650,-365,-1.19316138733614,1.19316138733614,2059,6.73073779869896,6.73073779869896
"54","053","050","Mason County",25453,26412,27516,959,3.76772875496012,3.76772875496012,2063,8.10513495462225,8.10513495462225
"54","055","050","Mercer County",59664,58406,62023,-1258,-2.10847412174846,2.10847412174846,2359,3.95380799141861,3.95380799141861
"54","057","050","Mineral County",26938,26769,28433,-169,-0.627366545400549,0.627366545400549,1495,5.54978097854332,5.54978097854332
"54","059","050","Mingo County",23568,23047,27286,-521,-2.21062457569586,2.21062457569586,3718,15.775627970129,15.775627970129
"54","061","050","Monongalia County",105822,106717,100574,895,0.84575986089849,0.84575986089849,-5248,-4.959271229045,4.959271229045
"54","063","050","Monroe County",12376,13255,13578,879,7.10245636716225,7.10245636716225,1202,9.71234647705236,9.71234647705236
"54","065","050","Morgan County",17063,17875,18082,812,4.75883490593682,4.75883490593682,1019,5.97198616890348,5.97198616890348
"54","067","050","Nicholas County",24604,24391,26422,-213,-0.865712892212648,0.865712892212648,1818,7.38904243212486,7.38904243212486
"54","069","050","Ohio County",42425,41297,43635,-1128,-2.65880966411314,2.65880966411314,1210,2.85209192692988,2.85209192692988
"54","071","050","Pendleton County",6143,6933,7852,790,12.8601660426502,12.8601660426502,1709,27.8202832492268,27.8202832492268
"54","073","050","Pleasants County",7653,7431,7654,-222,-2.90082320658565,2.90082320658565,1,0.0130667712008363,0.0130667712008363
"54","075","050","Pocahontas County",7869,8208,8816,339,4.3080442241708,4.3080442241708,947,12.0345660185538,12.0345660185538
"54","077","050","Preston County",34216,33419,33686,-797,-2.32931961655366,2.32931961655366,-530,-1.54898293196166,1.54898293196166
"54","079","050","Putnam County",57440,56439,57697,-1001,-1.74268802228412,1.74268802228412,257,0.447423398328691,0.447423398328691
"54","081","050","Raleigh County",74591,73127,79264,-1464,-1.96270327519406,1.96270327519406,4673,6.26483087771983,6.26483087771983
"54","083","050","Randolph County",27932,28451,29601,519,1.85808391808678,1.85808391808678,1669,5.97522554775884,5.97522554775884
"54","085","050","Ritchie County",8444,9533,10662,1089,12.8967314069162,12.8967314069162,2218,26.2671719564188,26.2671719564188
"54","087","050","Roane County",14028,13515,15074,-513,-3.65697177074423,3.65697177074423,1046,7.45651554034788,7.45651554034788
"54","089","050","Summers County",11959,12455,14002,496,4.14750397190401,4.14750397190401,2043,17.0833681745965,17.0833681745965
"54","091","050","Taylor County",16705,16685,16807,-20,-0.11972463334331,0.11972463334331,102,0.610595630050883,0.610595630050883
"54","093","050","Tucker County",6762,6835,7158,73,1.07956225968648,1.07956225968648,396,5.85625554569654,5.85625554569654
"54","095","050","Tyler County",8313,8550,9288,237,2.85095633345363,2.85095633345363,975,11.7286178274991,11.7286178274991
"54","097","050","Upshur County",23816,24225,25095,409,1.71733288545516,1.71733288545516,1279,5.37033926771918,5.37033926771918
"54","099","050","Wayne County",38982,39169,42783,187,0.479708583448771,0.479708583448771,3801,9.75065414806834,9.75065414806834
"54","101","050","Webster County",8378,8088,9205,-290,-3.46144664597756,3.46144664597756,827,9.87109095249463,9.87109095249463
"54","103","050","Wetzel County",14442,14949,16710,507,3.51059410054009,3.51059410054009,2268,15.7041960947237,15.7041960947237
"54","105","050","Wirt County",5194,5720,5903,526,10.1270696958029,10.1270696958029,709,13.6503658067,13.6503658067
"54","107","050","Wood County",84296,83111,87140,-1185,-1.40576065293727,1.40576065293727,2844,3.37382556704944,3.37382556704944
"54","109","050","Wyoming County",21382,20199,23637,-1183,-5.53269104854551,5.53269104854551,2255,10.5462538583856,10.5462538583856
"55","001","050","Adams County",20654,20498,21479,-156,-0.755301636486879,0.755301636486879,825,3.99438365449792,3.99438365449792
"55","003","050","Ashland County",16027,15461,16135,-566,-3.53154052536345,3.53154052536345,108,0.673862856429775,0.673862856429775
"55","005","050","Barron County",46711,45176,47616,-1535,-3.28616385862003,3.28616385862003,905,1.93744514140138,1.93744514140138
"55","007","050","Bayfield County",16220,15262,15671,-958,-5.90628853267571,5.90628853267571,-549,-3.38471023427867,3.38471023427867
"55","009","050","Brown County",268740,264607,265632,-4133,-1.53791768996056,1.53791768996056,-3108,-1.15650814914043,1.15650814914043
"55","011","050","Buffalo County",13317,13042,14006,-275,-2.06502966133514,2.06502966133514,689,5.17383795149058,5.17383795149058
"55","013","050","Burnett County",16526,15558,16034,-968,-5.85743676630764,5.85743676630764,-492,-2.97712695147041,2.97712695147041
"55","015","050","Calumet County",52442,50256,52775,-2186,-4.16841462949544,4.16841462949544,333,0.634987223980779,0.634987223980779
"55","017","050","Chippewa County",66297,64794,66794,-1503,-2.26707090818589,2.26707090818589,497,0.749656847217823,0.749656847217823
"55","019","050","Clark County",34659,34777,35128,118,0.340459909403041,0.340459909403041,469,1.35318387720361,1.35318387720361
"55","021","050","Columbia County",58490,57694,59031,-796,-1.36091639596512,1.36091639596512,541,0.924944434946145,0.924944434946145
"55","023","050","Crawford County",16113,16058,17080,-55,-0.341339291255508,0.341339291255508,967,6.00136535716502,6.00136535716502
"55","025","050","Dane County",561504,551616,546507,-9888,-1.76098478372371,1.76098478372371,-14997,-2.67086254060523,2.67086254060523
"55","027","050","Dodge County",89396,87467,91620,-1929,-2.15781466732292,2.15781466732292,2224,2.4878070607186,2.4878070607186
"55","029","050","Door County",30066,27881,29321,-2185,-7.26734517395064,7.26734517395064,-745,-2.47788199294885,2.47788199294885
"55","031","050","Douglas County",44295,43681,45123,-614,-1.38616096624901,1.38616096624901,828,1.86928547240095,1.86928547240095
"55","033","050","Dunn County",45440,45490,45733,50,0.110035211267606,0.110035211267606,293,0.644806338028169,0.644806338028169
"55","035","050","Eau Claire County",105710,105132,105703,-578,-0.54677892346987,0.54677892346987,-7,-0.00662189007662473,0.00662189007662473
"55","037","050","Florence County",4558,4308,4574,-250,-5.48486178148311,5.48486178148311,16,0.351031154014919,0.351031154014919
"55","039","050","Fond du Lac County",104154,103012,105778,-1142,-1.09645332872477,1.09645332872477,1624,1.55922960231964,1.55922960231964
"55","041","050","Forest County",9179,8980,9648,-199,-2.16799215600828,2.16799215600828,469,5.10948905109489,5.10948905109489
"55","043","050","Grant County",51938,51167,52924,-771,-1.48446224344411,1.48446224344411,986,1.89841734375602,1.89841734375602
"55","045","050","Green County",37093,36691,37631,-402,-1.08376243496077,1.08376243496077,538,1.45040843285795,1.45040843285795
"55","047","050","Green Lake County",19018,18926,19380,-92,-0.483752234724997,0.483752234724997,362,1.90345988011358,1.90345988011358
"55","049","050","Iowa County",23709,23662,24369,-47,-0.198236956430048,0.198236956430048,660,2.7837530051879,2.7837530051879
"55","051","050","Iron County",6137,5712,6056,-425,-6.92520775623269,6.92520775623269,-81,-1.31986312530552,1.31986312530552
"55","053","050","Jackson County",21145,20657,21063,-488,-2.30787420193899,2.30787420193899,-82,-0.387798533932372,0.387798533932372
"55","055","050","Jefferson County",84900,85026,86442,126,0.148409893992933,0.148409893992933,1542,1.81625441696113,1.81625441696113
"55","057","050","Juneau County",26718,26869,28086,151,0.56516206302867,0.56516206302867,1368,5.12014372333258,5.12014372333258
"55","059","050","Kenosha County",169151,169794,171293,643,0.380133726670253,0.380133726670253,2142,1.26632417189375,1.26632417189375
"55","061","050","Kewaunee County",20563,20404,21020,-159,-0.773233477605408,0.773233477605408,457,2.22243836016145,2.22243836016145
"55","063","050","La Crosse County",120784,118479,121641,-2305,-1.9083653464035,1.9083653464035,857,0.709531063717049,0.709531063717049
"55","065","050","Lafayette County",16611,16659,17107,48,0.288965143579556,0.288965143579556,496,2.98597315032208,2.98597315032208
"55","067","050","Langlade County",19491,19162,20457,-329,-1.68795854496947,1.68795854496947,966,4.95613360012313,4.95613360012313
"55","069","050","Lincoln County",28415,27574,29764,-841,-2.95970438148865,2.95970438148865,1349,4.74749252155552,4.74749252155552
"55","071","050","Manitowoc County",81359,78810,82506,-2549,-3.13302769208078,3.13302769208078,1147,1.40980100542042,1.40980100542042
"55","073","050","Marathon County",138013,135700,139917,-2313,-1.67592907914472,1.67592907914472,1904,1.37958018447538,1.37958018447538
"55","075","050","Marinette County",41872,40277,42653,-1595,-3.80922812380588,3.80922812380588,781,1.86520825372564,1.86520825372564
"55","077","050","Marquette County",15592,15573,15671,-19,-0.121857362750128,0.121857362750128,79,0.506670087224218,0.506670087224218
"55","078","050","Menominee County",4255,4553,4332,298,7.00352526439483,7.00352526439483,77,1.8096357226792,1.8096357226792
"55","079","050","Milwaukee County",939489,946092,951910,6603,0.702828878251901,0.702828878251901,12421,1.32210169570905,1.32210169570905
"55","081","050","Monroe County",46274,46623,46901,349,0.75420322427281,0.75420322427281,627,1.35497255478238,1.35497255478238
"55","083","050","Oconto County",38965,38311,39345,-654,-1.67842935968177,1.67842935968177,380,0.975234184524573,0.975234184524573
"55","085","050","Oneida County",37845,35727,37658,-2118,-5.59651208878319,5.59651208878319,-187,-0.494120755714097,0.494120755714097
"55","087","050","Outagamie County",190705,188621,189457,-2084,-1.09278728926877,1.09278728926877,-1248,-0.654413885320259,0.654413885320259
"55","089","050","Ozaukee County",91503,89975,91200,-1528,-1.66989060467963,1.66989060467963,-303,-0.331136684043146,0.331136684043146
"55","091","050","Pepin County",7318,7257,7749,-61,-0.833561082262913,0.833561082262913,431,5.8895873189396,5.8895873189396
"55","093","050","Pierce County",42212,42704,43145,492,1.16554534255662,1.16554534255662,933,2.21027196057993,2.21027196057993
"55","095","050","Polk County",44977,43763,45768,-1214,-2.69915734708851,2.69915734708851,791,1.758676656958,1.758676656958
"55","097","050","Portage County",70377,71035,73343,658,0.934964548076787,0.934964548076787,2966,4.21444506017591,4.21444506017591
"55","099","050","Price County",14054,13268,14631,-786,-5.59271381813007,5.59271381813007,577,4.10559271381813,4.10559271381813
"55","101","050","Racine County",197727,195982,198088,-1745,-0.882529952914878,0.882529952914878,361,0.182574964471215,0.182574964471215
"55","103","050","Richland County",17304,17273,18434,-31,-0.179149329634767,0.179149329634767,1130,6.53028201571891,6.53028201571891
"55","105","050","Rock County",163687,163140,163633,-547,-0.334174369375699,0.334174369375699,-54,-0.0329897914922993,0.0329897914922993
"55","107","050","Rusk County",14188,14033,15537,-155,-1.09247251198196,1.09247251198196,1349,9.50803495912038,9.50803495912038
"55","109","050","St. Croix County",93536,91555,92460,-1981,-2.11790112897708,2.11790112897708,-1076,-1.15035921997947,1.15035921997947
"55","111","050","Sauk County",65763,64450,64308,-1313,-1.99656341711905,1.99656341711905,-1455,-2.21249030609917,2.21249030609917
"55","113","050","Sawyer County",18074,16656,17370,-1418,-7.8455239570654,7.8455239570654,-704,-3.89509793072922,3.89509793072922
"55","115","050","Shawano County",40881,40784,42556,-97,-0.237274039284753,0.237274039284753,1675,4.09725789486559,4.09725789486559
"55","117","050","Sheboygan County",118034,115262,117197,-2772,-2.34847586288697,2.34847586288697,-837,-0.709117711845739,0.709117711845739
"55","119","050","Taylor County",19913,20310,21098,397,1.99367247526741,1.99367247526741,1185,5.95088635564707,5.95088635564707
"55","121","050","Trempealeau County",30760,29644,30660,-1116,-3.62808842652796,3.62808842652796,-100,-0.325097529258778,0.325097529258778
"55","123","050","Vernon County",30714,30869,31078,155,0.504655857263788,0.504655857263788,364,1.1851273035098,1.1851273035098
"55","125","050","Vilas County",23047,22297,22609,-750,-3.25421963813078,3.25421963813078,-438,-1.90046426866837,1.90046426866837
"55","127","050","Walworth County",106478,103954,105406,-2524,-2.37044272056199,2.37044272056199,-1072,-1.00678074343996,1.00678074343996
"55","129","050","Washburn County",16623,15718,16499,-905,-5.44426397160561,5.44426397160561,-124,-0.745954400529387,0.745954400529387
"55","131","050","Washington County",136761,136430,139411,-331,-0.242028063556131,0.242028063556131,2650,1.93768691366691,1.93768691366691
"55","133","050","Waukesha County",406978,405937,408552,-1041,-0.255787782140558,0.255787782140558,1574,0.386753092304744,0.386753092304744
"55","135","050","Waupaca County",51812,50705,53771,-1107,-2.13657067860727,2.13657067860727,1959,3.78097737975758,3.78097737975758
"55","137","050","Waushara County",24520,24329,25131,-191,-0.778955954323002,0.778955954323002,611,2.49184339314845,2.49184339314845
"55","139","050","Winnebago County",171730,171695,174231,-35,-0.0203808303732603,0.0203808303732603,2501,1.45635590752926,1.45635590752926
"55","141","050","Wood County",74207,72620,78173,-1587,-2.13861226029889,2.13861226029889,3966,5.34450927810045,5.34450927810045
"56","001","050","Albany County",37066,39005,39749,1939,5.23120919440997,5.23120919440997,2683,7.2384395402795,7.2384395402795
"56","003","050","Big Horn County",11521,11642,11905,121,1.05025605416197,1.05025605416197,384,3.33304400659665,3.33304400659665
"56","005","050","Campbell County",47026,46657,49757,-369,-0.784672308935483,0.784672308935483,2731,5.80742567941139,5.80742567941139
"56","007","050","Carbon County",14537,14769,16410,232,1.59592763293664,1.59592763293664,1873,12.8843640365963,12.8843640365963
"56","009","050","Converse County",13751,13849,14492,98,0.712675441786052,0.712675441786052,741,5.38869900370882,5.38869900370882
"56","011","050","Crook County",7181,7600,7247,419,5.83484194401894,5.83484194401894,66,0.919092048461217,0.919092048461217
"56","013","050","Fremont County",39234,39403,40669,169,0.430748840291584,0.430748840291584,1435,3.65754192791966,3.65754192791966
"56","015","050","Goshen County",12498,13249,13385,751,6.00896143382941,6.00896143382941,887,7.09713554168667,7.09713554168667
"56","017","050","Hot Springs County",4621,4421,4821,-200,-4.32806751785328,4.32806751785328,200,4.32806751785328,4.32806751785328
"56","019","050","Johnson County",8447,8591,8787,144,1.70474724754351,1.70474724754351,340,4.02509766781106,4.02509766781106
"56","021","050","Laramie County",100512,100458,101488,-54,-0.0537249283667622,0.0537249283667622,976,0.971028334925183,0.971028334925183
"56","023","050","Lincoln County",19581,20186,19859,605,3.08972984015117,3.08972984015117,278,1.41974362902814,1.41974362902814
"56","025","050","Natrona County",79955,80568,83639,613,0.766681258207742,0.766681258207742,3684,4.60759177037083,4.60759177037083
"56","027","050","Niobrara County",2467,2294,2543,-173,-7.0125658694771,7.0125658694771,76,3.0806647750304,3.0806647750304
"56","029","050","Park County",29624,29298,30775,-326,-1.10045908722657,1.10045908722657,1151,3.88536321901161,3.88536321901161
"56","031","050","Platte County",8605,8545,9124,-60,-0.697269029633934,0.697269029633934,519,6.03137710633353,6.03137710633353
"56","033","050","Sheridan County",30921,30796,32073,-125,-0.404256007244268,0.404256007244268,1152,3.72562336276317,3.72562336276317
"56","035","050","Sublette County",8728,9852,10881,1124,12.878093492209,12.878093492209,2153,24.6677360219982,24.6677360219982
"56","037","050","Sweetwater County",42272,42717,46663,445,1.05270628311885,1.05270628311885,4391,10.3874905374716,10.3874905374716
"56","039","050","Teton County",23331,23453,23770,122,0.522909433800523,0.522909433800523,439,1.88161673310188,1.88161673310188
"56","041","050","Uinta County",20450,20169,22149,-281,-1.37408312958435,1.37408312958435,1699,8.3080684596577,8.3080684596577
"56","043","050","Washakie County",7685,7756,8606,71,0.92387768379961,0.92387768379961,921,11.9843851659076,11.9843851659076
"56","045","050","Weston County",6838,6752,7283,-86,-1.2576776835332,1.2576776835332,445,6.50775080432875,6.50775080432875
