"STATE","COUNTY","SUMLEV","NAME","CENSUS2020","POPESTIMATE042020","Error","PctError","AbsPctError"
"01","001","050","Autauga County",58805,56130,-2675,-4.54893291386787,4.54893291386787
"01","003","050","Baldwin County",231767,227989,-3778,-1.63008538747967,1.63008538747967
"01","005","050","Barbour County",25223,24652,-571,-2.26380684296079,2.26380684296079
"01","007","050","Bibb County",22293,22199,-94,-0.421657022383708,0.421657022383708
"01","009","050","Blount County",59134,57932,-1202,-2.03267155950891,2.03267155950891
"01","011","050","Bullock County",10357,10050,-307,-2.96417881625953,2.96417881625953
"01","013","050","Butler County",19051,19525,474,2.48805836963939,2.48805836963939
"01","015","050","Calhoun County",116441,113704,-2737,-2.35054662876478,2.35054662876478
"01","017","050","Chambers County",34772,32989,-1783,-5.12768894512826,5.12768894512826
"01","019","050","Cherokee County",24971,26319,1348,5.39826198390133,5.39826198390133
"01","021","050","Chilton County",45014,44417,-597,-1.32625405429422,1.32625405429422
"01","023","050","Choctaw County",12665,12469,-196,-1.54757204895381,1.54757204895381
"01","025","050","Clarke County",23087,23398,311,1.34707844241348,1.34707844241348
"01","027","050","Clay County",14236,13152,-1084,-7.61449845462208,7.61449845462208
"01","029","050","Cleburne County",15056,14976,-80,-0.53134962805526,0.53134962805526
"01","031","050","Coffee County",53465,53160,-305,-0.570466660432058,0.570466660432058
"01","033","050","Colbert County",57227,55402,-1825,-3.18905411781152,3.18905411781152
"01","035","050","Conecuh County",11597,11924,327,2.81969474864189,2.81969474864189
"01","037","050","Coosa County",10387,10681,294,2.83046115336478,2.83046115336478
"01","039","050","Covington County",37570,36993,-577,-1.53579984029811,1.53579984029811
"01","041","050","Crenshaw County",13194,13713,519,3.93360618462938,3.93360618462938
"01","043","050","Cullman County",87866,84344,-3522,-4.00837639132315,4.00837639132315
"01","045","050","Dale County",49326,49076,-250,-0.506832096663017,0.506832096663017
"01","047","050","Dallas County",38462,36424,-2038,-5.29873641516302,5.29873641516302
"01","049","050","DeKalb County",71608,71664,56,0.0782035526756787,0.0782035526756787
"01","051","050","Elmore County",87977,82048,-5929,-6.73926139786535,6.73926139786535
"01","053","050","Escambia County",36757,36361,-396,-1.07734581168213,1.07734581168213
"01","055","050","Etowah County",103436,102482,-954,-0.922309447387757,0.922309447387757
"01","057","050","Fayette County",16321,16246,-75,-0.459530666013112,0.459530666013112
"01","059","050","Franklin County",32113,31541,-572,-1.78121010182792,1.78121010182792
"01","061","050","Geneva County",26659,26402,-257,-0.96402715780787,0.96402715780787
"01","063","050","Greene County",7730,8034,304,3.93272962483829,3.93272962483829
"01","065","050","Hale County",14785,14673,-112,-0.757524518092661,0.757524518092661
"01","067","050","Henry County",17146,17203,57,0.332439052840313,0.332439052840313
"01","069","050","Houston County",107202,106542,-660,-0.615660155594112,0.615660155594112
"01","071","050","Jackson County",52579,51642,-937,-1.78208029821792,1.78208029821792
"01","073","050","Jefferson County",674721,656529,-18192,-2.69622555100553,2.69622555100553
"01","075","050","Lamar County",13972,13790,-182,-1.30260521042084,1.30260521042084
"01","077","050","Lauderdale County",93564,93331,-233,-0.249027403702279,0.249027403702279
"01","079","050","Lawrence County",33073,32863,-210,-0.634959030024491,0.634959030024491
"01","081","050","Lee County",174241,166460,-7781,-4.46565389317095,4.46565389317095
"01","083","050","Limestone County",103570,101485,-2085,-2.01313121560297,2.01313121560297
"01","085","050","Lowndes County",10311,9653,-658,-6.38153428377461,6.38153428377461
"01","087","050","Macon County",19532,17942,-1590,-8.14048740528364,8.14048740528364
"01","089","050","Madison County",388153,377894,-10259,-2.643029939225,2.643029939225
"01","091","050","Marengo County",19323,18793,-530,-2.74284531387466,2.74284531387466
"01","093","050","Marion County",29341,29749,408,1.39054565284073,1.39054565284073
"01","095","050","Marshall County",97612,96951,-661,-0.677170839650863,0.677170839650863
"01","097","050","Mobile County",414809,413119,-1690,-0.407416425390963,0.407416425390963
"01","099","050","Monroe County",19772,20520,748,3.78312765527008,3.78312765527008
"01","101","050","Montgomery County",228954,225131,-3823,-1.66976772626816,1.66976772626816
"01","103","050","Morgan County",123421,119862,-3559,-2.88362596316672,2.88362596316672
"01","105","050","Perry County",8511,8754,243,2.85512865703208,2.85512865703208
"01","107","050","Pickens County",19123,19821,698,3.65005490770277,3.65005490770277
"01","109","050","Pike County",33009,32976,-33,-0.0999727347087158,0.0999727347087158
"01","111","050","Randolph County",21967,22882,915,4.16533891746711,4.16533891746711
"01","113","050","Russell County",59183,58196,-987,-1.66770863254651,1.66770863254651
"01","115","050","St. Clair County",91103,90488,-615,-0.675060096813497,0.675060096813497
"01","117","050","Shelby County",223024,220664,-2360,-1.05818207905876,1.05818207905876
"01","119","050","Sumter County",12345,12263,-82,-0.664236533009316,0.664236533009316
"01","121","050","Talladega County",82149,80075,-2074,-2.52468076300381,2.52468076300381
"01","123","050","Tallapoosa County",41311,40192,-1119,-2.70872164798722,2.70872164798722
"01","125","050","Tuscaloosa County",227036,210736,-16300,-7.17947814443524,7.17947814443524
"01","127","050","Walker County",65342,63277,-2065,-3.16029506289982,3.16029506289982
"01","129","050","Washington County",15388,16050,662,4.30205354821939,4.30205354821939
"01","131","050","Wilcox County",10600,10252,-348,-3.28301886792453,3.28301886792453
"01","133","050","Winston County",23540,23552,12,0.0509770603228547,0.0509770603228547
"02","013","050","Aleutians East Borough",3420,3419,-1,-0.0292397660818713,0.0292397660818713
"02","016","050","Aleutians West Census Area",5232,5719,487,9.30810397553517,9.30810397553517
"02","020","050","Anchorage Municipality",291247,287706,-3541,-1.21580651474522,1.21580651474522
"02","050","050","Bethel Census Area",18666,18487,-179,-0.958962820100718,0.958962820100718
"02","060","050","Bristol Bay Borough",844,823,-21,-2.48815165876777,2.48815165876777
"02","063","050","Chugach Census Area",7102,6464,-638,-8.98338496198254,8.98338496198254
"02","066","050","Copper River Census Area",2617,2921,304,11.616354604509,11.616354604509
"02","068","050","Denali Borough",1619,2099,480,29.6479308214948,29.6479308214948
"02","070","050","Dillingham Census Area",4857,4867,10,0.205888408482602,0.205888408482602
"02","090","050","Fairbanks North Star Borough",95655,96053,398,0.416078615859077,0.416078615859077
"02","100","050","Haines Borough",2080,2589,509,24.4711538461538,24.4711538461538
"02","105","050","Hoonah-Angoon Census Area",2365,2157,-208,-8.79492600422833,8.79492600422833
"02","110","050","Juneau City and Borough",32255,31924,-331,-1.02619748876143,1.02619748876143
"02","122","050","Kenai Peninsula Borough",58799,59300,501,0.852055307063045,0.852055307063045
"02","130","050","Ketchikan Gateway Borough",13948,13795,-153,-1.09693145970748,1.09693145970748
"02","150","050","Kodiak Island Borough",13101,13051,-50,-0.381650255705671,0.381650255705671
"02","158","050","Kusilvak Census Area",8368,8355,-13,-0.155353728489484,0.155353728489484
"02","164","050","Lake and Peninsula Borough",1476,1508,32,2.1680216802168,2.1680216802168
"02","170","050","Matanuska-Susitna Borough",107081,109794,2713,2.53359606279359,2.53359606279359
"02","180","050","Nome Census Area",10046,9941,-105,-1.04519211626518,1.04519211626518
"02","185","050","North Slope Borough",11031,9305,-1726,-15.646813525519,15.646813525519
"02","188","050","Northwest Arctic Borough",7793,7642,-151,-1.9376363403054,1.9376363403054
"02","195","050","Petersburg Borough",3398,3282,-116,-3.41377280753384,3.41377280753384
"02","198","050","Prince of Wales-Hyder Census Area",5753,6158,405,7.03980531896402,7.03980531896402
"02","220","050","Sitka City and Borough",8458,8413,-45,-0.532040671553559,0.532040671553559
"02","230","050","Skagway Municipality",1240,1173,-67,-5.40322580645161,5.40322580645161
"02","240","050","Southeast Fairbanks Census Area",6808,6906,98,1.43948296122209,1.43948296122209
"02","275","050","Wrangell City and Borough",2127,2498,371,17.4424071462153,17.4424071462153
"02","282","050","Yakutat City and Borough",662,609,-53,-8.00604229607251,8.00604229607251
"02","290","050","Yukon-Koyukuk Census Area",5343,5116,-227,-4.24854950402396,4.24854950402396
"04","001","050","Apache County",66021,71929,5908,8.94866784810893,8.94866784810893
"04","003","050","Cochise County",125447,127515,2068,1.64850494631199,1.64850494631199
"04","005","050","Coconino County",145101,142929,-2172,-1.49688837430479,1.49688837430479
"04","007","050","Gila County",53272,54299,1027,1.92784201832107,1.92784201832107
"04","009","050","Graham County",38533,39140,607,1.57527314250123,1.57527314250123
"04","011","050","Greenlee County",9563,9363,-200,-2.09139391404371,2.09139391404371
"04","012","050","La Paz County",16557,21444,4887,29.516216705925,29.516216705925
"04","013","050","Maricopa County",4420568,4560260,139692,3.16004640127694,3.16004640127694
"04","015","050","Mohave County",213267,216539,3272,1.53422704872296,1.53422704872296
"04","017","050","Navajo County",106717,111886,5169,4.84365190175886,4.84365190175886
"04","019","050","Pima County",1043433,1059005,15572,1.49238139870984,1.49238139870984
"04","021","050","Pinal County",425264,476349,51085,12.012538093984,12.012538093984
"04","023","050","Santa Cruz County",47669,46824,-845,-1.77264050011538,1.77264050011538
"04","025","050","Yavapai County",236209,239344,3135,1.3272144583822,1.3272144583822
"04","027","050","Yuma County",203881,217074,13193,6.47093157282925,6.47093157282925
"05","001","050","Arkansas County",17149,17436,287,1.67356697183509,1.67356697183509
"05","003","050","Ashley County",19062,19479,417,2.18759836323576,2.18759836323576
"05","005","050","Baxter County",41627,42249,622,1.49422249981983,1.49422249981983
"05","007","050","Benton County",284333,286700,2367,0.832474598446188,0.832474598446188
"05","009","050","Boone County",37373,37669,296,0.792015626254248,0.792015626254248
"05","011","050","Bradley County",10545,10691,146,1.38454243717402,1.38454243717402
"05","013","050","Calhoun County",4739,5126,387,8.16627980586622,8.16627980586622
"05","015","050","Carroll County",28260,28355,95,0.336164189667374,0.336164189667374
"05","017","050","Chicot County",10208,10008,-200,-1.95924764890282,1.95924764890282
"05","019","050","Clark County",21446,22196,750,3.49715564674065,3.49715564674065
"05","021","050","Clay County",14552,14419,-133,-0.913963716327652,0.913963716327652
"05","023","050","Cleburne County",24711,24987,276,1.11691149690421,1.11691149690421
"05","025","050","Cleveland County",7550,7964,414,5.48344370860927,5.48344370860927
"05","027","050","Columbia County",22801,23391,590,2.58760580676286,2.58760580676286
"05","029","050","Conway County",20715,21029,314,1.51580979966208,1.51580979966208
"05","031","050","Craighead County",111231,111931,700,0.629320962681267,0.629320962681267
"05","033","050","Crawford County",60133,63460,3327,5.53273576904528,5.53273576904528
"05","035","050","Crittenden County",48163,47736,-427,-0.886572680273239,0.886572680273239
"05","037","050","Cross County",16833,16204,-629,-3.73670765757738,3.73670765757738
"05","039","050","Dallas County",6482,6844,362,5.58469608145634,5.58469608145634
"05","041","050","Desha County",11395,11191,-204,-1.79025888547609,1.79025888547609
"05","043","050","Drew County",17350,18028,678,3.90778097982709,3.90778097982709
"05","045","050","Faulkner County",123498,126699,3201,2.59194480882281,2.59194480882281
"05","047","050","Franklin County",17097,17867,770,4.50371410188922,4.50371410188922
"05","049","050","Fulton County",12075,12436,361,2.98964803312629,2.98964803312629
"05","051","050","Garland County",100180,99786,-394,-0.393292074266321,0.393292074266321
"05","053","050","Grant County",17958,18421,463,2.57823811114823,2.57823811114823
"05","055","050","Greene County",45736,45563,-173,-0.378257827531922,0.378257827531922
"05","057","050","Hempstead County",20065,21356,1291,6.43408921006728,6.43408921006728
"05","059","050","Hot Spring County",33040,33817,777,2.35169491525424,2.35169491525424
"05","061","050","Howard County",12785,13145,360,2.81579976535002,2.81579976535002
"05","063","050","Independence County",37938,37814,-124,-0.326849069534504,0.326849069534504
"05","065","050","Izard County",13577,13612,35,0.257788907711571,0.257788907711571
"05","067","050","Jackson County",16755,16686,-69,-0.411817367949866,0.411817367949866
"05","069","050","Jefferson County",67260,65873,-1387,-2.06214689265537,2.06214689265537
"05","071","050","Johnson County",25749,26554,805,3.1263350033011,3.1263350033011
"05","073","050","Lafayette County",6308,6610,302,4.78757133798351,4.78757133798351
"05","075","050","Lawrence County",16216,16431,215,1.32585101134682,1.32585101134682
"05","077","050","Lee County",8600,8607,7,0.0813953488372093,0.0813953488372093
"05","079","050","Lincoln County",12941,12977,36,0.278185611621977,0.278185611621977
"05","081","050","Little River County",12026,12226,200,1.66306336271412,1.66306336271412
"05","083","050","Logan County",21131,21426,295,1.39605319199281,1.39605319199281
"05","085","050","Lonoke County",74015,73896,-119,-0.160778220630953,0.160778220630953
"05","087","050","Madison County",16521,16620,99,0.599237334301798,0.599237334301798
"05","089","050","Marion County",16826,16756,-70,-0.416022821823369,0.416022821823369
"05","091","050","Miller County",42600,43228,628,1.47417840375587,1.47417840375587
"05","093","050","Mississippi County",40685,40244,-441,-1.08393756912867,1.08393756912867
"05","095","050","Monroe County",6799,6625,-174,-2.55919988233564,2.55919988233564
"05","097","050","Montgomery County",8484,9004,520,6.12918434700613,6.12918434700613
"05","099","050","Nevada County",8310,8129,-181,-2.17809867629362,2.17809867629362
"05","101","050","Newton County",7225,7638,413,5.71626297577855,5.71626297577855
"05","103","050","Ouachita County",22650,23233,583,2.57395143487859,2.57395143487859
"05","105","050","Perry County",10019,10352,333,3.32368499850284,3.32368499850284
"05","107","050","Phillips County",16568,17426,858,5.17865765330758,5.17865765330758
"05","109","050","Pike County",10171,10670,499,4.90610559433684,4.90610559433684
"05","111","050","Poinsett County",22965,23334,369,1.60679294578707,1.60679294578707
"05","113","050","Polk County",19221,19763,542,2.81983247489725,2.81983247489725
"05","115","050","Pope County",63381,64295,914,1.44207254540004,1.44207254540004
"05","117","050","Prairie County",8282,8004,-278,-3.35667713112775,3.35667713112775
"05","119","050","Pulaski County",399125,393018,-6107,-1.53009708737864,1.53009708737864
"05","121","050","Randolph County",18571,18233,-338,-1.82004200096925,1.82004200096925
"05","123","050","St. Francis County",23090,24754,1664,7.20658293633608,7.20658293633608
"05","125","050","Saline County",123416,123638,222,0.179879432164387,0.179879432164387
"05","127","050","Scott County",9836,10150,314,3.19235461569744,3.19235461569744
"05","129","050","Searcy County",7828,7838,10,0.127746550843127,0.127746550843127
"05","131","050","Sebastian County",127799,127650,-149,-0.116589331684911,0.116589331684911
"05","133","050","Sevier County",15839,16764,925,5.84001515247175,5.84001515247175
"05","135","050","Sharp County",17271,17372,101,0.584795321637427,0.584795321637427
"05","137","050","Stone County",12359,12655,296,2.39501577797556,2.39501577797556
"05","139","050","Union County",39054,38320,-734,-1.87944896809546,1.87944896809546
"05","141","050","Van Buren County",15796,16534,738,4.67206887819701,4.67206887819701
"05","143","050","Washington County",245871,242313,-3558,-1.44710030869846,1.44710030869846
"05","145","050","White County",76822,78701,1879,2.44591393090521,2.44591393090521
"05","147","050","Woodruff County",6269,6305,36,0.574254267028234,0.574254267028234
"05","149","050","Yell County",20263,21211,948,4.6784780141144,4.6784780141144
"06","001","050","Alameda County",1682353,1665644,-16709,-0.993192272965305,0.993192272965305
"06","003","050","Alpine County",1204,1110,-94,-7.80730897009967,7.80730897009967
"06","005","050","Amador County",40474,40045,-429,-1.05993971438454,1.05993971438454
"06","007","050","Butte County",211632,214384,2752,1.30037045437363,1.30037045437363
"06","009","050","Calaveras County",45292,46296,1004,2.21672701580853,2.21672701580853
"06","011","050","Colusa County",21839,21548,-291,-1.33247859334219,1.33247859334219
"06","013","050","Contra Costa County",1165927,1153445,-12482,-1.07056445214838,1.07056445214838
"06","015","050","Del Norte County",27743,27973,230,0.829037955520311,0.829037955520311
"06","017","050","El Dorado County",191185,193078,1893,0.990140439888067,0.990140439888067
"06","019","050","Fresno County",1008654,1000999,-7655,-0.758932200734841,0.758932200734841
"06","021","050","Glenn County",28917,28342,-575,-1.988449700868,1.988449700868
"06","023","050","Humboldt County",136463,135268,-1195,-0.87569524339931,0.87569524339931
"06","025","050","Imperial County",179702,180476,774,0.43071306941492,0.43071306941492
"06","027","050","Inyo County",19016,18062,-954,-5.01682793437106,5.01682793437106
"06","029","050","Kern County",909235,901373,-7862,-0.864682947752781,0.864682947752781
"06","031","050","Kings County",152486,152804,318,0.208543735162572,0.208543735162572
"06","033","050","Lake County",68163,64521,-3642,-5.34307468861406,5.34307468861406
"06","035","050","Lassen County",32730,30193,-2537,-7.75129850290254,7.75129850290254
"06","037","050","Los Angeles County",10014009,9968969,-45040,-0.449769917322822,0.449769917322822
"06","039","050","Madera County",156255,157606,1351,0.864612332405363,0.864612332405363
"06","041","050","Marin County",262321,257948,-4373,-1.66704152545927,1.66704152545927
"06","043","050","Mariposa County",17131,17182,51,0.297705913256669,0.297705913256669
"06","045","050","Mendocino County",91601,86349,-5252,-5.73356186067838,5.73356186067838
"06","047","050","Merced County",281202,278938,-2264,-0.805115184102531,0.805115184102531
"06","049","050","Modoc County",8700,8798,98,1.1264367816092,1.1264367816092
"06","051","050","Mono County",13195,14512,1317,9.98105342932929,9.98105342932929
"06","053","050","Monterey County",439035,431854,-7181,-1.63563269443211,1.63563269443211
"06","055","050","Napa County",138019,136493,-1526,-1.10564487498098,1.10564487498098
"06","057","050","Nevada County",102241,99675,-2566,-2.50975635997301,2.50975635997301
"06","059","050","Orange County",3186989,3170769,-16220,-0.508944335860588,0.508944335860588
"06","061","050","Placer County",404739,402221,-2518,-0.622129322847564,0.622129322847564
"06","063","050","Plumas County",19790,18991,-799,-4.03739262253664,4.03739262253664
"06","065","050","Riverside County",2418185,2485219,67034,2.77207905929447,2.77207905929447
"06","067","050","Sacramento County",1585055,1558550,-26505,-1.6721817224008,1.6721817224008
"06","069","050","San Benito County",64209,63808,-401,-0.624523041941161,0.624523041941161
"06","071","050","San Bernardino County",2181654,2187894,6240,0.286021523119615,0.286021523119615
"06","073","050","San Diego County",3298634,3334413,35779,1.08466110517263,1.08466110517263
"06","075","050","San Francisco County",873965,870561,-3404,-0.389489281607387,0.389489281607387
"06","077","050","San Joaquin County",779233,767048,-12185,-1.56371714236948,1.56371714236948
"06","079","050","San Luis Obispo County",282424,282577,153,0.054173866243662,0.054173866243662
"06","081","050","San Mateo County",764442,760706,-3736,-0.488722493007972,0.488722493007972
"06","083","050","Santa Barbara County",448229,445285,-2944,-0.656807123144643,0.656807123144643
"06","085","050","Santa Clara County",1936259,1913192,-23067,-1.19131789703753,1.19131789703753
"06","087","050","Santa Cruz County",270861,270819,-42,-0.0155061082990907,0.0155061082990907
"06","089","050","Shasta County",182155,179278,-2877,-1.57942411682358,1.57942411682358
"06","091","050","Sierra County",3236,2933,-303,-9.36341161928306,9.36341161928306
"06","093","050","Siskiyou County",44076,43381,-695,-1.57682185316272,1.57682185316272
"06","095","050","Solano County",453491,447406,-6085,-1.34181273718773,1.34181273718773
"06","097","050","Sonoma County",488863,490747,1884,0.385384044200522,0.385384044200522
"06","099","050","Stanislaus County",552878,550391,-2487,-0.449827990985353,0.449827990985353
"06","101","050","Sutter County",99633,96593,-3040,-3.05119789627935,3.05119789627935
"06","103","050","Tehama County",65829,64698,-1131,-1.71808777286606,1.71808777286606
"06","105","050","Trinity County",16112,12252,-3860,-23.9572989076465,23.9572989076465
"06","107","050","Tulare County",473117,468274,-4843,-1.02363685938151,1.02363685938151
"06","109","050","Tuolumne County",55620,54501,-1119,-2.01186623516721,2.01186623516721
"06","111","050","Ventura County",843843,842692,-1151,-0.136399780527894,0.136399780527894
"06","113","050","Yolo County",216403,220010,3607,1.66679759522742,1.66679759522742
"06","115","050","Yuba County",81575,79800,-1775,-2.17591173766473,2.17591173766473
"08","001","050","Adams County",519572,519385,-187,-0.0359911619563795,0.0359911619563795
"08","003","050","Alamosa County",16376,16226,-150,-0.915974596971177,0.915974596971177
"08","005","050","Arapahoe County",655070,657478,2408,0.367594302898927,0.367594302898927
"08","007","050","Archuleta County",13359,14188,829,6.20555430795718,6.20555430795718
"08","009","050","Baca County",3506,3583,77,2.19623502567028,2.19623502567028
"08","011","050","Bent County",5650,5421,-229,-4.05309734513274,4.05309734513274
"08","013","050","Boulder County",330758,327069,-3689,-1.11531693866815,1.11531693866815
"08","014","050","Broomfield County",74112,71878,-2234,-3.01435664939551,3.01435664939551
"08","015","050","Chaffee County",19476,20622,1146,5.8841651263093,5.8841651263093
"08","017","050","Cheyenne County",1748,1802,54,3.08924485125858,3.08924485125858
"08","019","050","Clear Creek County",9397,9596,199,2.11769713738427,2.11769713738427
"08","021","050","Conejos County",7461,8165,704,9.43573247553947,9.43573247553947
"08","023","050","Costilla County",3499,3935,436,12.4607030580166,12.4607030580166
"08","025","050","Crowley County",5922,5775,-147,-2.4822695035461,2.4822695035461
"08","027","050","Custer County",4704,5176,472,10.0340136054422,10.0340136054422
"08","029","050","Delta County",31196,31103,-93,-0.298115142967047,0.298115142967047
"08","031","050","Denver County",715522,733428,17906,2.50250865801471,2.50250865801471
"08","033","050","Dolores County",2326,2088,-238,-10.2321582115219,10.2321582115219
"08","035","050","Douglas County",357978,358691,713,0.199174250931621,0.199174250931621
"08","037","050","Eagle County",55731,55036,-695,-1.24706177890223,1.24706177890223
"08","039","050","Elbert County",26062,27187,1125,4.31662957562735,4.31662957562735
"08","041","050","El Paso County",730395,727064,-3331,-0.45605460059283,0.45605460059283
"08","043","050","Fremont County",48939,47921,-1018,-2.08014058317497,2.08014058317497
"08","045","050","Garfield County",61685,60329,-1356,-2.19826538056254,2.19826538056254
"08","047","050","Gilpin County",5808,6244,436,7.5068870523416,7.5068870523416
"08","049","050","Grand County",15717,15804,87,0.553540752051918,0.553540752051918
"08","051","050","Gunnison County",16918,17567,649,3.83615084525358,3.83615084525358
"08","053","050","Hinsdale County",788,801,13,1.6497461928934,1.6497461928934
"08","055","050","Huerfano County",6820,6899,79,1.158357771261,1.158357771261
"08","057","050","Jackson County",1379,1390,11,0.797679477882524,0.797679477882524
"08","059","050","Jefferson County",582910,583411,501,0.0859480880410355,0.0859480880410355
"08","061","050","Kiowa County",1446,1445,-1,-0.0691562932226833,0.0691562932226833
"08","063","050","Kit Carson County",7087,7130,43,0.606744743897277,0.606744743897277
"08","065","050","Lake County",7436,8006,570,7.66541151156536,7.66541151156536
"08","067","050","La Plata County",55638,56551,913,1.64096480822459,1.64096480822459
"08","069","050","Larimer County",359066,359793,727,0.202469740938992,0.202469740938992
"08","071","050","Las Animas County",14555,14415,-140,-0.961868773617314,0.961868773617314
"08","073","050","Lincoln County",5675,5694,19,0.334801762114537,0.334801762114537
"08","075","050","Logan County",21528,22094,566,2.62913415087328,2.62913415087328
"08","077","050","Mesa County",155703,155396,-307,-0.197170253623887,0.197170253623887
"08","079","050","Mineral County",865,775,-90,-10.4046242774566,10.4046242774566
"08","081","050","Moffat County",13292,13153,-139,-1.04574179957869,1.04574179957869
"08","083","050","Montezuma County",25849,26404,555,2.14708499361677,2.14708499361677
"08","085","050","Montrose County",42679,43191,512,1.19965322523958,1.19965322523958
"08","087","050","Morgan County",29111,28946,-165,-0.566796056473498,0.566796056473498
"08","089","050","Otero County",18690,18212,-478,-2.55751738897806,2.55751738897806
"08","091","050","Ouray County",4874,4995,121,2.48256052523595,2.48256052523595
"08","093","050","Park County",17390,18915,1525,8.76940770557792,8.76940770557792
"08","095","050","Phillips County",4530,4369,-161,-3.55408388520971,3.55408388520971
"08","097","050","Pitkin County",17358,17889,531,3.05910819218804,3.05910819218804
"08","099","050","Prowers County",11999,12091,92,0.766730560880073,0.766730560880073
"08","101","050","Pueblo County",168162,169551,1389,0.825989224676205,0.825989224676205
"08","103","050","Rio Blanco County",6529,6339,-190,-2.91009342931536,2.91009342931536
"08","105","050","Rio Grande County",11539,11280,-259,-2.24456192044371,2.24456192044371
"08","107","050","Routt County",24829,25549,720,2.89983487051432,2.89983487051432
"08","109","050","Saguache County",6368,6897,529,8.3071608040201,8.3071608040201
"08","111","050","San Juan County",705,746,41,5.81560283687943,5.81560283687943
"08","113","050","San Miguel County",8072,8109,37,0.458374628344896,0.458374628344896
"08","115","050","Sedgwick County",2404,2255,-149,-6.19800332778702,6.19800332778702
"08","117","050","Summit County",31055,30673,-382,-1.23007567219449,1.23007567219449
"08","119","050","Teller County",24710,25460,750,3.03520841764468,3.03520841764468
"08","121","050","Washington County",4817,4867,50,1.03799045048786,1.03799045048786
"08","123","050","Weld County",328981,331780,2799,0.850809013286482,0.850809013286482
"08","125","050","Yuma County",9988,10034,46,0.460552663195835,0.460552663195835
"09","001","050","Fairfield County",957419,943542,-13877,-1.44941765308606,1.44941765308606
"09","003","050","Hartford County",899498,890395,-9103,-1.01200892053123,1.01200892053123
"09","005","050","Litchfield County",185186,179937,-5249,-2.83444752843087,2.83444752843087
"09","007","050","Middlesex County",164245,161950,-2295,-1.39730280982678,1.39730280982678
"09","009","050","New Haven County",864835,852944,-11891,-1.37494435354721,1.37494435354721
"09","011","050","New London County",268555,265329,-3226,-1.20124369309825,1.20124369309825
"09","013","050","Tolland County",149788,150731,943,0.629556439768206,0.629556439768206
"09","015","050","Windham County",116418,116666,248,0.213025477159889,0.213025477159889
"10","001","050","Kent County",181851,183244,1393,0.766011734881854,0.766011734881854
"10","003","050","New Castle County",570719,561505,-9214,-1.6144547491848,1.6144547491848
"10","005","050","Sussex County",237378,240150,2772,1.16775775345651,1.16775775345651
"12","001","050","Alachua County",278468,270997,-7471,-2.68289354611661,2.68289354611661
"12","003","050","Baker County",28259,29531,1272,4.50122084999469,4.50122084999469
"12","005","050","Bay County",175216,172083,-3133,-1.78807871427267,1.78807871427267
"12","007","050","Bradford County",28303,28555,252,0.890364978977494,0.890364978977494
"12","009","050","Brevard County",606612,607008,396,0.0652806077031117,0.0652806077031117
"12","011","050","Broward County",1944375,1958891,14516,0.746563805850209,0.746563805850209
"12","013","050","Calhoun County",13648,14107,459,3.36313012895662,3.36313012895662
"12","015","050","Charlotte County",186847,193654,6807,3.64308765995708,3.64308765995708
"12","017","050","Citrus County",153843,152445,-1398,-0.908718628731889,0.908718628731889
"12","019","050","Clay County",218245,221205,2960,1.35627391234622,1.35627391234622
"12","021","050","Collier County",375752,391598,15846,4.21714322212523,4.21714322212523
"12","023","050","Columbia County",69698,72490,2792,4.00585382650865,4.00585382650865
"12","027","050","DeSoto County",33976,38395,4419,13.0062396986108,13.0062396986108
"12","029","050","Dixie County",16759,17043,284,1.69461185034907,1.69461185034907
"12","031","050","Duval County",995567,965591,-29976,-3.01094753040227,3.01094753040227
"12","033","050","Escambia County",321905,321818,-87,-0.0270266072288408,0.0270266072288408
"12","035","050","Flagler County",115378,117821,2443,2.11738806358231,2.11738806358231
"12","037","050","Franklin County",12451,12198,-253,-2.03196530399165,2.03196530399165
"12","039","050","Gadsden County",43826,45423,1597,3.64395564276913,3.64395564276913
"12","041","050","Gilchrist County",17864,18821,957,5.35714285714286,5.35714285714286
"12","043","050","Glades County",12126,14158,2032,16.7573808345703,16.7573808345703
"12","045","050","Gulf County",14192,13530,-662,-4.66459977452086,4.66459977452086
"12","047","050","Hamilton County",14004,14529,525,3.74892887746358,3.74892887746358
"12","049","050","Hardee County",25327,26845,1518,5.99360366407391,5.99360366407391
"12","051","050","Hendry County",39619,42663,3044,7.6831823115172,7.6831823115172
"12","053","050","Hernando County",194515,197792,3277,1.68470297920469,1.68470297920469
"12","055","050","Highlands County",101235,106575,5340,5.27485553415321,5.27485553415321
"12","057","050","Hillsborough County",1459762,1493476,33714,2.30955457122462,2.30955457122462
"12","059","050","Holmes County",19653,19621,-32,-0.162825013992775,0.162825013992775
"12","061","050","Indian River County",159788,161998,2210,1.38308258442436,1.38308258442436
"12","063","050","Jackson County",47319,46156,-1163,-2.45778651281726,2.45778651281726
"12","065","050","Jefferson County",14510,14492,-18,-0.124052377670572,0.124052377670572
"12","067","050","Lafayette County",8226,8454,228,2.77169948942378,2.77169948942378
"12","069","050","Lake County",383956,373635,-10321,-2.68806842450697,2.68806842450697
"12","071","050","Lee County",760822,786766,25944,3.409996030609,3.409996030609
"12","073","050","Leon County",292198,295239,3041,1.04073265388538,1.04073265388538
"12","075","050","Levy County",42915,42087,-828,-1.92939531632296,1.92939531632296
"12","077","050","Liberty County",7974,8366,392,4.91597692500627,4.91597692500627
"12","079","050","Madison County",17968,18696,728,4.05164737310775,4.05164737310775
"12","081","050","Manatee County",399710,409491,9781,2.44702409246704,2.44702409246704
"12","083","050","Marion County",375908,371919,-3989,-1.06116390180576,1.06116390180576
"12","085","050","Martin County",158431,161993,3562,2.24829736604579,2.24829736604579
"12","086","050","Miami-Dade County",2701767,2710533,8766,0.324454329333358,0.324454329333358
"12","087","050","Monroe County",82874,73938,-8936,-10.7826338779352,10.7826338779352
"12","089","050","Nassau County",90352,90503,151,0.167124136709757,0.167124136709757
"12","091","050","Okaloosa County",211668,212541,873,0.412438346845059,0.412438346845059
"12","093","050","Okeechobee County",39644,42276,2632,6.63908788215115,6.63908788215115
"12","095","050","Orange County",1429908,1403003,-26905,-1.88158958478448,1.88158958478448
"12","097","050","Osceola County",388656,382803,-5853,-1.50595899715944,1.50595899715944
"12","099","050","Palm Beach County",1492191,1506359,14168,0.94947630698751,0.94947630698751
"12","101","050","Pasco County",561891,566648,4757,0.84660548042236,0.84660548042236
"12","103","050","Pinellas County",959107,977106,17999,1.87664150089615,1.87664150089615
"12","105","050","Polk County",725046,740123,15077,2.07945426910844,2.07945426910844
"12","107","050","Putnam County",73321,74708,1387,1.8916817828453,1.8916817828453
"12","109","050","St. Johns County",273425,275439,2014,0.736582243759715,0.736582243759715
"12","111","050","St. Lucie County",329226,335119,5893,1.78995583580884,1.78995583580884
"12","113","050","Santa Rosa County",188000,188045,45,0.023936170212766,0.023936170212766
"12","115","050","Sarasota County",434006,441731,7725,1.77992930973305,1.77992930973305
"12","117","050","Seminole County",470856,473837,2981,0.633102264811322,0.633102264811322
"12","119","050","Sumter County",129752,137843,8091,6.23574203095135,6.23574203095135
"12","121","050","Suwannee County",43474,44750,1276,2.93508763858858,2.93508763858858
"12","123","050","Taylor County",21796,21592,-204,-0.935951550743256,0.935951550743256
"12","125","050","Union County",16147,15191,-956,-5.92060444664644,5.92060444664644
"12","127","050","Volusia County",553543,559967,6424,1.16052411465776,1.16052411465776
"12","129","050","Wakulla County",33764,34146,382,1.13138253761403,1.13138253761403
"12","131","050","Walton County",75305,76029,724,0.96142354425337,0.96142354425337
"12","133","050","Washington County",25318,25854,536,2.11707085867762,2.11707085867762
"13","001","050","Appling County",18444,18393,-51,-0.2765126870527,0.2765126870527
"13","003","050","Atkinson County",8286,8401,115,1.38788317644219,1.38788317644219
"13","005","050","Bacon County",11140,11069,-71,-0.637342908438061,0.637342908438061
"13","007","050","Baker County",2876,2998,122,4.24200278164117,4.24200278164117
"13","009","050","Baldwin County",43799,45140,1341,3.06171373775657,3.06171373775657
"13","011","050","Banks County",18035,19353,1318,7.30801219850291,7.30801219850291
"13","013","050","Barrow County",83505,85159,1654,1.98071971738219,1.98071971738219
"13","015","050","Bartow County",108901,109089,188,0.172633860111477,0.172633860111477
"13","017","050","Ben Hill County",17194,16677,-517,-3.00686285913691,3.00686285913691
"13","019","050","Berrien County",18160,19420,1260,6.93832599118943,6.93832599118943
"13","021","050","Bibb County",157346,152985,-4361,-2.77159889669899,2.77159889669899
"13","023","050","Bleckley County",12583,12970,387,3.07557816101089,3.07557816101089
"13","025","050","Brantley County",18021,19224,1203,6.67554519726985,6.67554519726985
"13","027","050","Brooks County",16301,15425,-876,-5.37390344150666,5.37390344150666
"13","029","050","Bryan County",44738,40509,-4229,-9.45281416245697,9.45281416245697
"13","031","050","Bulloch County",81099,80632,-467,-0.575839406157906,0.575839406157906
"13","033","050","Burke County",24596,22657,-1939,-7.88339567409335,7.88339567409335
"13","035","050","Butts County",25434,25322,-112,-0.440355429739718,0.440355429739718
"13","037","050","Calhoun County",5573,6220,647,11.60954602548,11.60954602548
"13","039","050","Camden County",54768,55294,526,0.960414840782939,0.960414840782939
"13","043","050","Candler County",10981,10962,-19,-0.173026136053183,0.173026136053183
"13","045","050","Carroll County",119148,121327,2179,1.82881794071239,1.82881794071239
"13","047","050","Catoosa County",67872,67958,86,0.126709099481377,0.126709099481377
"13","049","050","Charlton County",12518,13410,892,7.12573893593226,7.12573893593226
"13","051","050","Chatham County",295291,289846,-5445,-1.84394377072109,1.84394377072109
"13","053","050","Chattahoochee County",9565,10696,1131,11.8243596445374,11.8243596445374
"13","055","050","Chattooga County",24965,24872,-93,-0.372521530142199,0.372521530142199
"13","057","050","Cherokee County",266620,263935,-2685,-1.00705123396594,1.00705123396594
"13","059","050","Clarke County",128671,127996,-675,-0.524593731299205,0.524593731299205
"13","061","050","Clay County",2848,2881,33,1.15870786516854,1.15870786516854
"13","063","050","Clayton County",297595,292796,-4799,-1.61259429761925,1.61259429761925
"13","065","050","Clinch County",6749,6595,-154,-2.28181952881908,2.28181952881908
"13","067","050","Cobb County",766149,762910,-3239,-0.422763718284563,0.422763718284563
"13","069","050","Coffee County",43092,43277,185,0.429314025805254,0.429314025805254
"13","071","050","Colquitt County",45898,45589,-309,-0.673231949104536,0.673231949104536
"13","073","050","Columbia County",156010,159669,3659,2.34536247676431,2.34536247676431
"13","075","050","Cook County",17229,17302,73,0.423704219629694,0.423704219629694
"13","077","050","Coweta County",146158,150338,4180,2.85991871809959,2.85991871809959
"13","079","050","Crawford County",12130,12288,158,1.30255564715581,1.30255564715581
"13","081","050","Crisp County",20128,22129,2001,9.94137519872814,9.94137519872814
"13","083","050","Dade County",16251,16089,-162,-0.996861731585749,0.996861731585749
"13","085","050","Dawson County",26798,26889,91,0.339577580416449,0.339577580416449
"13","087","050","Decatur County",29367,26485,-2882,-9.8137365069636,9.8137365069636
"13","089","050","DeKalb County",764382,762044,-2338,-0.305868008404175,0.305868008404175
"13","091","050","Dodge County",19925,20528,603,3.02634880803011,3.02634880803011
"13","093","050","Dooly County",11208,13246,2038,18.1834403997145,18.1834403997145
"13","095","050","Dougherty County",85790,86899,1109,1.29269145588064,1.29269145588064
"13","097","050","Douglas County",144237,147753,3516,2.43765469331725,2.43765469331725
"13","099","050","Early County",10854,10079,-775,-7.14022480191634,7.14022480191634
"13","101","050","Echols County",3697,3986,289,7.81714903976197,7.81714903976197
"13","103","050","Effingham County",64769,65432,663,1.02363785144128,1.02363785144128
"13","105","050","Elbert County",19637,19330,-307,-1.56337526098691,1.56337526098691
"13","107","050","Emanuel County",22768,22537,-231,-1.01458186929023,1.01458186929023
"13","109","050","Evans County",10774,10658,-116,-1.07666604789308,1.07666604789308
"13","111","050","Fannin County",25319,26423,1104,4.36036178364074,4.36036178364074
"13","113","050","Fayette County",119194,115609,-3585,-3.00770172995285,3.00770172995285
"13","115","050","Floyd County",98584,98605,21,0.0213016310963239,0.0213016310963239
"13","117","050","Forsyth County",251283,249437,-1846,-0.734629879458618,0.734629879458618
"13","119","050","Franklin County",23424,23479,55,0.234801912568306,0.234801912568306
"13","121","050","Fulton County",1066710,1074999,8289,0.777062181848862,0.777062181848862
"13","123","050","Gilmer County",31353,31904,551,1.75740758460115,1.75740758460115
"13","125","050","Glascock County",2884,2978,94,3.25936199722607,3.25936199722607
"13","127","050","Glynn County",84499,85583,1084,1.28285541840732,1.28285541840732
"13","129","050","Gordon County",57544,58630,1086,1.88725149450855,1.88725149450855
"13","131","050","Grady County",26236,24541,-1695,-6.46058850434517,6.46058850434517
"13","133","050","Greene County",18915,18749,-166,-0.877610362146445,0.877610362146445
"13","135","050","Gwinnett County",957062,941951,-15111,-1.57889457527308,1.57889457527308
"13","137","050","Habersham County",46031,45949,-82,-0.178140818144294,0.178140818144294
"13","139","050","Hall County",203136,206130,2994,1.47388941398866,1.47388941398866
"13","141","050","Hancock County",8735,8500,-235,-2.69032627361191,2.69032627361191
"13","143","050","Haralson County",29919,30262,343,1.14642869079849,1.14642869079849
"13","145","050","Harris County",34668,35886,1218,3.51332641052267,3.51332641052267
"13","147","050","Hart County",25828,26387,559,2.16431779464147,2.16431779464147
"13","149","050","Heard County",11412,11936,524,4.59165790396074,4.59165790396074
"13","151","050","Henry County",240712,238157,-2555,-1.06143441124663,1.06143441124663
"13","153","050","Houston County",163633,159504,-4129,-2.52332964622051,2.52332964622051
"13","155","050","Irwin County",9666,9396,-270,-2.79329608938547,2.79329608938547
"13","157","050","Jackson County",75907,75436,-471,-0.62049613342643,0.62049613342643
"13","159","050","Jasper County",14588,14427,-161,-1.10364683301344,1.10364683301344
"13","161","050","Jeff Davis County",14779,15194,415,2.80803843291156,2.80803843291156
"13","163","050","Jefferson County",15709,15301,-408,-2.5972372525304,2.5972372525304
"13","165","050","Jenkins County",8674,8745,71,0.818538160018446,0.818538160018446
"13","167","050","Johnson County",9189,9692,503,5.47393622809881,5.47393622809881
"13","169","050","Jones County",28347,28765,418,1.47458284827319,1.47458284827319
"13","171","050","Lamar County",18500,19204,704,3.80540540540541,3.80540540540541
"13","173","050","Lanier County",9877,10676,799,8.0895008605852,8.0895008605852
"13","175","050","Laurens County",49570,47541,-2029,-4.09320153318539,4.09320153318539
"13","177","050","Lee County",33163,30203,-2960,-8.92560986641739,8.92560986641739
"13","179","050","Liberty County",65256,62969,-2287,-3.50465857545666,3.50465857545666
"13","181","050","Lincoln County",7690,8008,318,4.13524057217165,4.13524057217165
"13","183","050","Long County",16168,20048,3880,23.9980207817912,23.9980207817912
"13","185","050","Lowndes County",118251,118154,-97,-0.0820289046181428,0.0820289046181428
"13","187","050","Lumpkin County",33488,34064,576,1.72001911132346,1.72001911132346
"13","189","050","McDuffie County",21632,21195,-437,-2.02015532544379,2.02015532544379
"13","191","050","McIntosh County",10975,14376,3401,30.9886104783599,30.9886104783599
"13","193","050","Macon County",12082,12766,684,5.66131435192849,5.66131435192849
"13","195","050","Madison County",30120,30319,199,0.660690571049137,0.660690571049137
"13","197","050","Marion County",7498,8486,988,13.1768471592425,13.1768471592425
"13","199","050","Meriwether County",20613,21166,553,2.68277300732547,2.68277300732547
"13","201","050","Miller County",6000,5641,-359,-5.98333333333333,5.98333333333333
"13","205","050","Mitchell County",21755,21676,-79,-0.363134911514594,0.363134911514594
"13","207","050","Monroe County",27957,27943,-14,-0.0500769038165755,0.0500769038165755
"13","209","050","Montgomery County",8610,9052,442,5.1335656213705,5.1335656213705
"13","211","050","Morgan County",20097,19538,-559,-2.7815096780614,2.7815096780614
"13","213","050","Murray County",39973,40015,42,0.105070922872939,0.105070922872939
"13","215","050","Muscogee County",206922,196455,-10467,-5.05842781337895,5.05842781337895
"13","217","050","Newton County",112483,112995,512,0.455179893850626,0.455179893850626
"13","219","050","Oconee County",41799,40921,-878,-2.10052872078279,2.10052872078279
"13","221","050","Oglethorpe County",14825,15341,516,3.48060708263069,3.48060708263069
"13","223","050","Paulding County",168661,172398,3737,2.21568708830139,2.21568708830139
"13","225","050","Peach County",27981,27884,-97,-0.346663807583718,0.346663807583718
"13","227","050","Pickens County",33216,32998,-218,-0.65631021194605,0.65631021194605
"13","229","050","Pierce County",19716,19494,-222,-1.12598904443092,1.12598904443092
"13","231","050","Pike County",18889,19089,200,1.0588173010747,1.0588173010747
"13","233","050","Polk County",42853,42779,-74,-0.172683359391408,0.172683359391408
"13","235","050","Pulaski County",9855,11170,1315,13.3434804667681,13.3434804667681
"13","237","050","Putnam County",22047,22424,377,1.70998321767134,1.70998321767134
"13","239","050","Quitman County",2235,2279,44,1.96868008948546,1.96868008948546
"13","241","050","Rabun County",16883,17231,348,2.06124503938873,2.06124503938873
"13","243","050","Randolph County",6425,6719,294,4.57587548638132,4.57587548638132
"13","245","050","Richmond County",206607,202314,-4293,-2.07785796221812,2.07785796221812
"13","247","050","Rockdale County",93570,90897,-2673,-2.85668483488298,2.85668483488298
"13","249","050","Schley County",4547,5214,667,14.6690125357378,14.6690125357378
"13","251","050","Screven County",14067,13985,-82,-0.582924575247032,0.582924575247032
"13","253","050","Seminole County",9147,8064,-1083,-11.8399475237783,11.8399475237783
"13","255","050","Spalding County",67306,67299,-7,-0.0104002614922889,0.0104002614922889
"13","257","050","Stephens County",26784,26076,-708,-2.64336917562724,2.64336917562724
"13","259","050","Stewart County",5314,6678,1364,25.6680466691758,25.6680466691758
"13","261","050","Sumter County",29616,29318,-298,-1.00621285791464,1.00621285791464
"13","263","050","Talbot County",5733,6152,419,7.30856445142159,7.30856445142159
"13","265","050","Taliaferro County",1559,1556,-3,-0.192431045542014,0.192431045542014
"13","267","050","Tattnall County",22842,25354,2512,10.9972857017774,10.9972857017774
"13","269","050","Taylor County",7816,8068,252,3.22415557830092,3.22415557830092
"13","271","050","Telfair County",12477,15783,3306,26.4967540274104,26.4967540274104
"13","273","050","Terrell County",9185,8541,-644,-7.01143168209036,7.01143168209036
"13","275","050","Thomas County",45798,44381,-1417,-3.09402157299445,3.09402157299445
"13","277","050","Tift County",41344,40687,-657,-1.5891060371517,1.5891060371517
"13","279","050","Toombs County",27030,26923,-107,-0.395856455789863,0.395856455789863
"13","281","050","Towns County",12493,12192,-301,-2.40934923557192,2.40934923557192
"13","283","050","Treutlen County",6406,6837,431,6.72806743677802,6.72806743677802
"13","285","050","Troup County",69426,70198,772,1.11197534065048,1.11197534065048
"13","287","050","Turner County",9006,7891,-1115,-12.3806351321341,12.3806351321341
"13","289","050","Twiggs County",8022,8109,87,1.08451757666417,1.08451757666417
"13","291","050","Union County",24632,25170,538,2.18415069827866,2.18415069827866
"13","293","050","Upson County",27700,26491,-1209,-4.36462093862816,4.36462093862816
"13","295","050","Walker County",67654,70029,2375,3.51050935643125,3.51050935643125
"13","297","050","Walton County",96673,96389,-284,-0.293773856195629,0.293773856195629
"13","299","050","Ware County",36251,35806,-445,-1.22755234338363,1.22755234338363
"13","301","050","Warren County",5215,5223,8,0.153403643336529,0.153403643336529
"13","303","050","Washington County",19988,20202,214,1.07064238543126,1.07064238543126
"13","305","050","Wayne County",30144,30001,-143,-0.474389596602972,0.474389596602972
"13","307","050","Webster County",2348,2585,237,10.0936967632027,10.0936967632027
"13","309","050","Wheeler County",7471,7773,302,4.04229688127426,4.04229688127426
"13","311","050","White County",28003,30972,2969,10.6024354533443,10.6024354533443
"13","313","050","Whitfield County",102864,103975,1111,1.08006688442993,1.08006688442993
"13","315","050","Wilcox County",8766,8526,-240,-2.7378507871321,2.7378507871321
"13","317","050","Wilkes County",9565,9700,135,1.41139571353894,1.41139571353894
"13","319","050","Wilkinson County",8877,8846,-31,-0.349217077841613,0.349217077841613
"13","321","050","Worth County",20784,20017,-767,-3.69033872209392,3.69033872209392
"15","001","050","Hawaii County",200629,203242,2613,1.30240393960993,1.30240393960993
"15","003","050","Honolulu County",1016508,967285,-49223,-4.84236228342522,4.84236228342522
"15","005","050","Kalawao County",82,90,8,9.75609756097561,9.75609756097561
"15","007","050","Kauai County",73298,71994,-1304,-1.77903899151409,1.77903899151409
"15","009","050","Maui County",164754,167976,3222,1.95564295859281,1.95564295859281
"16","001","050","Ada County",494967,491505,-3462,-0.69944056876519,0.69944056876519
"16","003","050","Adams County",4379,4416,37,0.844941767526833,0.844941767526833
"16","005","050","Bannock County",87018,88632,1614,1.85478866441426,1.85478866441426
"16","007","050","Bear Lake County",6372,6155,-217,-3.40552416823603,3.40552416823603
"16","009","050","Benewah County",9530,9424,-106,-1.11227701993704,1.11227701993704
"16","011","050","Bingham County",47992,47151,-841,-1.75237539589932,1.75237539589932
"16","013","050","Blaine County",24272,23357,-915,-3.76977587343441,3.76977587343441
"16","015","050","Boise County",7610,8048,438,5.75558475689882,5.75558475689882
"16","017","050","Bonner County",47110,46609,-501,-1.06346847803014,1.06346847803014
"16","019","050","Bonneville County",123964,121481,-2483,-2.00300087122068,2.00300087122068
"16","021","050","Boundary County",12056,12609,553,4.58692767086928,4.58692767086928
"16","023","050","Butte County",2574,2636,62,2.40870240870241,2.40870240870241
"16","025","050","Camas County",1077,1122,45,4.17827298050139,4.17827298050139
"16","027","050","Canyon County",231105,235471,4366,1.8891845697843,1.8891845697843
"16","029","050","Caribou County",7027,7139,112,1.59385228404725,1.59385228404725
"16","031","050","Cassia County",24655,24259,-396,-1.60616507807747,1.60616507807747
"16","033","050","Clark County",790,837,47,5.94936708860759,5.94936708860759
"16","035","050","Clearwater County",8734,8838,104,1.19074879780169,1.19074879780169
"16","037","050","Custer County",4275,4259,-16,-0.374269005847953,0.374269005847953
"16","039","050","Elmore County",28666,27459,-1207,-4.21056303634968,4.21056303634968
"16","041","050","Franklin County",14194,14139,-55,-0.387487670846837,0.387487670846837
"16","043","050","Fremont County",13388,13200,-188,-1.4042426053182,1.4042426053182
"16","045","050","Gem County",19123,18580,-543,-2.83951262877164,2.83951262877164
"16","047","050","Gooding County",15598,15542,-56,-0.359020387229132,0.359020387229132
"16","049","050","Idaho County",16541,16784,243,1.46907683936884,1.46907683936884
"16","051","050","Jefferson County",30891,30422,-469,-1.51824155903014,1.51824155903014
"16","053","050","Jerome County",24237,24573,336,1.38631018690432,1.38631018690432
"16","055","050","Kootenai County",171362,169445,-1917,-1.11868442245072,1.11868442245072
"16","057","050","Latah County",39517,40732,1215,3.07462611028165,3.07462611028165
"16","059","050","Lemhi County",7974,8062,88,1.10358665663406,1.10358665663406
"16","061","050","Lewis County",3533,3836,303,8.57628078120577,8.57628078120577
"16","063","050","Lincoln County",5127,5341,214,4.17398088550809,4.17398088550809
"16","065","050","Madison County",52913,40266,-12647,-23.9014986865232,23.9014986865232
"16","067","050","Minidoka County",21613,21133,-480,-2.22088557812428,2.22088557812428
"16","069","050","Nez Perce County",42090,40710,-1380,-3.27868852459016,3.27868852459016
"16","071","050","Oneida County",4564,4512,-52,-1.13935144609991,1.13935144609991
"16","073","050","Owyhee County",11913,12047,134,1.12482162343658,1.12482162343658
"16","075","050","Payette County",25386,24559,-827,-3.25770109509178,3.25770109509178
"16","077","050","Power County",7878,7640,-238,-3.02107133790302,3.02107133790302
"16","079","050","Shoshone County",13169,12869,-300,-2.27807730275647,2.27807730275647
"16","081","050","Teton County",11630,12387,757,6.50902837489252,6.50902837489252
"16","083","050","Twin Falls County",90046,88083,-1963,-2.1799968904782,2.1799968904782
"16","085","050","Valley County",11746,11693,-53,-0.451217435722799,0.451217435722799
"16","087","050","Washington County",10500,10276,-224,-2.13333333333333,2.13333333333333
"17","001","050","Adams County",65737,65003,-734,-1.11657057669197,1.11657057669197
"17","003","050","Alexander County",5240,5585,345,6.58396946564886,6.58396946564886
"17","005","050","Bond County",16725,16344,-381,-2.2780269058296,2.2780269058296
"17","007","050","Boone County",53448,52957,-491,-0.918649902709175,0.918649902709175
"17","009","050","Brown County",6244,6562,318,5.09288917360666,5.09288917360666
"17","011","050","Bureau County",33244,32425,-819,-2.46360245457827,2.46360245457827
"17","013","050","Calhoun County",4437,4653,216,4.86815415821501,4.86815415821501
"17","015","050","Carroll County",15702,14287,-1415,-9.01159088014266,9.01159088014266
"17","017","050","Cass County",13042,12001,-1041,-7.98190461585646,7.98190461585646
"17","019","050","Champaign County",205865,209481,3616,1.75649090423336,1.75649090423336
"17","021","050","Christian County",34032,32196,-1836,-5.39492242595205,5.39492242595205
"17","023","050","Clark County",15455,15336,-119,-0.769977353607247,0.769977353607247
"17","025","050","Clay County",13288,13124,-164,-1.23419626730885,1.23419626730885
"17","027","050","Clinton County",36899,37444,545,1.47700479687796,1.47700479687796
"17","029","050","Coles County",46863,50516,3653,7.79506220259053,7.79506220259053
"17","031","050","Cook County",5275541,5121283,-154258,-2.92402238936253,2.92402238936253
"17","033","050","Crawford County",18679,18583,-96,-0.513946142727127,0.513946142727127
"17","035","050","Cumberland County",10450,10682,232,2.2200956937799,2.2200956937799
"17","037","050","DeKalb County",100420,104743,4323,4.30491933877714,4.30491933877714
"17","039","050","De Witt County",15516,15453,-63,-0.406032482598608,0.406032482598608
"17","041","050","Douglas County",19740,19507,-233,-1.18034447821682,1.18034447821682
"17","043","050","DuPage County",932877,919381,-13496,-1.44670733655134,1.44670733655134
"17","045","050","Edgar County",16866,16948,82,0.486185224712439,0.486185224712439
"17","047","050","Edwards County",6245,6378,133,2.12970376301041,2.12970376301041
"17","049","050","Effingham County",34668,34094,-574,-1.65570554978655,1.65570554978655
"17","051","050","Fayette County",21488,21293,-195,-0.907483246463142,0.907483246463142
"17","053","050","Ford County",13534,12968,-566,-4.18205999704448,4.18205999704448
"17","055","050","Franklin County",37804,38202,398,1.05279864564596,1.05279864564596
"17","057","050","Fulton County",33609,33849,240,0.714094438989556,0.714094438989556
"17","059","050","Gallatin County",4946,4803,-143,-2.89122523251112,2.89122523251112
"17","061","050","Greene County",11985,12766,781,6.51647893199833,6.51647893199833
"17","063","050","Grundy County",52533,51023,-1510,-2.87438372070889,2.87438372070889
"17","065","050","Hamilton County",7993,8098,105,1.31364944326285,1.31364944326285
"17","067","050","Hancock County",17620,17511,-109,-0.618615209988649,0.618615209988649
"17","069","050","Hardin County",3649,3818,169,4.63140586462044,4.63140586462044
"17","071","050","Henderson County",6387,6575,188,2.94347894160013,2.94347894160013
"17","073","050","Henry County",49284,48583,-701,-1.42236831426021,1.42236831426021
"17","075","050","Iroquois County",27077,26813,-264,-0.974997230121505,0.974997230121505
"17","077","050","Jackson County",52974,56767,3793,7.16011628345981,7.16011628345981
"17","079","050","Jasper County",9287,9505,218,2.34736728760633,2.34736728760633
"17","081","050","Jefferson County",37113,37357,244,0.657451566836418,0.657451566836418
"17","083","050","Jersey County",21512,21635,123,0.571773893640759,0.571773893640759
"17","085","050","Jo Daviess County",22035,21246,-789,-3.58066712049013,3.58066712049013
"17","087","050","Johnson County",13308,12367,-941,-7.07093477607454,7.07093477607454
"17","089","050","Kane County",516522,531666,15144,2.93191771115267,2.93191771115267
"17","091","050","Kankakee County",107502,108894,1392,1.2948596305185,1.2948596305185
"17","093","050","Kendall County",131869,130278,-1591,-1.2065003905391,1.2065003905391
"17","095","050","Knox County",49967,49249,-718,-1.43694838593472,1.43694838593472
"17","097","050","Lake County",714342,694897,-19445,-2.72208549966263,2.72208549966263
"17","099","050","LaSalle County",109658,107865,-1793,-1.63508362362983,1.63508362362983
"17","101","050","Lawrence County",15280,15523,243,1.59031413612565,1.59031413612565
"17","103","050","Lee County",34145,33784,-361,-1.05725582076439,1.05725582076439
"17","105","050","Livingston County",35815,35468,-347,-0.968867792824236,0.968867792824236
"17","107","050","Logan County",27987,28448,461,1.64719333976489,1.64719333976489
"17","109","050","McDonough County",27238,29419,2181,8.00719582935605,8.00719582935605
"17","111","050","McHenry County",310229,306389,-3840,-1.23779530604811,1.23779530604811
"17","113","050","McLean County",170954,171347,393,0.229886402190063,0.229886402190063
"17","115","050","Macon County",103998,103303,-695,-0.668282082347737,0.668282082347737
"17","117","050","Macoupin County",44967,44717,-250,-0.55596326194765,0.55596326194765
"17","119","050","Madison County",265859,263013,-2846,-1.07049225341252,1.07049225341252
"17","121","050","Marion County",37729,37124,-605,-1.60354104269925,1.60354104269925
"17","123","050","Marshall County",11742,11352,-390,-3.32141032192131,3.32141032192131
"17","125","050","Mason County",13086,13248,162,1.23796423658872,1.23796423658872
"17","127","050","Massac County",14169,13690,-479,-3.3806196626438,3.3806196626438
"17","129","050","Menard County",12297,12101,-196,-1.59388468732211,1.59388468732211
"17","131","050","Mercer County",15699,15301,-398,-2.53519332441557,2.53519332441557
"17","133","050","Monroe County",34962,34742,-220,-0.629254619300955,0.629254619300955
"17","135","050","Montgomery County",28288,28132,-156,-0.551470588235294,0.551470588235294
"17","137","050","Morgan County",32915,33469,554,1.6831231961112,1.6831231961112
"17","139","050","Moultrie County",14526,14373,-153,-1.05328376703841,1.05328376703841
"17","141","050","Ogle County",51788,50406,-1382,-2.66857186993126,2.66857186993126
"17","143","050","Peoria County",181830,178182,-3648,-2.00626959247649,2.00626959247649
"17","145","050","Perry County",20945,20735,-210,-1.00262592504178,1.00262592504178
"17","147","050","Piatt County",16673,16357,-316,-1.8952797936784,1.8952797936784
"17","149","050","Pike County",14739,15327,588,3.98941583553837,3.98941583553837
"17","151","050","Pope County",3763,4148,385,10.2311985118257,10.2311985118257
"17","153","050","Pulaski County",5193,5220,27,0.519930675909879,0.519930675909879
"17","155","050","Putnam County",5637,5721,84,1.49015433741352,1.49015433741352
"17","157","050","Randolph County",30163,31458,1295,4.29333952193084,4.29333952193084
"17","159","050","Richland County",15813,15505,-308,-1.94776449756529,1.94776449756529
"17","161","050","Rock Island County",144672,141193,-3479,-2.4047500552975,2.4047500552975
"17","163","050","St. Clair County",257400,258637,1237,0.480574980574981,0.480574980574981
"17","165","050","Saline County",23768,23256,-512,-2.15415684954561,2.15415684954561
"17","167","050","Sangamon County",196343,194189,-2154,-1.09705973729647,1.09705973729647
"17","169","050","Schuyler County",6902,6763,-139,-2.01390901188061,2.01390901188061
"17","171","050","Scott County",4949,4951,2,0.0404122044857547,0.0404122044857547
"17","173","050","Shelby County",20990,21369,379,1.80562172463078,1.80562172463078
"17","175","050","Stark County",5400,5274,-126,-2.33333333333333,2.33333333333333
"17","177","050","Stephenson County",44630,43969,-661,-1.48106654716558,1.48106654716558
"17","179","050","Tazewell County",131343,131075,-268,-0.204045895099092,0.204045895099092
"17","181","050","Union County",17244,16545,-699,-4.053583855254,4.053583855254
"17","183","050","Vermilion County",74188,75093,905,1.21987383404324,1.21987383404324
"17","185","050","Wabash County",11361,11229,-132,-1.16186955373647,1.16186955373647
"17","187","050","Warren County",16835,16724,-111,-0.659340659340659,0.659340659340659
"17","189","050","Washington County",13761,13808,47,0.341544945861493,0.341544945861493
"17","191","050","Wayne County",16179,16061,-118,-0.72934050312133,0.72934050312133
"17","193","050","White County",13877,13423,-454,-3.27160049001946,3.27160049001946
"17","195","050","Whiteside County",55691,54821,-870,-1.56219137742185,1.56219137742185
"17","197","050","Will County",696355,689418,-6937,-0.996187289529048,0.996187289529048
"17","199","050","Williamson County",67153,66479,-674,-1.00367816776615,1.00367816776615
"17","201","050","Winnebago County",285350,281743,-3607,-1.26406167864027,1.26406167864027
"17","203","050","Woodford County",38467,38146,-321,-0.834481503626485,0.834481503626485
"18","001","050","Adams County",35809,35859,50,0.139629702030216,0.139629702030216
"18","003","050","Allen County",385410,381615,-3795,-0.984665680703666,0.984665680703666
"18","005","050","Bartholomew County",82208,84443,2235,2.71871350720125,2.71871350720125
"18","007","050","Benton County",8719,8746,27,0.30966853997018,0.30966853997018
"18","009","050","Blackford County",12112,11806,-306,-2.52642007926024,2.52642007926024
"18","011","050","Boone County",70812,69046,-1766,-2.49392758289555,2.49392758289555
"18","013","050","Brown County",15475,15119,-356,-2.30048465266559,2.30048465266559
"18","015","050","Carroll County",20306,20257,-49,-0.241307987786861,0.241307987786861
"18","017","050","Cass County",37870,37515,-355,-0.937417480855558,0.937417480855558
"18","019","050","Clark County",121093,119083,-2010,-1.65988124829676,1.65988124829676
"18","021","050","Clay County",26466,26288,-178,-0.672561021688204,0.672561021688204
"18","023","050","Clinton County",33190,32277,-913,-2.75082856282013,2.75082856282013
"18","025","050","Crawford County",10526,10629,103,0.978529355880676,0.978529355880676
"18","027","050","Daviess County",33381,33539,158,0.473323147898505,0.473323147898505
"18","029","050","Dearborn County",50679,49791,-888,-1.75220505534837,1.75220505534837
"18","031","050","Decatur County",26472,26579,107,0.40420066485343,0.40420066485343
"18","033","050","DeKalb County",43265,43682,417,0.963827574251705,0.963827574251705
"18","035","050","Delaware County",111903,113601,1698,1.51738559287955,1.51738559287955
"18","037","050","Dubois County",43637,42592,-1045,-2.39475674313083,2.39475674313083
"18","039","050","Elkhart County",207047,206292,-755,-0.364651504247828,0.364651504247828
"18","041","050","Fayette County",23398,22947,-451,-1.92751517223694,1.92751517223694
"18","043","050","Floyd County",80484,78883,-1601,-1.98921524775111,1.98921524775111
"18","045","050","Fountain County",16479,16505,26,0.1577765641119,0.1577765641119
"18","047","050","Franklin County",22785,22782,-3,-0.0131665569453588,0.0131665569453588
"18","049","050","Fulton County",20480,20058,-422,-2.060546875,2.060546875
"18","051","050","Gibson County",33011,33826,815,2.46887401169307,2.46887401169307
"18","053","050","Grant County",66674,65416,-1258,-1.88679245283019,1.88679245283019
"18","055","050","Greene County",30803,32193,1390,4.51254747914164,4.51254747914164
"18","057","050","Hamilton County",347467,342823,-4644,-1.33652979995223,1.33652979995223
"18","059","050","Hancock County",79840,79246,-594,-0.743987975951904,0.743987975951904
"18","061","050","Harrison County",39654,40686,1032,2.60251172643365,2.60251172643365
"18","063","050","Hendricks County",174788,172509,-2279,-1.30386525390759,1.30386525390759
"18","065","050","Henry County",48914,48044,-870,-1.77863188453204,1.77863188453204
"18","067","050","Howard County",83658,82780,-878,-1.04951110473595,1.04951110473595
"18","069","050","Huntington County",36662,36459,-203,-0.553706835415417,0.553706835415417
"18","071","050","Jackson County",46428,44232,-2196,-4.72990436805376,4.72990436805376
"18","073","050","Jasper County",32918,33474,556,1.68904550701744,1.68904550701744
"18","075","050","Jay County",20478,20433,-45,-0.2197480222678,0.2197480222678
"18","077","050","Jefferson County",33147,32163,-984,-2.96859444293601,2.96859444293601
"18","079","050","Jennings County",27613,27579,-34,-0.123130409589686,0.123130409589686
"18","081","050","Johnson County",161765,160103,-1662,-1.02741631378852,1.02741631378852
"18","083","050","Knox County",36282,36578,296,0.815831541811366,0.815831541811366
"18","085","050","Kosciusko County",80240,79137,-1103,-1.37462612163509,1.37462612163509
"18","087","050","LaGrange County",40446,40058,-388,-0.959303763042081,0.959303763042081
"18","089","050","Lake County",498700,487517,-11183,-2.24243031882896,2.24243031882896
"18","091","050","LaPorte County",112417,109800,-2617,-2.3279397244189,2.3279397244189
"18","093","050","Lawrence County",45011,45486,475,1.05529759392149,1.05529759392149
"18","095","050","Madison County",130129,129682,-447,-0.343505290903642,0.343505290903642
"18","097","050","Marion County",977203,966118,-11085,-1.13436000503478,1.13436000503478
"18","099","050","Marshall County",46095,46138,43,0.0932856058140796,0.0932856058140796
"18","101","050","Martin County",9812,10104,292,2.97594781899715,2.97594781899715
"18","103","050","Miami County",35962,35378,-584,-1.62393637728714,1.62393637728714
"18","105","050","Monroe County",139718,148278,8560,6.1266264905023,6.1266264905023
"18","107","050","Montgomery County",37936,38351,415,1.09394770139182,1.09394770139182
"18","109","050","Morgan County",71780,70642,-1138,-1.58539983282251,1.58539983282251
"18","111","050","Newton County",13830,13928,98,0.708604483007954,0.708604483007954
"18","113","050","Noble County",47457,47859,402,0.847082622163221,0.847082622163221
"18","115","050","Ohio County",5940,5896,-44,-0.740740740740741,0.740740740740741
"18","117","050","Orange County",19867,19638,-229,-1.15266522373786,1.15266522373786
"18","119","050","Owen County",21321,20845,-476,-2.23254068758501,2.23254068758501
"18","121","050","Parke County",16156,16882,726,4.49368655607824,4.49368655607824
"18","123","050","Perry County",19170,19160,-10,-0.0521648408972353,0.0521648408972353
"18","125","050","Pike County",12250,12372,122,0.995918367346939,0.995918367346939
"18","127","050","Porter County",173215,170947,-2268,-1.30935542533845,1.30935542533845
"18","129","050","Posey County",25222,25313,91,0.360796130362382,0.360796130362382
"18","131","050","Pulaski County",12514,12372,-142,-1.13472910340419,1.13472910340419
"18","133","050","Putnam County",36726,37488,762,2.07482437510211,2.07482437510211
"18","135","050","Randolph County",24502,24280,-222,-0.906048485837891,0.906048485837891
"18","137","050","Ripley County",28995,28437,-558,-1.92446973616141,1.92446973616141
"18","139","050","Rush County",16752,16629,-123,-0.734240687679083,0.734240687679083
"18","141","050","St. Joseph County",272912,271650,-1262,-0.462420120771531,0.462420120771531
"18","143","050","Scott County",24384,23804,-580,-2.37860892388451,2.37860892388451
"18","145","050","Shelby County",45055,44860,-195,-0.432804350238597,0.432804350238597
"18","147","050","Spencer County",19810,20234,424,2.14033316506815,2.14033316506815
"18","149","050","Starke County",23371,23041,-330,-1.41200633263446,1.41200633263446
"18","151","050","Steuben County",34435,34816,381,1.10643240888631,1.10643240888631
"18","153","050","Sullivan County",20817,20578,-239,-1.14810011048662,1.14810011048662
"18","155","050","Switzerland County",9737,10748,1011,10.3830748690562,10.3830748690562
"18","157","050","Tippecanoe County",186251,195897,9646,5.17903259579814,5.17903259579814
"18","159","050","Tipton County",15359,15188,-171,-1.11335373396706,1.11335373396706
"18","161","050","Union County",7087,7117,30,0.42331028643996,0.42331028643996
"18","163","050","Vanderburgh County",180136,182262,2126,1.18021938979438,1.18021938979438
"18","165","050","Vermillion County",15439,15368,-71,-0.459874344193277,0.459874344193277
"18","167","050","Vigo County",106153,106698,545,0.513409889499119,0.513409889499119
"18","169","050","Wabash County",30976,30835,-141,-0.455191115702479,0.455191115702479
"18","171","050","Warren County",8440,8195,-245,-2.90284360189573,2.90284360189573
"18","173","050","Warrick County",63898,63178,-720,-1.12679583085543,1.12679583085543
"18","175","050","Washington County",28182,28164,-18,-0.0638705556738344,0.0638705556738344
"18","177","050","Wayne County",66553,65823,-730,-1.09687016362899,1.09687016362899
"18","179","050","Wells County",28180,28112,-68,-0.241305890702626,0.241305890702626
"18","181","050","White County",24688,24164,-524,-2.12248865845755,2.12248865845755
"18","183","050","Whitley County",34191,34238,47,0.137463075078237,0.137463075078237
"19","001","050","Adair County",7496,7084,-412,-5.49626467449306,5.49626467449306
"19","003","050","Adams County",3704,3595,-109,-2.94276457883369,2.94276457883369
"19","005","050","Allamakee County",14061,13676,-385,-2.73806983856056,2.73806983856056
"19","007","050","Appanoose County",12317,12482,165,1.33961191848664,1.33961191848664
"19","009","050","Audubon County",5674,5495,-179,-3.15474092351075,3.15474092351075
"19","011","050","Benton County",25575,25485,-90,-0.351906158357771,0.351906158357771
"19","013","050","Black Hawk County",131144,130962,-182,-0.13877874702617,0.13877874702617
"19","015","050","Boone County",26715,26320,-395,-1.47857009170878,1.47857009170878
"19","017","050","Bremer County",24988,25323,335,1.34064350888426,1.34064350888426
"19","019","050","Buchanan County",20565,21285,720,3.50109409190372,3.50109409190372
"19","021","050","Buena Vista County",20823,19791,-1032,-4.95605820486962,4.95605820486962
"19","023","050","Butler County",14334,14378,44,0.306962466862006,0.306962466862006
"19","025","050","Calhoun County",9927,9527,-400,-4.02941472751083,4.02941472751083
"19","027","050","Carroll County",20760,19998,-762,-3.67052023121387,3.67052023121387
"19","029","050","Cass County",13127,12840,-287,-2.18633351108403,2.18633351108403
"19","031","050","Cedar County",18505,18517,12,0.0648473385571467,0.0648473385571467
"19","033","050","Cerro Gordo County",43127,42247,-880,-2.04048507895286,2.04048507895286
"19","035","050","Cherokee County",11658,11218,-440,-3.77423228684165,3.77423228684165
"19","037","050","Chickasaw County",12012,11872,-140,-1.16550116550117,1.16550116550117
"19","039","050","Clarke County",9748,9386,-362,-3.71358227328683,3.71358227328683
"19","041","050","Clay County",16384,16030,-354,-2.16064453125,2.16064453125
"19","043","050","Clayton County",17043,17379,336,1.97148389368069,1.97148389368069
"19","045","050","Clinton County",46460,46491,31,0.0667240637107189,0.0667240637107189
"19","047","050","Crawford County",16525,16893,368,2.22692889561271,2.22692889561271
"19","049","050","Dallas County",99678,96181,-3497,-3.50829671542366,3.50829671542366
"19","051","050","Davis County",9110,9050,-60,-0.658616904500549,0.658616904500549
"19","053","050","Decatur County",7645,7807,162,2.1190320470896,2.1190320470896
"19","055","050","Delaware County",17488,16977,-511,-2.92200365965233,2.92200365965233
"19","057","050","Des Moines County",38910,38845,-65,-0.167052171678232,0.167052171678232
"19","059","050","Dickinson County",17703,17518,-185,-1.04502061797435,1.04502061797435
"19","061","050","Dubuque County",99266,97601,-1665,-1.67731146616163,1.67731146616163
"19","063","050","Emmet County",9388,9134,-254,-2.70558159352365,2.70558159352365
"19","065","050","Fayette County",19509,19362,-147,-0.753498385360603,0.753498385360603
"19","067","050","Floyd County",15627,15540,-87,-0.556728738721444,0.556728738721444
"19","069","050","Franklin County",10019,10014,-5,-0.0499051801577004,0.0499051801577004
"19","071","050","Fremont County",6605,6782,177,2.67978803936412,2.67978803936412
"19","073","050","Greene County",8771,8827,56,0.638467677573823,0.638467677573823
"19","075","050","Grundy County",12329,12230,-99,-0.802984832508719,0.802984832508719
"19","077","050","Guthrie County",10623,10745,122,1.14845147321849,1.14845147321849
"19","079","050","Hamilton County",15039,14751,-288,-1.91502094554159,1.91502094554159
"19","081","050","Hancock County",10795,10548,-247,-2.28809634089856,2.28809634089856
"19","083","050","Hardin County",16878,16653,-225,-1.33309633842872,1.33309633842872
"19","085","050","Harrison County",14582,13955,-627,-4.29982169798382,4.29982169798382
"19","087","050","Henry County",20482,19746,-736,-3.59339908212089,3.59339908212089
"19","089","050","Howard County",9469,9180,-289,-3.05206463195691,3.05206463195691
"19","091","050","Humboldt County",9597,9500,-97,-1.01073252057935,1.01073252057935
"19","093","050","Ida County",7005,6840,-165,-2.35546038543897,2.35546038543897
"19","095","050","Iowa County",16662,16145,-517,-3.10286880326491,3.10286880326491
"19","097","050","Jackson County",19485,19266,-219,-1.12394149345651,1.12394149345651
"19","099","050","Jasper County",37813,37166,-647,-1.71105175468754,1.71105175468754
"19","101","050","Jefferson County",15663,18333,2670,17.0465428078912,17.0465428078912
"19","103","050","Johnson County",152854,153507,653,0.427205045337381,0.427205045337381
"19","105","050","Jones County",20646,20639,-7,-0.03390487261455,0.03390487261455
"19","107","050","Keokuk County",10033,10111,78,0.777434466261337,0.777434466261337
"19","109","050","Kossuth County",14828,14705,-123,-0.829511734556245,0.829511734556245
"19","111","050","Lee County",33555,33541,-14,-0.0417225450752496,0.0417225450752496
"19","113","050","Linn County",230299,227797,-2502,-1.08641374908271,1.08641374908271
"19","115","050","Louisa County",10837,11030,193,1.78093568330719,1.78093568330719
"19","117","050","Lucas County",8634,8531,-103,-1.1929580727357,1.1929580727357
"19","119","050","Lyon County",11934,11766,-168,-1.40774258421317,1.40774258421317
"19","121","050","Madison County",16548,16466,-82,-0.49552816050278,0.49552816050278
"19","123","050","Mahaska County",22190,22391,201,0.905813429472735,0.905813429472735
"19","125","050","Marion County",33414,33201,-213,-0.637457353205243,0.637457353205243
"19","127","050","Marshall County",40105,39486,-619,-1.54344844782446,1.54344844782446
"19","129","050","Mills County",14484,14844,360,2.48550124275062,2.48550124275062
"19","131","050","Mitchell County",10565,10625,60,0.56791292001893,0.56791292001893
"19","133","050","Monona County",8751,8599,-152,-1.73694434921723,1.73694434921723
"19","135","050","Monroe County",7577,7745,168,2.21723637323479,2.21723637323479
"19","137","050","Montgomery County",10330,9931,-399,-3.86253630203291,3.86253630203291
"19","139","050","Muscatine County",43235,42459,-776,-1.79484214178328,1.79484214178328
"19","141","050","O'Brien County",14182,13721,-461,-3.25059935129037,3.25059935129037
"19","143","050","Osceola County",6192,5986,-206,-3.32687338501292,3.32687338501292
"19","145","050","Page County",15211,15079,-132,-0.867793044507264,0.867793044507264
"19","147","050","Palo Alto County",8996,8844,-152,-1.68963983992886,1.68963983992886
"19","149","050","Plymouth County",25698,25213,-485,-1.88730640516772,1.88730640516772
"19","151","050","Pocahontas County",7078,6607,-471,-6.65442215315061,6.65442215315061
"19","153","050","Polk County",492401,493699,1298,0.263606288370657,0.263606288370657
"19","155","050","Pottawattamie County",93667,93361,-306,-0.326689228863954,0.326689228863954
"19","157","050","Poweshiek County",18662,18382,-280,-1.50037509377344,1.50037509377344
"19","159","050","Ringgold County",4663,4813,150,3.21681321037958,3.21681321037958
"19","161","050","Sac County",9814,9607,-207,-2.10923170980232,2.10923170980232
"19","163","050","Scott County",174669,173301,-1368,-0.783195644332995,0.783195644332995
"19","165","050","Shelby County",11746,11435,-311,-2.64770985867529,2.64770985867529
"19","167","050","Sioux County",35872,35022,-850,-2.36953612845674,2.36953612845674
"19","169","050","Story County",98537,98081,-456,-0.46277032992683,0.46277032992683
"19","171","050","Tama County",17135,16807,-328,-1.91421067989495,1.91421067989495
"19","173","050","Taylor County",5896,6121,225,3.81614654002714,3.81614654002714
"19","175","050","Union County",12138,12144,6,0.0494315373208107,0.0494315373208107
"19","177","050","Van Buren County",7203,7053,-150,-2.08246563931695,2.08246563931695
"19","179","050","Wapello County",35437,35008,-429,-1.2105990913452,1.2105990913452
"19","181","050","Warren County",52403,52079,-324,-0.618285212678663,0.618285212678663
"19","183","050","Washington County",22565,21992,-573,-2.53933082206958,2.53933082206958
"19","185","050","Wayne County",6497,6420,-77,-1.18516238263814,1.18516238263814
"19","187","050","Webster County",36999,35914,-1085,-2.93251168950512,2.93251168950512
"19","189","050","Winnebago County",10679,10278,-401,-3.755033242813,3.755033242813
"19","191","050","Winneshiek County",20070,19886,-184,-0.916791230692576,0.916791230692576
"19","193","050","Woodbury County",105941,103123,-2818,-2.65997111599853,2.65997111599853
"19","195","050","Worth County",7443,7361,-82,-1.10170630122263,1.10170630122263
"19","197","050","Wright County",12943,12434,-509,-3.93262767519122,3.93262767519122
"20","001","050","Allen County",12526,12419,-107,-0.85422321571132,0.85422321571132
"20","003","050","Anderson County",7836,7969,133,1.69729453802961,1.69729453802961
"20","005","050","Atchison County",16348,16075,-273,-1.66992904330805,1.66992904330805
"20","007","050","Barber County",4228,4383,155,3.66603595080416,3.66603595080416
"20","009","050","Barton County",25493,25762,269,1.05519162122936,1.05519162122936
"20","011","050","Bourbon County",14360,14499,139,0.967966573816156,0.967966573816156
"20","013","050","Brown County",9508,9521,13,0.13672696676483,0.13672696676483
"20","015","050","Butler County",67380,67023,-357,-0.529830810329475,0.529830810329475
"20","017","050","Chase County",2572,2588,16,0.622083981337481,0.622083981337481
"20","019","050","Chautauqua County",3379,3256,-123,-3.64013021604025,3.64013021604025
"20","021","050","Cherokee County",19362,19772,410,2.11754983989257,2.11754983989257
"20","023","050","Cheyenne County",2616,2616,0,0,0
"20","025","050","Clark County",1991,1979,-12,-0.60271220492215,0.60271220492215
"20","027","050","Clay County",8117,8048,-69,-0.85006775902427,0.85006775902427
"20","029","050","Cloud County",9032,8701,-331,-3.66474756421612,3.66474756421612
"20","031","050","Coffey County",8360,8180,-180,-2.15311004784689,2.15311004784689
"20","033","050","Comanche County",1689,1701,12,0.710479573712256,0.710479573712256
"20","035","050","Cowley County",34549,34734,185,0.535471359518365,0.535471359518365
"20","037","050","Crawford County",38972,38769,-203,-0.520886790516268,0.520886790516268
"20","039","050","Decatur County",2764,2787,23,0.832127351664255,0.832127351664255
"20","041","050","Dickinson County",18402,18330,-72,-0.39126181936746,0.39126181936746
"20","043","050","Doniphan County",7510,7530,20,0.266311584553928,0.266311584553928
"20","045","050","Douglas County",118785,122546,3761,3.16622469166982,3.16622469166982
"20","047","050","Edwards County",2907,2757,-150,-5.15995872033024,5.15995872033024
"20","049","050","Elk County",2483,2507,24,0.966572694321385,0.966572694321385
"20","051","050","Ellis County",28934,28696,-238,-0.82256169212691,0.82256169212691
"20","053","050","Ellsworth County",6376,6053,-323,-5.06587202007528,5.06587202007528
"20","055","050","Finney County",38470,36086,-2384,-6.19703665193657,6.19703665193657
"20","057","050","Ford County",34287,33195,-1092,-3.18488056697874,3.18488056697874
"20","059","050","Franklin County",25996,25706,-290,-1.11555623942145,1.11555623942145
"20","061","050","Geary County",36739,32184,-4555,-12.3982688695936,12.3982688695936
"20","063","050","Gove County",2718,2638,-80,-2.94334069168506,2.94334069168506
"20","065","050","Graham County",2415,2404,-11,-0.455486542443064,0.455486542443064
"20","067","050","Grant County",7352,7104,-248,-3.37323177366703,3.37323177366703
"20","069","050","Gray County",5653,5982,329,5.81991862727755,5.81991862727755
"20","071","050","Greeley County",1284,1202,-82,-6.38629283489097,6.38629283489097
"20","073","050","Greenwood County",6016,5913,-103,-1.71210106382979,1.71210106382979
"20","075","050","Hamilton County",2518,2459,-59,-2.34312946783161,2.34312946783161
"20","077","050","Harper County",5485,5367,-118,-2.15132178669098,2.15132178669098
"20","079","050","Harvey County",34024,34350,326,0.958147190218669,0.958147190218669
"20","081","050","Haskell County",3780,3949,169,4.47089947089947,4.47089947089947
"20","083","050","Hodgeman County",1723,1781,58,3.36622170632618,3.36622170632618
"20","085","050","Jackson County",13232,13154,-78,-0.589480048367594,0.589480048367594
"20","087","050","Jefferson County",18368,19066,698,3.80008710801394,3.80008710801394
"20","089","050","Jewell County",2932,2838,-94,-3.20600272851296,3.20600272851296
"20","091","050","Johnson County",609863,606439,-3424,-0.561437568765444,0.561437568765444
"20","093","050","Kearny County",3983,3772,-211,-5.29751443635451,5.29751443635451
"20","095","050","Kingman County",7470,6998,-472,-6.3186077643909,6.3186077643909
"20","097","050","Kiowa County",2460,2461,1,0.040650406504065,0.040650406504065
"20","099","050","Labette County",20184,19624,-560,-2.77447483154974,2.77447483154974
"20","101","050","Lane County",1574,1516,-58,-3.6848792884371,3.6848792884371
"20","103","050","Leavenworth County",81881,82201,320,0.39081105506772,0.39081105506772
"20","105","050","Lincoln County",2939,2979,40,1.36100714528751,1.36100714528751
"20","107","050","Linn County",9591,9677,86,0.896673965175685,0.896673965175685
"20","109","050","Logan County",2762,2735,-27,-0.977552498189718,0.977552498189718
"20","111","050","Lyon County",32179,33120,941,2.92426737934678,2.92426737934678
"20","113","050","McPherson County",30223,28494,-1729,-5.7208086556596,5.7208086556596
"20","115","050","Marion County",11823,11688,-135,-1.14184217203755,1.14184217203755
"20","117","050","Marshall County",10038,9660,-378,-3.76569037656904,3.76569037656904
"20","119","050","Meade County",4055,4039,-16,-0.394574599260173,0.394574599260173
"20","121","050","Miami County",34191,34306,115,0.336345821999942,0.336345821999942
"20","123","050","Mitchell County",5796,5901,105,1.81159420289855,1.81159420289855
"20","125","050","Montgomery County",31486,31576,90,0.285841326303754,0.285841326303754
"20","127","050","Morris County",5386,5565,179,3.32343111771259,3.32343111771259
"20","129","050","Morton County",2701,2545,-156,-5.77563865235098,5.77563865235098
"20","131","050","Nemaha County",10273,10135,-138,-1.34332716830527,1.34332716830527
"20","133","050","Neosho County",15904,15933,29,0.182344064386318,0.182344064386318
"20","135","050","Ness County",2687,2770,83,3.08894678079643,3.08894678079643
"20","137","050","Norton County",5459,5351,-108,-1.97838431947243,1.97838431947243
"20","139","050","Osage County",15766,15804,38,0.241024990485856,0.241024990485856
"20","141","050","Osborne County",3500,3433,-67,-1.91428571428571,1.91428571428571
"20","143","050","Ottawa County",5735,5710,-25,-0.4359197907585,0.4359197907585
"20","145","050","Pawnee County",6253,6370,117,1.87110187110187,1.87110187110187
"20","147","050","Phillips County",4981,5193,212,4.25617345914475,4.25617345914475
"20","149","050","Pottawatomie County",25348,24669,-679,-2.67871232444374,2.67871232444374
"20","151","050","Pratt County",9157,9114,-43,-0.46958610898766,0.46958610898766
"20","153","050","Rawlins County",2561,2519,-42,-1.63998438110113,1.63998438110113
"20","155","050","Reno County",61898,61856,-42,-0.0678535655433132,0.0678535655433132
"20","157","050","Republic County",4674,4544,-130,-2.78134360290971,2.78134360290971
"20","159","050","Rice County",9427,9410,-17,-0.180333085817333,0.180333085817333
"20","161","050","Riley County",71959,73097,1138,1.58145610694979,1.58145610694979
"20","163","050","Rooks County",4919,4854,-65,-1.32140678999797,1.32140678999797
"20","165","050","Rush County",2956,2956,0,0,0
"20","167","050","Russell County",6691,6812,121,1.80839934240024,1.80839934240024
"20","169","050","Saline County",54303,53965,-338,-0.622433383054343,0.622433383054343
"20","171","050","Scott County",5151,4798,-353,-6.85303824500097,6.85303824500097
"20","173","050","Sedgwick County",523824,519337,-4487,-0.856585418002993,0.856585418002993
"20","175","050","Seward County",21964,21080,-884,-4.02476780185759,4.02476780185759
"20","177","050","Shawnee County",178909,176250,-2659,-1.48623042999514,1.48623042999514
"20","179","050","Sheridan County",2447,2517,70,2.86064568859828,2.86064568859828
"20","181","050","Sherman County",5927,5795,-132,-2.22709633878859,2.22709633878859
"20","183","050","Smith County",3570,3539,-31,-0.868347338935574,0.868347338935574
"20","185","050","Stafford County",4072,4051,-21,-0.515717092337918,0.515717092337918
"20","187","050","Stanton County",2084,1969,-115,-5.51823416506718,5.51823416506718
"20","189","050","Stevens County",5250,5383,133,2.53333333333333,2.53333333333333
"20","191","050","Sumner County",22382,22614,232,1.03654722544902,1.03654722544902
"20","193","050","Thomas County",7930,7698,-232,-2.92559899117276,2.92559899117276
"20","195","050","Trego County",2808,2766,-42,-1.4957264957265,1.4957264957265
"20","197","050","Wabaunsee County",6877,6893,16,0.232659589937473,0.232659589937473
"20","199","050","Wallace County",1512,1524,12,0.793650793650794,0.793650793650794
"20","201","050","Washington County",5530,5432,-98,-1.77215189873418,1.77215189873418
"20","203","050","Wichita County",2152,2086,-66,-3.06691449814126,3.06691449814126
"20","205","050","Wilson County",8624,8388,-236,-2.73654916512059,2.73654916512059
"20","207","050","Woodson County",3115,3028,-87,-2.79293739967897,2.79293739967897
"20","209","050","Wyandotte County",169245,165506,-3739,-2.20922331531212,2.20922331531212
"21","001","050","Adair County",18903,19559,656,3.47034862191187,3.47034862191187
"21","003","050","Allen County",20588,21344,756,3.6720419661939,3.6720419661939
"21","005","050","Anderson County",23852,22836,-1016,-4.25960087204427,4.25960087204427
"21","007","050","Ballard County",7728,7795,67,0.866977225672878,0.866977225672878
"21","009","050","Barren County",44485,44327,-158,-0.355175901989435,0.355175901989435
"21","011","050","Bath County",12750,12510,-240,-1.88235294117647,1.88235294117647
"21","013","050","Bell County",24097,25649,1552,6.44063576378802,6.44063576378802
"21","015","050","Boone County",135968,135048,-920,-0.67662979524594,0.67662979524594
"21","017","050","Bourbon County",20252,19902,-350,-1.72822437290144,1.72822437290144
"21","019","050","Boyd County",48261,46640,-1621,-3.35881975093761,3.35881975093761
"21","021","050","Boyle County",30614,30318,-296,-0.966877899000457,0.966877899000457
"21","023","050","Bracken County",8400,8317,-83,-0.988095238095238,0.988095238095238
"21","025","050","Breathitt County",13718,12585,-1133,-8.25922146085435,8.25922146085435
"21","027","050","Breckinridge County",20432,20556,124,0.606891151135474,0.606891151135474
"21","029","050","Bullitt County",82217,82140,-77,-0.0936545969811596,0.0936545969811596
"21","031","050","Butler County",12371,12754,383,3.09595020612723,3.09595020612723
"21","033","050","Caldwell County",12649,12715,66,0.521780377895486,0.521780377895486
"21","035","050","Calloway County",37103,39280,2177,5.8674500714228,5.8674500714228
"21","037","050","Campbell County",93076,94035,959,1.03034079676823,1.03034079676823
"21","039","050","Carlisle County",4826,4703,-123,-2.54869457107335,2.54869457107335
"21","041","050","Carroll County",10810,10731,-79,-0.730804810360777,0.730804810360777
"21","043","050","Carter County",26627,26627,0,0,0
"21","045","050","Casey County",15941,16124,183,1.14798318800577,1.14798318800577
"21","047","050","Christian County",72748,71568,-1180,-1.62203771925001,1.62203771925001
"21","049","050","Clark County",36972,36469,-503,-1.36048901871687,1.36048901871687
"21","051","050","Clay County",20345,19720,-625,-3.07200786434013,3.07200786434013
"21","053","050","Clinton County",9253,10138,885,9.56446557873122,9.56446557873122
"21","055","050","Crittenden County",8990,8848,-142,-1.57953281423804,1.57953281423804
"21","057","050","Cumberland County",5888,6559,671,11.3960597826087,11.3960597826087
"21","059","050","Daviess County",103312,101937,-1375,-1.3309199318569,1.3309199318569
"21","061","050","Edmonson County",12126,12224,98,0.808180768596404,0.808180768596404
"21","063","050","Elliott County",7354,7405,51,0.693500135980419,0.693500135980419
"21","065","050","Estill County",14163,14141,-22,-0.155334321824472,0.155334321824472
"21","067","050","Fayette County",322570,324708,2138,0.662801872461791,0.662801872461791
"21","069","050","Fleming County",15082,14600,-482,-3.19586261768996,3.19586261768996
"21","071","050","Floyd County",35942,35130,-812,-2.25919537031885,2.25919537031885
"21","073","050","Franklin County",51541,51101,-440,-0.853689295900351,0.853689295900351
"21","075","050","Fulton County",6515,5962,-553,-8.48810437452034,8.48810437452034
"21","077","050","Gallatin County",8690,8799,109,1.25431530494822,1.25431530494822
"21","079","050","Garrard County",16953,17741,788,4.64814487111426,4.64814487111426
"21","081","050","Grant County",24941,25353,412,1.65189848041378,1.65189848041378
"21","083","050","Graves County",36649,36934,285,0.777647411934841,0.777647411934841
"21","085","050","Grayson County",26420,26479,59,0.22331566994701,0.22331566994701
"21","087","050","Green County",11107,10996,-111,-0.999369766813721,0.999369766813721
"21","089","050","Greenup County",35962,34975,-987,-2.74456370613425,2.74456370613425
"21","091","050","Hancock County",9095,8740,-355,-3.90324354040682,3.90324354040682
"21","093","050","Hardin County",110702,111271,569,0.513992520460335,0.513992520460335
"21","095","050","Harlan County",26831,25675,-1156,-4.30844918191644,4.30844918191644
"21","097","050","Harrison County",18692,18914,222,1.18767387117483,1.18767387117483
"21","099","050","Hart County",19288,19047,-241,-1.24948154292825,1.24948154292825
"21","101","050","Henderson County",44793,44891,98,0.218784185028911,0.218784185028911
"21","103","050","Henry County",15678,16091,413,2.63426457456308,2.63426457456308
"21","105","050","Hickman County",4521,4372,-149,-3.29573103295731,3.29573103295731
"21","107","050","Hopkins County",45423,44681,-742,-1.63353367236862,1.63353367236862
"21","109","050","Jackson County",12955,13339,384,2.96410652257816,2.96410652257816
"21","111","050","Jefferson County",782969,767935,-15034,-1.92012710592629,1.92012710592629
"21","113","050","Jessamine County",52991,54070,1079,2.03619482553641,2.03619482553641
"21","115","050","Johnson County",22680,22053,-627,-2.76455026455026,2.76455026455026
"21","117","050","Kenton County",169064,167846,-1218,-0.720437230871149,0.720437230871149
"21","119","050","Knott County",14251,14600,349,2.44895095081047,2.44895095081047
"21","121","050","Knox County",30193,31074,881,2.91789487629583,2.91789487629583
"21","123","050","Larue County",14867,14411,-456,-3.06719580278469,3.06719580278469
"21","125","050","Laurel County",62613,61156,-1457,-2.32699279702298,2.32699279702298
"21","127","050","Lawrence County",16293,15430,-863,-5.29675320689867,5.29675320689867
"21","129","050","Lee County",7395,7304,-91,-1.23056118999324,1.23056118999324
"21","131","050","Leslie County",10513,9704,-809,-7.69523447160658,7.69523447160658
"21","133","050","Letcher County",21548,21300,-248,-1.15091887878225,1.15091887878225
"21","135","050","Lewis County",13080,13276,196,1.49847094801223,1.49847094801223
"21","137","050","Lincoln County",24275,24481,206,0.848609680741504,0.848609680741504
"21","139","050","Livingston County",8888,9062,174,1.95769576957696,1.95769576957696
"21","141","050","Logan County",27432,27349,-83,-0.302566345873433,0.302566345873433
"21","143","050","Lyon County",8680,8160,-520,-5.99078341013825,5.99078341013825
"21","145","050","McCracken County",67875,65649,-2226,-3.27955801104972,3.27955801104972
"21","147","050","McCreary County",16888,17122,234,1.38559924206537,1.38559924206537
"21","149","050","McLean County",9152,9104,-48,-0.524475524475524,0.524475524475524
"21","151","050","Madison County",92701,93997,1296,1.39804317105533,1.39804317105533
"21","153","050","Magoffin County",11637,12060,423,3.63495746326373,3.63495746326373
"21","155","050","Marion County",19581,19287,-294,-1.50145549256933,1.50145549256933
"21","157","050","Marshall County",31659,31149,-510,-1.61091632711077,1.61091632711077
"21","159","050","Martin County",11287,11081,-206,-1.8251085319394,1.8251085319394
"21","161","050","Mason County",17120,17029,-91,-0.531542056074766,0.531542056074766
"21","163","050","Meade County",30003,28609,-1394,-4.64620204646202,4.64620204646202
"21","165","050","Menifee County",6113,6499,386,6.31441190904629,6.31441190904629
"21","167","050","Mercer County",22641,21885,-756,-3.33907512919041,3.33907512919041
"21","169","050","Metcalfe County",10286,10050,-236,-2.2943807116469,2.2943807116469
"21","171","050","Monroe County",11338,10576,-762,-6.72076203916035,6.72076203916035
"21","173","050","Montgomery County",28114,28172,58,0.206302909582414,0.206302909582414
"21","175","050","Morgan County",13726,13182,-544,-3.96328136383506,3.96328136383506
"21","177","050","Muhlenberg County",30928,30510,-418,-1.351526125194,1.351526125194
"21","179","050","Nelson County",46738,46403,-335,-0.716761521674013,0.716761521674013
"21","181","050","Nicholas County",7537,7230,-307,-4.07323868913361,4.07323868913361
"21","183","050","Ohio County",23772,23936,164,0.689887262325425,0.689887262325425
"21","185","050","Oldham County",67607,66961,-646,-0.955522357152366,0.955522357152366
"21","187","050","Owen County",11278,10972,-306,-2.71324702961518,2.71324702961518
"21","189","050","Owsley County",4051,4348,297,7.33152308072081,7.33152308072081
"21","191","050","Pendleton County",14644,14575,-69,-0.471182736957116,0.471182736957116
"21","193","050","Perry County",28473,25538,-2935,-10.3080110982334,10.3080110982334
"21","195","050","Pike County",58669,57266,-1403,-2.39138216093678,2.39138216093678
"21","197","050","Powell County",13129,12226,-903,-6.8779038769137,6.8779038769137
"21","199","050","Pulaski County",65034,65458,424,0.651966663591352,0.651966663591352
"21","201","050","Robertson County",2193,2140,-53,-2.41678066575467,2.41678066575467
"21","203","050","Rockcastle County",16037,16738,701,4.37114173473842,4.37114173473842
"21","205","050","Rowan County",24662,24646,-16,-0.0648771389181737,0.0648771389181737
"21","207","050","Russell County",17991,17963,-28,-0.155633372241676,0.155633372241676
"21","209","050","Scott County",57155,58116,961,1.68139270405039,1.68139270405039
"21","211","050","Shelby County",48065,49452,1387,2.88567564756059,2.88567564756059
"21","213","050","Simpson County",19594,18607,-987,-5.03725630294988,5.03725630294988
"21","215","050","Spencer County",19490,19497,7,0.0359158542842483,0.0359158542842483
"21","217","050","Taylor County",26023,25693,-330,-1.26810898051723,1.26810898051723
"21","219","050","Todd County",12243,12417,174,1.42122028914482,1.42122028914482
"21","221","050","Trigg County",14061,14736,675,4.80051205461916,4.80051205461916
"21","223","050","Trimble County",8474,8474,0,0,0
"21","225","050","Union County",13668,14434,766,5.60433128475271,5.60433128475271
"21","227","050","Warren County",134554,134118,-436,-0.324033473549653,0.324033473549653
"21","229","050","Washington County",12027,12122,95,0.789889415481832,0.789889415481832
"21","231","050","Wayne County",19555,20203,648,3.31373050370749,3.31373050370749
"21","233","050","Webster County",13017,12914,-103,-0.791272950756703,0.791272950756703
"21","235","050","Whitley County",36712,36408,-304,-0.828067117018958,0.828067117018958
"21","237","050","Wolfe County",6562,7112,550,8.38159097836026,8.38159097836026
"21","239","050","Woodford County",26871,26721,-150,-0.558222619180529,0.558222619180529
"22","001","050","Acadia Parish",57576,62032,4456,7.73933583437543,7.73933583437543
"22","003","050","Allen Parish",22750,25509,2759,12.1274725274725,12.1274725274725
"22","005","050","Ascension Parish",126500,128291,1791,1.41581027667984,1.41581027667984
"22","007","050","Assumption Parish",21039,21734,695,3.30338894434146,3.30338894434146
"22","009","050","Avoyelles Parish",39693,40053,360,0.906960925100144,0.906960925100144
"22","011","050","Beauregard Parish",36549,37866,1317,3.6033817614709,3.6033817614709
"22","013","050","Bienville Parish",12981,13053,72,0.554656806101225,0.554656806101225
"22","015","050","Bossier Parish",128746,127400,-1346,-1.04546937380579,1.04546937380579
"22","017","050","Caddo Parish",237848,238399,551,0.231660556321684,0.231660556321684
"22","019","050","Calcasieu Parish",216785,203623,-13162,-6.07145328320686,6.07145328320686
"22","021","050","Caldwell Parish",9645,9878,233,2.41575946086055,2.41575946086055
"22","023","050","Cameron Parish",5617,7008,1391,24.7641089549582,24.7641089549582
"22","025","050","Catahoula Parish",8906,9292,386,4.3341567482596,4.3341567482596
"22","027","050","Claiborne Parish",14170,15576,1406,9.92237120677488,9.92237120677488
"22","029","050","Concordia Parish",18687,19034,347,1.85690587039118,1.85690587039118
"22","031","050","De Soto Parish",26812,27643,831,3.09935849619573,3.09935849619573
"22","033","050","East Baton Rouge Parish",456781,440452,-16329,-3.57479842637938,3.57479842637938
"22","035","050","East Carroll Parish",7459,6646,-813,-10.899584394691,10.899584394691
"22","037","050","East Feliciana Parish",19539,18966,-573,-2.93259634577,2.93259634577
"22","039","050","Evangeline Parish",32350,33325,975,3.01391035548686,3.01391035548686
"22","041","050","Franklin Parish",19774,19809,35,0.177000101142915,0.177000101142915
"22","043","050","Grant Parish",22169,22283,114,0.514231584645225,0.514231584645225
"22","045","050","Iberia Parish",69929,69204,-725,-1.0367658625177,1.0367658625177
"22","047","050","Iberville Parish",30241,32207,1966,6.50110776760028,6.50110776760028
"22","049","050","Jackson Parish",15031,15633,602,4.00505621715122,4.00505621715122
"22","051","050","Jefferson Parish",440781,433079,-7702,-1.74735299389039,1.74735299389039
"22","053","050","Jefferson Davis Parish",32250,31297,-953,-2.95503875968992,2.95503875968992
"22","055","050","Lafayette Parish",241753,246211,4458,1.84403089103341,1.84403089103341
"22","057","050","Lafourche Parish",97557,97659,102,0.104554260586119,0.104554260586119
"22","059","050","LaSalle Parish",14791,14990,199,1.34541275099723,1.34541275099723
"22","061","050","Lincoln Parish",48396,46641,-1755,-3.62633275477312,3.62633275477312
"22","063","050","Livingston Parish",142282,143240,958,0.673310749075779,0.673310749075779
"22","065","050","Madison Parish",10017,10736,719,7.17779774383548,7.17779774383548
"22","067","050","Morehouse Parish",25629,24382,-1247,-4.86558195793827,4.86558195793827
"22","069","050","Natchitoches Parish",37515,37797,282,0.751699320271891,0.751699320271891
"22","071","050","Orleans Parish",383997,390153,6156,1.60313752451191,1.60313752451191
"22","073","050","Ouachita Parish",160368,152757,-7611,-4.74595929362466,4.74595929362466
"22","075","050","Plaquemines Parish",23515,23154,-361,-1.53519030406124,1.53519030406124
"22","077","050","Pointe Coupee Parish",20758,21593,835,4.02254552461702,4.02254552461702
"22","079","050","Rapides Parish",130023,128944,-1079,-0.829853179822031,0.829853179822031
"22","081","050","Red River Parish",7620,8313,693,9.09448818897638,9.09448818897638
"22","083","050","Richland Parish",20043,20052,9,0.0449034575662326,0.0449034575662326
"22","085","050","Sabine Parish",22155,23829,1674,7.55585646580907,7.55585646580907
"22","087","050","St. Bernard Parish",43764,47553,3789,8.6578009322731,8.6578009322731
"22","089","050","St. Charles Parish",52549,53014,465,0.884888389883728,0.884888389883728
"22","091","050","St. Helena Parish",10920,10090,-830,-7.6007326007326,7.6007326007326
"22","093","050","St. James Parish",20192,20805,613,3.0358557844691,3.0358557844691
"22","095","050","St. John the Baptist Parish",42477,42591,114,0.268380535348542,0.268380535348542
"22","097","050","St. Landry Parish",82540,81649,-891,-1.07947661739763,1.07947661739763
"22","099","050","St. Martin Parish",51767,53102,1335,2.57886298220874,2.57886298220874
"22","101","050","St. Mary Parish",49406,48587,-819,-1.65769339756305,1.65769339756305
"22","103","050","St. Tammany Parish",264570,262999,-1571,-0.593793702989757,0.593793702989757
"22","105","050","Tangipahoa Parish",133157,136313,3156,2.37013450288006,2.37013450288006
"22","107","050","Tensas Parish",4147,4202,55,1.3262599469496,1.3262599469496
"22","109","050","Terrebonne Parish",109580,110086,506,0.461763095455375,0.461763095455375
"22","111","050","Union Parish",21107,22152,1045,4.95096413512105,4.95096413512105
"22","113","050","Vermilion Parish",57359,59431,2072,3.61233633780226,3.61233633780226
"22","115","050","Vernon Parish",48750,47996,-754,-1.54666666666667,1.54666666666667
"22","117","050","Washington Parish",45463,45864,401,0.882035941314915,0.882035941314915
"22","119","050","Webster Parish",36967,38017,1050,2.8403711418292,2.8403711418292
"22","121","050","West Baton Rouge Parish",27199,26737,-462,-1.69859185999485,1.69859185999485
"22","123","050","West Carroll Parish",9751,10702,951,9.75284586196288,9.75284586196288
"22","125","050","West Feliciana Parish",15310,15491,181,1.18223383409536,1.18223383409536
"22","127","050","Winn Parish",13755,13860,105,0.763358778625954,0.763358778625954
"23","001","050","Androscoggin County",111139,108597,-2542,-2.28722590629752,2.28722590629752
"23","003","050","Aroostook County",67105,66945,-160,-0.238432307577677,0.238432307577677
"23","005","050","Cumberland County",303069,297753,-5316,-1.7540560070479,1.7540560070479
"23","007","050","Franklin County",29456,30021,565,1.91811515480717,1.91811515480717
"23","009","050","Hancock County",55478,55149,-329,-0.593027866902195,0.593027866902195
"23","011","050","Kennebec County",123642,122842,-800,-0.647029326604228,0.647029326604228
"23","013","050","Knox County",40607,39936,-671,-1.65242445883715,1.65242445883715
"23","015","050","Lincoln County",35237,34791,-446,-1.2657150154667,1.2657150154667
"23","017","050","Oxford County",57777,58084,307,0.531353306679128,0.531353306679128
"23","019","050","Penobscot County",152199,151730,-469,-0.308149199403413,0.308149199403413
"23","021","050","Piscataquis County",16800,16973,173,1.0297619047619,1.0297619047619
"23","023","050","Sagadahoc County",36699,36054,-645,-1.75754107741355,1.75754107741355
"23","025","050","Somerset County",50477,50658,181,0.358579154862611,0.358579154862611
"23","027","050","Waldo County",39607,39871,264,0.666548842376348,0.666548842376348
"23","029","050","Washington County",31095,31423,328,1.05483196655411,1.05483196655411
"23","031","050","York County",211972,208820,-3152,-1.48698884758364,1.48698884758364
"24","001","050","Allegany County",68106,70217,2111,3.09958006636713,3.09958006636713
"24","003","050","Anne Arundel County",588261,582384,-5877,-0.999046341674869,0.999046341674869
"24","005","050","Baltimore County",854535,827220,-27315,-3.19647527602731,3.19647527602731
"24","009","050","Calvert County",92783,93033,250,0.26944591142774,0.26944591142774
"24","011","050","Caroline County",33293,33521,228,0.684828642657616,0.684828642657616
"24","013","050","Carroll County",172891,169105,-3786,-2.18981901891943,2.18981901891943
"24","015","050","Cecil County",103725,103409,-316,-0.304651723306821,0.304651723306821
"24","017","050","Charles County",166617,164382,-2235,-1.34139973712166,1.34139973712166
"24","019","050","Dorchester County",32531,31886,-645,-1.98272417079094,1.98272417079094
"24","021","050","Frederick County",271717,264158,-7559,-2.78193856107641,2.78193856107641
"24","023","050","Garrett County",28806,28916,110,0.381864889259182,0.381864889259182
"24","025","050","Harford County",260924,256602,-4322,-1.65642102681241,1.65642102681241
"24","027","050","Howard County",332317,327874,-4443,-1.33697644116912,1.33697644116912
"24","029","050","Kent County",19198,19282,84,0.43754557766434,0.43754557766434
"24","031","050","Montgomery County",1062061,1052462,-9599,-0.903808726617398,0.903808726617398
"24","033","050","Prince George's County",967201,910800,-56401,-5.83136287079935,5.83136287079935
"24","035","050","Queen Anne's County",49874,51045,1171,2.34791675021053,2.34791675021053
"24","037","050","St. Mary's County",113777,114489,712,0.625785527830757,0.625785527830757
"24","039","050","Somerset County",24620,25482,862,3.50121852152721,3.50121852152721
"24","041","050","Talbot County",37526,37060,-466,-1.24180568139423,1.24180568139423
"24","043","050","Washington County",154705,151158,-3547,-2.29275071911057,2.29275071911057
"24","045","050","Wicomico County",103588,104018,430,0.41510599683361,0.41510599683361
"24","047","050","Worcester County",52460,52377,-83,-0.15821578345406,0.15821578345406
"24","510","050","Baltimore city",585708,588649,2941,0.50212733990316,0.50212733990316
"25","001","050","Barnstable County",228996,213296,-15700,-6.85601495222624,6.85601495222624
"25","003","050","Berkshire County",129026,124804,-4222,-3.27220870212205,3.27220870212205
"25","005","050","Bristol County",579200,566625,-12575,-2.17109806629834,2.17109806629834
"25","007","050","Dukes County",20600,17474,-3126,-15.1747572815534,15.1747572815534
"25","009","050","Essex County",809829,791347,-18482,-2.28221019499178,2.28221019499178
"25","011","050","Franklin County",71029,70323,-706,-0.993960213433949,0.993960213433949
"25","013","050","Hampden County",465825,464723,-1102,-0.236569527182955,0.236569527182955
"25","015","050","Hampshire County",162308,161518,-790,-0.486728935111023,0.486728935111023
"25","017","050","Middlesex County",1632002,1610956,-21046,-1.28958175296354,1.28958175296354
"25","019","050","Nantucket County",14255,11353,-2902,-20.3577692037881,20.3577692037881
"25","021","050","Norfolk County",725981,709317,-16664,-2.29537687625434,2.29537687625434
"25","023","050","Plymouth County",530819,523502,-7317,-1.37843596404801,1.37843596404801
"25","025","050","Suffolk County",797936,803229,5293,0.663336407932466,0.663336407932466
"25","027","050","Worcester County",862111,829649,-32462,-3.76540839868648,3.76540839868648
"26","001","050","Alcona County",10167,10510,343,3.37365988000393,3.37365988000393
"26","003","050","Alger County",8842,9050,208,2.35240895724949,2.35240895724949
"26","005","050","Allegan County",120502,118779,-1723,-1.42985178669234,1.42985178669234
"26","007","050","Alpena County",28907,28306,-601,-2.07908119140693,2.07908119140693
"26","009","050","Antrim County",23431,23461,30,0.128035508514361,0.128035508514361
"26","011","050","Arenac County",15002,14989,-13,-0.0866551126516464,0.0866551126516464
"26","013","050","Baraga County",8158,8205,47,0.576121598430988,0.576121598430988
"26","015","050","Barry County",62423,61972,-451,-0.722490107812825,0.722490107812825
"26","017","050","Bay County",103856,102596,-1260,-1.21321830226467,1.21321830226467
"26","019","050","Benzie County",17970,17852,-118,-0.656649972175849,0.656649972175849
"26","021","050","Berrien County",154316,153226,-1090,-0.706342829000233,0.706342829000233
"26","023","050","Branch County",44862,43479,-1383,-3.08278721412331,3.08278721412331
"26","025","050","Calhoun County",134310,133733,-577,-0.429603156875884,0.429603156875884
"26","027","050","Cass County",51589,51688,99,0.191901374323984,0.191901374323984
"26","029","050","Charlevoix County",26054,26159,105,0.403009134873724,0.403009134873724
"26","031","050","Cheboygan County",25579,25380,-199,-0.777981938308769,0.777981938308769
"26","033","050","Chippewa County",36785,37064,279,0.758461329346201,0.758461329346201
"26","035","050","Clare County",30856,30840,-16,-0.0518537723619393,0.0518537723619393
"26","037","050","Clinton County",79128,79777,649,0.820190071782428,0.820190071782428
"26","039","050","Crawford County",12988,14000,1012,7.79180782260548,7.79180782260548
"26","041","050","Delta County",36903,35675,-1228,-3.3276427390727,3.3276427390727
"26","043","050","Dickinson County",25947,25189,-758,-2.92133965390989,2.92133965390989
"26","045","050","Eaton County",109175,110195,1020,0.934279825967483,0.934279825967483
"26","047","050","Emmet County",34112,33368,-744,-2.18105065666041,2.18105065666041
"26","049","050","Genesee County",406211,405242,-969,-0.238545977336901,0.238545977336901
"26","051","050","Gladwin County",25386,25440,54,0.212715670054361,0.212715670054361
"26","053","050","Gogebic County",14380,13890,-490,-3.40751043115438,3.40751043115438
"26","055","050","Grand Traverse County",95238,93515,-1723,-1.80915180915181,1.80915180915181
"26","057","050","Gratiot County",41761,40415,-1346,-3.22310289504562,3.22310289504562
"26","059","050","Hillsdale County",45746,45664,-82,-0.179250644865125,0.179250644865125
"26","061","050","Houghton County",37361,35285,-2076,-5.55659645084446,5.55659645084446
"26","063","050","Huron County",31407,30721,-686,-2.18422644633362,2.18422644633362
"26","065","050","Ingham County",284900,290986,6086,2.13618813618814,2.13618813618814
"26","067","050","Ionia County",66804,64600,-2204,-3.29920364050057,3.29920364050057
"26","069","050","Iosco County",25237,25185,-52,-0.206046677497325,0.206046677497325
"26","071","050","Iron County",11631,11074,-557,-4.78892614564526,4.78892614564526
"26","073","050","Isabella County",64394,69581,5187,8.05509830108395,8.05509830108395
"26","075","050","Jackson County",160366,157359,-3007,-1.87508574136662,1.87508574136662
"26","077","050","Kalamazoo County",261670,266005,4335,1.65666679405358,1.65666679405358
"26","079","050","Kalkaska County",17939,18010,71,0.395785718267462,0.395785718267462
"26","081","050","Kent County",657974,658530,556,0.0845018192208203,0.0845018192208203
"26","083","050","Keweenaw County",2046,2110,64,3.12805474095797,3.12805474095797
"26","085","050","Lake County",12096,11624,-472,-3.9021164021164,3.9021164021164
"26","087","050","Lapeer County",88619,87726,-893,-1.00768458231305,1.00768458231305
"26","089","050","Leelanau County",22301,21732,-569,-2.55145509169992,2.55145509169992
"26","091","050","Lenawee County",99423,98041,-1382,-1.39002041781077,1.39002041781077
"26","093","050","Livingston County",193866,192338,-1528,-0.788173274323502,0.788173274323502
"26","095","050","Luce County",5339,6149,810,15.1713804083162,15.1713804083162
"26","097","050","Mackinac County",10834,10832,-2,-0.0184604024367731,0.0184604024367731
"26","099","050","Macomb County",881217,871621,-9596,-1.08894857906736,1.08894857906736
"26","101","050","Manistee County",25032,24695,-337,-1.34627676573985,1.34627676573985
"26","103","050","Marquette County",66017,66067,50,0.0757380674674705,0.0757380674674705
"26","105","050","Mason County",29052,29170,118,0.406168250034421,0.406168250034421
"26","107","050","Mecosta County",39714,43841,4127,10.391801379866,10.391801379866
"26","109","050","Menominee County",23502,22645,-857,-3.64649817036848,3.64649817036848
"26","111","050","Midland County",83494,83470,-24,-0.0287445804488945,0.0287445804488945
"26","113","050","Missaukee County",15052,15141,89,0.591283550358756,0.591283550358756
"26","115","050","Monroe County",154809,150577,-4232,-2.73369119366445,2.73369119366445
"26","117","050","Montcalm County",66614,63548,-3066,-4.60263608250518,4.60263608250518
"26","119","050","Montmorency County",9153,9327,174,1.9010160603081,1.9010160603081
"26","121","050","Muskegon County",175824,173897,-1927,-1.09598234598235,1.09598234598235
"26","123","050","Newaygo County",49978,49267,-711,-1.42262595542038,1.42262595542038
"26","125","050","Oakland County",1274395,1255261,-19134,-1.5014183200656,1.5014183200656
"26","127","050","Oceana County",26659,26762,103,0.386361078810158,0.386361078810158
"26","129","050","Ogemaw County",20770,20921,151,0.727010110736639,0.727010110736639
"26","131","050","Ontonagon County",5816,5672,-144,-2.47592847317744,2.47592847317744
"26","133","050","Osceola County",22891,23432,541,2.36337425188939,2.36337425188939
"26","135","050","Oscoda County",8219,8354,135,1.64253558827108,1.64253558827108
"26","137","050","Otsego County",25091,24719,-372,-1.482603323901,1.482603323901
"26","139","050","Ottawa County",296200,293970,-2230,-0.75286968264686,0.75286968264686
"26","141","050","Presque Isle County",12982,12653,-329,-2.53427823139732,2.53427823139732
"26","143","050","Roscommon County",23459,23978,519,2.21237051877744,2.21237051877744
"26","145","050","Saginaw County",190124,190103,-21,-0.0110454229871032,0.0110454229871032
"26","147","050","St. Clair County",160383,159349,-1034,-0.644706733257265,0.644706733257265
"26","149","050","St. Joseph County",60939,60872,-67,-0.109946011585356,0.109946011585356
"26","151","050","Sanilac County",40611,40857,246,0.605747211346679,0.605747211346679
"26","153","050","Schoolcraft County",8047,8087,40,0.497079657015037,0.497079657015037
"26","155","050","Shiawassee County",68094,67809,-285,-0.418539078332893,0.418539078332893
"26","157","050","Tuscola County",53323,52313,-1010,-1.89411698516588,1.89411698516588
"26","159","050","Van Buren County",75587,75524,-63,-0.0833476656038737,0.0833476656038737
"26","161","050","Washtenaw County",372258,367108,-5150,-1.38344911324941,1.38344911324941
"26","163","050","Wayne County",1793561,1744071,-49490,-2.75931512783786,2.75931512783786
"26","165","050","Wexford County",33673,33702,29,0.0861224126154486,0.0861224126154486
"27","001","050","Aitkin County",15697,15877,180,1.14671593298082,1.14671593298082
"27","003","050","Anoka County",363887,359504,-4383,-1.20449480195775,1.20449480195775
"27","005","050","Becker County",35183,34515,-668,-1.89864423158912,1.89864423158912
"27","007","050","Beltrami County",46228,47438,1210,2.6174612788786,2.6174612788786
"27","009","050","Benton County",41379,40999,-380,-0.91834022088499,0.91834022088499
"27","011","050","Big Stone County",5166,4941,-225,-4.35540069686411,4.35540069686411
"27","013","050","Blue Earth County",69112,68220,-892,-1.29065864104642,1.29065864104642
"27","015","050","Brown County",25912,24910,-1002,-3.86693423896264,3.86693423896264
"27","017","050","Carlton County",36207,35826,-381,-1.05228270776369,1.05228270776369
"27","019","050","Carver County",106922,106250,-672,-0.628495538803988,0.628495538803988
"27","021","050","Cass County",30066,29892,-174,-0.578726801037717,0.578726801037717
"27","023","050","Chippewa County",12598,11781,-817,-6.48515637402762,6.48515637402762
"27","025","050","Chisago County",56621,56763,142,0.250790342805673,0.250790342805673
"27","027","050","Clay County",65318,64668,-650,-0.995131510456536,0.995131510456536
"27","029","050","Clearwater County",8524,8980,456,5.34960112623182,5.34960112623182
"27","031","050","Cook County",5600,5429,-171,-3.05357142857143,3.05357142857143
"27","033","050","Cottonwood County",11517,11277,-240,-2.08387600937744,2.08387600937744
"27","035","050","Crow Wing County",66123,65573,-550,-0.831783191930191,0.831783191930191
"27","037","050","Dakota County",439882,431437,-8445,-1.9198330461351,1.9198330461351
"27","039","050","Dodge County",20867,21007,140,0.670915800067092,0.670915800067092
"27","041","050","Douglas County",39006,38300,-706,-1.80997795210993,1.80997795210993
"27","043","050","Faribault County",13921,13649,-272,-1.95388262337476,1.95388262337476
"27","045","050","Fillmore County",21228,21138,-90,-0.423968343697004,0.423968343697004
"27","047","050","Freeborn County",30895,30408,-487,-1.57630684576792,1.57630684576792
"27","049","050","Goodhue County",47582,46370,-1212,-2.54718170736833,2.54718170736833
"27","051","050","Grant County",6074,6022,-52,-0.856108001317089,0.856108001317089
"27","053","050","Hennepin County",1281565,1268278,-13287,-1.03677925036967,1.03677925036967
"27","055","050","Houston County",18843,18645,-198,-1.0507880910683,1.0507880910683
"27","057","050","Hubbard County",21344,21756,412,1.93028485757121,1.93028485757121
"27","059","050","Isanti County",41135,41221,86,0.209067703901787,0.209067703901787
"27","061","050","Itasca County",45014,45275,261,0.579819611676367,0.579819611676367
"27","063","050","Jackson County",9989,9789,-200,-2.00220242266493,2.00220242266493
"27","065","050","Kanabec County",16032,16409,377,2.35154690618762,2.35154690618762
"27","067","050","Kandiyohi County",43732,43154,-578,-1.32168663678771,1.32168663678771
"27","069","050","Kittson County",4207,4231,24,0.570477775136677,0.570477775136677
"27","071","050","Koochiching County",12062,12107,45,0.37307245896203,0.37307245896203
"27","073","050","Lac qui Parle County",6719,6556,-163,-2.42595624348861,2.42595624348861
"27","075","050","Lake County",10905,10651,-254,-2.32920678587804,2.32920678587804
"27","077","050","Lake of the Woods County",3763,3756,-7,-0.186021791124103,0.186021791124103
"27","079","050","Le Sueur County",28674,28791,117,0.408035153797866,0.408035153797866
"27","081","050","Lincoln County",5640,5587,-53,-0.939716312056738,0.939716312056738
"27","083","050","Lyon County",25269,25374,105,0.415528908939808,0.415528908939808
"27","085","050","McLeod County",36771,35758,-1013,-2.75488836311224,2.75488836311224
"27","087","050","Mahnomen County",5411,5475,64,1.18277582701904,1.18277582701904
"27","089","050","Marshall County",9040,9332,292,3.23008849557522,3.23008849557522
"27","091","050","Martin County",20025,19537,-488,-2.43695380774032,2.43695380774032
"27","093","050","Meeker County",23400,23314,-86,-0.367521367521368,0.367521367521368
"27","095","050","Mille Lacs County",26459,26139,-320,-1.20941834536453,1.20941834536453
"27","097","050","Morrison County",34010,33229,-781,-2.29638341664216,2.29638341664216
"27","099","050","Mower County",40029,40135,106,0.264808014189712,0.264808014189712
"27","101","050","Murray County",8179,8167,-12,-0.146717202592004,0.146717202592004
"27","103","050","Nicollet County",34454,34458,4,0.0116096824751843,0.0116096824751843
"27","105","050","Nobles County",22290,21488,-802,-3.59802602063706,3.59802602063706
"27","107","050","Norman County",6441,6345,-96,-1.49045179319981,1.49045179319981
"27","109","050","Olmsted County",162847,159124,-3723,-2.28619501740898,2.28619501740898
"27","111","050","Otter Tail County",60081,58738,-1343,-2.23531565719612,2.23531565719612
"27","113","050","Pennington County",13992,13917,-75,-0.536020583190394,0.536020583190394
"27","115","050","Pine County",28876,29390,514,1.78002493420141,1.78002493420141
"27","117","050","Pipestone County",9424,9118,-306,-3.24702886247878,3.24702886247878
"27","119","050","Polk County",31192,30994,-198,-0.634778148243139,0.634778148243139
"27","121","050","Pope County",11308,11264,-44,-0.389105058365759,0.389105058365759
"27","123","050","Ramsey County",552352,548750,-3602,-0.652120386999595,0.652120386999595
"27","125","050","Red Lake County",3935,4033,98,2.49047013977128,2.49047013977128
"27","127","050","Redwood County",15425,15099,-326,-2.11345218800648,2.11345218800648
"27","129","050","Renville County",14723,14436,-287,-1.94933097874075,1.94933097874075
"27","131","050","Rice County",67097,67089,-8,-0.0119230367974723,0.0119230367974723
"27","133","050","Rock County",9704,9305,-399,-4.11170651277824,4.11170651277824
"27","135","050","Roseau County",15331,15104,-227,-1.48066010045007,1.48066010045007
"27","137","050","St. Louis County",200231,198761,-1470,-0.734152054377194,0.734152054377194
"27","139","050","Scott County",150928,150307,-621,-0.411454468355772,0.411454468355772
"27","141","050","Sherburne County",97183,98469,1286,1.32327670477347,1.32327670477347
"27","143","050","Sibley County",14836,14762,-74,-0.498786734968994,0.498786734968994
"27","145","050","Stearns County",158292,161860,3568,2.25406211305688,2.25406211305688
"27","147","050","Steele County",37406,36635,-771,-2.06116665775544,2.06116665775544
"27","149","050","Stevens County",9671,9747,76,0.785854616895874,0.785854616895874
"27","151","050","Swift County",9838,9180,-658,-6.68835129091279,6.68835129091279
"27","153","050","Todd County",25262,24738,-524,-2.07426173699628,2.07426173699628
"27","155","050","Traverse County",3360,3208,-152,-4.52380952380952,4.52380952380952
"27","157","050","Wabasha County",21387,21608,221,1.03333800907093,1.03333800907093
"27","159","050","Wadena County",14065,13752,-313,-2.22538215428368,2.22538215428368
"27","161","050","Waseca County",18968,18548,-420,-2.21425558835934,2.21425558835934
"27","163","050","Washington County",267568,264834,-2734,-1.02179632840997,1.02179632840997
"27","165","050","Watonwan County",11253,10806,-447,-3.9722740602506,3.9722740602506
"27","167","050","Wilkin County",6506,6170,-336,-5.1644635720873,5.1644635720873
"27","169","050","Winona County",49671,50537,866,1.7434720460631,1.7434720460631
"27","171","050","Wright County",141337,139840,-1497,-1.0591706347241,1.0591706347241
"27","173","050","Yellow Medicine County",9528,9601,73,0.766162888329135,0.766162888329135
"28","001","050","Adams County",29538,30446,908,3.07400636468278,3.07400636468278
"28","003","050","Alcorn County",34740,36981,2241,6.45077720207254,6.45077720207254
"28","005","050","Amite County",12720,12250,-470,-3.69496855345912,3.69496855345912
"28","007","050","Attala County",17889,18077,188,1.05092514953323,1.05092514953323
"28","009","050","Benton County",7646,8347,701,9.16819251896417,9.16819251896417
"28","011","050","Bolivar County",30985,30335,-650,-2.09778925286429,2.09778925286429
"28","013","050","Calhoun County",13266,14292,1026,7.73405698778833,7.73405698778833
"28","015","050","Carroll County",9998,9790,-208,-2.08041608321664,2.08041608321664
"28","017","050","Chickasaw County",17106,16992,-114,-0.666432830585759,0.666432830585759
"28","019","050","Choctaw County",8246,8100,-146,-1.77055542081009,1.77055542081009
"28","021","050","Claiborne County",9135,8944,-191,-2.09085933223864,2.09085933223864
"28","023","050","Clarke County",15615,15371,-244,-1.56260006404099,1.56260006404099
"28","025","050","Clay County",18636,19375,739,3.96544322816055,3.96544322816055
"28","027","050","Coahoma County",21390,21723,333,1.55680224403927,1.55680224403927
"28","029","050","Copiah County",28368,28029,-339,-1.19500846023689,1.19500846023689
"28","031","050","Covington County",18340,18560,220,1.19956379498364,1.19956379498364
"28","033","050","DeSoto County",185314,187678,2364,1.27567264211015,1.27567264211015
"28","035","050","Forrest County",78158,75083,-3075,-3.93433813557153,3.93433813557153
"28","037","050","Franklin County",7675,7671,-4,-0.0521172638436482,0.0521172638436482
"28","039","050","George County",24350,24446,96,0.394250513347023,0.394250513347023
"28","041","050","Greene County",13530,13507,-23,-0.169992609016999,0.169992609016999
"28","043","050","Grenada County",21629,20673,-956,-4.41999167783994,4.41999167783994
"28","045","050","Hancock County",46053,47966,1913,4.15390962586585,4.15390962586585
"28","047","050","Harrison County",208621,208696,75,0.0359503597432665,0.0359503597432665
"28","049","050","Hinds County",227742,229130,1388,0.609461583721931,0.609461583721931
"28","051","050","Holmes County",17000,16808,-192,-1.12941176470588,1.12941176470588
"28","053","050","Humphreys County",7785,7908,123,1.57996146435453,1.57996146435453
"28","055","050","Issaquena County",1338,1252,-86,-6.42750373692078,6.42750373692078
"28","057","050","Itawamba County",23863,23300,-563,-2.35930100993169,2.35930100993169
"28","059","050","Jackson County",143252,143776,524,0.365788959316449,0.365788959316449
"28","061","050","Jasper County",16367,16354,-13,-0.079428117553614,0.079428117553614
"28","063","050","Jefferson County",7260,7000,-260,-3.58126721763085,3.58126721763085
"28","065","050","Jefferson Davis County",11321,10952,-369,-3.25942937903012,3.25942937903012
"28","067","050","Jones County",67246,68118,872,1.29673140409839,1.29673140409839
"28","069","050","Kemper County",8988,9584,596,6.63106364040943,6.63106364040943
"28","071","050","Lafayette County",55813,54411,-1402,-2.51195957930948,2.51195957930948
"28","073","050","Lamar County",64222,64032,-190,-0.295848774563234,0.295848774563234
"28","075","050","Lauderdale County",72984,74036,1052,1.4414118162885,1.4414118162885
"28","077","050","Lawrence County",12016,12515,499,4.15279627163782,4.15279627163782
"28","079","050","Leake County",21275,22779,1504,7.06933019976498,7.06933019976498
"28","081","050","Lee County",83343,85555,2212,2.65409212531346,2.65409212531346
"28","083","050","Leflore County",28339,27957,-382,-1.34796570097745,1.34796570097745
"28","085","050","Lincoln County",34907,34011,-896,-2.56682040851405,2.56682040851405
"28","087","050","Lowndes County",58879,58413,-466,-0.791453659199375,0.791453659199375
"28","089","050","Madison County",109145,106784,-2361,-2.16317742452701,2.16317742452701
"28","091","050","Marion County",24441,24462,21,0.0859211979869891,0.0859211979869891
"28","093","050","Marshall County",33752,35323,1571,4.65453899028206,4.65453899028206
"28","095","050","Monroe County",34180,35177,997,2.91691047396138,2.91691047396138
"28","097","050","Montgomery County",9822,9694,-128,-1.30319690490735,1.30319690490735
"28","099","050","Neshoba County",29087,29026,-61,-0.209715680544573,0.209715680544573
"28","101","050","Newton County",21291,20901,-390,-1.83175989854868,1.83175989854868
"28","103","050","Noxubee County",10285,10286,1,0.00972289742343218,0.00972289742343218
"28","105","050","Oktibbeha County",51788,49760,-2028,-3.91596508843748,3.91596508843748
"28","107","050","Panola County",33208,33919,711,2.14105034931342,2.14105034931342
"28","109","050","Pearl River County",56145,55845,-300,-0.534330750734705,0.534330750734705
"28","111","050","Perry County",11511,11897,386,3.35331422117974,3.35331422117974
"28","113","050","Pike County",40324,39075,-1249,-3.09741097113382,3.09741097113382
"28","115","050","Pontotoc County",31184,32427,1243,3.98601847101077,3.98601847101077
"28","117","050","Prentiss County",25008,25031,23,0.0919705694177863,0.0919705694177863
"28","119","050","Quitman County",6176,6774,598,9.68264248704663,9.68264248704663
"28","121","050","Rankin County",157031,155852,-1179,-0.750807165464144,0.750807165464144
"28","123","050","Scott County",27990,28104,114,0.407288317256163,0.407288317256163
"28","125","050","Sharkey County",3800,4209,409,10.7631578947368,10.7631578947368
"28","127","050","Simpson County",25949,26672,723,2.78623453697638,2.78623453697638
"28","129","050","Smith County",14209,15784,1575,11.0845238933071,11.0845238933071
"28","131","050","Stone County",18333,18339,6,0.0327278677794142,0.0327278677794142
"28","133","050","Sunflower County",25971,24831,-1140,-4.38951137807555,4.38951137807555
"28","135","050","Tallahatchie County",12715,13769,1054,8.2894219425875,8.2894219425875
"28","137","050","Tate County",28064,28463,399,1.42175028506271,1.42175028506271
"28","139","050","Tippah County",21815,21812,-3,-0.0137520055008022,0.0137520055008022
"28","141","050","Tishomingo County",18850,19288,438,2.3236074270557,2.3236074270557
"28","143","050","Tunica County",9782,9423,-359,-3.67000613371499,3.67000613371499
"28","145","050","Union County",27777,28829,1052,3.78730604456925,3.78730604456925
"28","147","050","Walthall County",13884,14294,410,2.9530394698934,2.9530394698934
"28","149","050","Warren County",44722,45004,282,0.630562139439202,0.630562139439202
"28","151","050","Washington County",44922,43125,-1797,-4.00026712969146,4.00026712969146
"28","153","050","Wayne County",19779,20268,489,2.47231912634612,2.47231912634612
"28","155","050","Webster County",9926,9684,-242,-2.43804150715293,2.43804150715293
"28","157","050","Wilkinson County",8587,8423,-164,-1.90986374752533,1.90986374752533
"28","159","050","Winston County",17714,17864,150,0.846787851416958,0.846787851416958
"28","161","050","Yalobusha County",12481,11993,-488,-3.90994311353257,3.90994311353257
"28","163","050","Yazoo County",26743,27619,876,3.2756235276521,3.2756235276521
"29","001","050","Adair County",25314,25470,156,0.616259777198388,0.616259777198388
"29","003","050","Andrew County",18135,17637,-498,-2.74607113316791,2.74607113316791
"29","005","050","Atchison County",5305,5105,-200,-3.77002827521206,3.77002827521206
"29","007","050","Audrain County",24962,24911,-51,-0.204310552039099,0.204310552039099
"29","009","050","Barry County",34534,35893,1359,3.9352522152082,3.9352522152082
"29","011","050","Barton County",11637,11632,-5,-0.042966400274985,0.042966400274985
"29","013","050","Bates County",16042,16266,224,1.39633462161825,1.39633462161825
"29","015","050","Benton County",19394,19624,230,1.18593379395689,1.18593379395689
"29","017","050","Bollinger County",10567,12142,1575,14.9048925901391,14.9048925901391
"29","019","050","Boone County",183610,182643,-967,-0.526659767986493,0.526659767986493
"29","021","050","Buchanan County",84793,86771,1978,2.33273973087401,2.33273973087401
"29","023","050","Butler County",42130,42338,208,0.493709945407073,0.493709945407073
"29","025","050","Caldwell County",8815,9061,246,2.7906976744186,2.7906976744186
"29","027","050","Callaway County",44283,44879,596,1.34588894158029,1.34588894158029
"29","029","050","Camden County",42745,46420,3675,8.5974967832495,8.5974967832495
"29","031","050","Cape Girardeau County",81710,79442,-2268,-2.77567005262514,2.77567005262514
"29","033","050","Carroll County",8495,8602,107,1.25956444967628,1.25956444967628
"29","035","050","Carter County",5202,5995,793,15.2441368704344,15.2441368704344
"29","037","050","Cass County",107824,106618,-1206,-1.11848939011723,1.11848939011723
"29","039","050","Cedar County",14188,14341,153,1.07837609247251,1.07837609247251
"29","041","050","Chariton County",7408,7400,-8,-0.107991360691145,0.107991360691145
"29","043","050","Christian County",88842,90279,1437,1.61747821976092,1.61747821976092
"29","045","050","Clark County",6634,6831,197,2.96955079891468,2.96955079891468
"29","047","050","Clay County",253335,252879,-456,-0.179998815797264,0.179998815797264
"29","049","050","Clinton County",21184,20541,-643,-3.03530966767372,3.03530966767372
"29","051","050","Cole County",77279,76398,-881,-1.14002510384451,1.14002510384451
"29","053","050","Cooper County",17103,17255,152,0.888732970823832,0.888732970823832
"29","055","050","Crawford County",23056,23780,724,3.14018043025677,3.14018043025677
"29","057","050","Dade County",7569,7558,-11,-0.145329634033558,0.145329634033558
"29","059","050","Dallas County",17071,17176,105,0.61507820280007,0.61507820280007
"29","061","050","Daviess County",8430,8291,-139,-1.64887307236062,1.64887307236062
"29","063","050","DeKalb County",11029,10919,-110,-0.997370568501224,0.997370568501224
"29","065","050","Dent County",14421,15512,1091,7.56535607794189,7.56535607794189
"29","067","050","Douglas County",11578,13340,1762,15.2185178787355,15.2185178787355
"29","069","050","Dunklin County",28283,28974,691,2.44316373793445,2.44316373793445
"29","071","050","Franklin County",104682,104374,-308,-0.294224412984085,0.294224412984085
"29","073","050","Gasconade County",14794,14617,-177,-1.19643098553468,1.19643098553468
"29","075","050","Gentry County",6162,6506,344,5.58260305095748,5.58260305095748
"29","077","050","Greene County",298915,294776,-4139,-1.38467457303916,1.38467457303916
"29","079","050","Grundy County",9808,9649,-159,-1.62112561174551,1.62112561174551
"29","081","050","Harrison County",8157,8334,177,2.16991541007723,2.16991541007723
"29","083","050","Henry County",21946,22069,123,0.560466599835961,0.560466599835961
"29","085","050","Hickory County",8279,9567,1288,15.5574344727624,15.5574344727624
"29","087","050","Holt County",4223,4270,47,1.11295287710159,1.11295287710159
"29","089","050","Howard County",10151,10001,-150,-1.47768692739632,1.47768692739632
"29","091","050","Howell County",39750,40238,488,1.22767295597484,1.22767295597484
"29","093","050","Iron County",9537,10123,586,6.1444898815141,6.1444898815141
"29","095","050","Jackson County",717204,705907,-11297,-1.57514458926609,1.57514458926609
"29","097","050","Jasper County",122761,121585,-1176,-0.95795896090778,0.95795896090778
"29","099","050","Jefferson County",226739,226350,-389,-0.171562898310392,0.171562898310392
"29","101","050","Johnson County",54013,54228,215,0.3980523207376,0.3980523207376
"29","103","050","Knox County",3744,3943,199,5.31517094017094,5.31517094017094
"29","105","050","Laclede County",36039,35902,-137,-0.380143733177946,0.380143733177946
"29","107","050","Lafayette County",32984,32977,-7,-0.0212224108658744,0.0212224108658744
"29","109","050","Lawrence County",38001,38220,219,0.576300623667798,0.576300623667798
"29","111","050","Lewis County",10032,9809,-223,-2.22288676236045,2.22288676236045
"29","113","050","Lincoln County",59574,59871,297,0.498539631382818,0.498539631382818
"29","115","050","Linn County",11874,11857,-17,-0.143169951153781,0.143169951153781
"29","117","050","Livingston County",14557,14544,-13,-0.0893041148588308,0.0893041148588308
"29","119","050","McDonald County",23303,22904,-399,-1.71222589366176,1.71222589366176
"29","121","050","Macon County",15209,15109,-100,-0.657505424419751,0.657505424419751
"29","123","050","Madison County",12626,12102,-524,-4.15016632345953,4.15016632345953
"29","125","050","Maries County",8432,8789,357,4.23387096774194,4.23387096774194
"29","127","050","Marion County",28525,28465,-60,-0.21034180543383,0.21034180543383
"29","129","050","Mercer County",3538,3573,35,0.989259468626343,0.989259468626343
"29","131","050","Miller County",24722,25744,1022,4.13396974354826,4.13396974354826
"29","133","050","Mississippi County",12577,12830,253,2.01160849169118,2.01160849169118
"29","135","050","Moniteau County",15473,15647,174,1.12453952045499,1.12453952045499
"29","137","050","Monroe County",8666,8662,-4,-0.0461573967228248,0.0461573967228248
"29","139","050","Montgomery County",11322,11333,11,0.0971559795089207,0.0971559795089207
"29","141","050","Morgan County",21006,20729,-277,-1.31867085594592,1.31867085594592
"29","143","050","New Madrid County",16434,16786,352,2.14190093708166,2.14190093708166
"29","145","050","Newton County",58648,58443,-205,-0.349543036420679,0.349543036420679
"29","147","050","Nodaway County",21241,21818,577,2.7164446118356,2.7164446118356
"29","149","050","Oregon County",8635,10440,1805,20.9033005211349,20.9033005211349
"29","151","050","Osage County",13274,13563,289,2.17718848877505,2.17718848877505
"29","153","050","Ozark County",8553,9091,538,6.29019057640594,6.29019057640594
"29","155","050","Pemiscot County",15661,15670,9,0.057467594661899,0.057467594661899
"29","157","050","Perry County",18956,19180,224,1.18168389955687,1.18168389955687
"29","159","050","Pettis County",42980,42475,-505,-1.17496510004653,1.17496510004653
"29","161","050","Phelps County",44638,44480,-158,-0.353958510685963,0.353958510685963
"29","163","050","Pike County",17587,17579,-8,-0.0454881446523,0.0454881446523
"29","165","050","Platte County",106718,106107,-611,-0.572536966584831,0.572536966584831
"29","167","050","Polk County",31519,32438,919,2.91570164028047,2.91570164028047
"29","169","050","Pulaski County",53955,52703,-1252,-2.32045222870911,2.32045222870911
"29","171","050","Putnam County",4681,4686,5,0.10681478316599,0.10681478316599
"29","173","050","Ralls County",10355,10285,-70,-0.67600193143409,0.67600193143409
"29","175","050","Randolph County",24716,24504,-212,-0.857743971516427,0.857743971516427
"29","177","050","Ray County",23158,22927,-231,-0.9974954659297,0.9974954659297
"29","179","050","Reynolds County",6096,6211,115,1.88648293963255,1.88648293963255
"29","181","050","Ripley County",10679,13304,2625,24.5809532727783,24.5809532727783
"29","183","050","St. Charles County",405262,405210,-52,-0.012831205491756,0.012831205491756
"29","185","050","St. Clair County",9284,9618,334,3.59758724687635,3.59758724687635
"29","186","050","Ste. Genevieve County",18479,17922,-557,-3.0142323718816,3.0142323718816
"29","187","050","St. Francois County",66922,66608,-314,-0.469202952691193,0.469202952691193
"29","189","050","St. Louis County",1004125,994969,-9156,-0.911838665504793,0.911838665504793
"29","195","050","Saline County",23333,22841,-492,-2.10860155145074,2.10860155145074
"29","197","050","Schuyler County",4032,4555,523,12.9712301587302,12.9712301587302
"29","199","050","Scotland County",4716,4885,169,3.58354537743851,3.58354537743851
"29","201","050","Scott County",38059,38322,263,0.691032344517722,0.691032344517722
"29","203","050","Shannon County",7031,8196,1165,16.5694780258854,16.5694780258854
"29","205","050","Shelby County",6103,5914,-189,-3.09683762084221,3.09683762084221
"29","207","050","Stoddard County",28672,29009,337,1.17536272321429,1.17536272321429
"29","209","050","Stone County",31076,32357,1281,4.12215214313296,4.12215214313296
"29","211","050","Sullivan County",5999,6040,41,0.683447241206868,0.683447241206868
"29","213","050","Taney County",56066,56106,40,0.0713444868547783,0.0713444868547783
"29","215","050","Texas County",24487,25148,661,2.6993915138645,2.6993915138645
"29","217","050","Vernon County",19707,20423,716,3.63322677221292,3.63322677221292
"29","219","050","Warren County",35532,36363,831,2.338736913205,2.338736913205
"29","221","050","Washington County",23514,24619,1105,4.69932805987922,4.69932805987922
"29","223","050","Wayne County",10974,12792,1818,16.566429743029,16.566429743029
"29","225","050","Webster County",39085,39780,695,1.77817577075604,1.77817577075604
"29","227","050","Worth County",1973,1960,-13,-0.658895083628991,0.658895083628991
"29","229","050","Wright County",18188,18296,108,0.593798108643061,0.593798108643061
"29","510","050","St. Louis city",301578,298587,-2991,-0.991783220261425,0.991783220261425
"30","001","050","Beaverhead County",9371,9515,144,1.53665563973962,1.53665563973962
"30","003","050","Big Horn County",13124,13140,16,0.121914050594331,0.121914050594331
"30","005","050","Blaine County",7044,6623,-421,-5.97671777399205,5.97671777399205
"30","007","050","Broadwater County",6774,6403,-371,-5.47682314732802,5.47682314732802
"30","009","050","Carbon County",10473,10899,426,4.06760240618734,4.06760240618734
"30","011","050","Carter County",1415,1244,-171,-12.0848056537102,12.0848056537102
"30","013","050","Cascade County",84414,81412,-3002,-3.55628213329542,3.55628213329542
"30","015","050","Chouteau County",5895,5710,-185,-3.13825275657337,3.13825275657337
"30","017","050","Custer County",11867,11350,-517,-4.35661919609,4.35661919609
"30","019","050","Daniels County",1661,1649,-12,-0.722456351595424,0.722456351595424
"30","021","050","Dawson County",8940,8587,-353,-3.94854586129754,3.94854586129754
"30","023","050","Deer Lodge County",9421,9222,-199,-2.11230230336482,2.11230230336482
"30","025","050","Fallon County",3049,2845,-204,-6.69071826828468,6.69071826828468
"30","027","050","Fergus County",11446,11101,-345,-3.01415341604054,3.01415341604054
"30","029","050","Flathead County",104357,105422,1065,1.02053527794015,1.02053527794015
"30","031","050","Gallatin County",118960,116274,-2686,-2.25790181573638,2.25790181573638
"30","033","050","Garfield County",1173,1269,96,8.18414322250639,8.18414322250639
"30","035","050","Glacier County",13778,13638,-140,-1.01611264334446,1.01611264334446
"30","037","050","Golden Valley County",823,829,6,0.729040097205346,0.729040097205346
"30","039","050","Granite County",3309,3336,27,0.815956482320943,0.815956482320943
"30","041","050","Hill County",16309,16398,89,0.545710957140229,0.545710957140229
"30","043","050","Jefferson County",12085,12346,261,2.15970211005379,2.15970211005379
"30","045","050","Judith Basin County",2023,2002,-21,-1.03806228373702,1.03806228373702
"30","047","050","Lake County",31134,30902,-232,-0.745166056401362,0.745166056401362
"30","049","050","Lewis and Clark County",70973,70107,-866,-1.22018232285517,1.22018232285517
"30","051","050","Liberty County",1959,2374,415,21.1842776927004,21.1842776927004
"30","053","050","Lincoln County",19677,20288,611,3.1051481425014,3.1051481425014
"30","055","050","McCone County",1729,1657,-72,-4.16425679583574,4.16425679583574
"30","057","050","Madison County",8623,8908,285,3.30511422938652,3.30511422938652
"30","059","050","Meagher County",1927,1834,-93,-4.82615464452517,4.82615464452517
"30","061","050","Mineral County",4535,4511,-24,-0.529217199558986,0.529217199558986
"30","063","050","Missoula County",117922,121277,3355,2.84510099896542,2.84510099896542
"30","065","050","Musselshell County",4730,4645,-85,-1.79704016913319,1.79704016913319
"30","067","050","Park County",17191,16743,-448,-2.60601477517306,2.60601477517306
"30","069","050","Petroleum County",496,495,-1,-0.201612903225806,0.201612903225806
"30","071","050","Phillips County",4217,3921,-296,-7.01920796774959,7.01920796774959
"30","073","050","Pondera County",5898,5805,-93,-1.57680569684639,1.57680569684639
"30","075","050","Powder River County",1694,1673,-21,-1.2396694214876,1.2396694214876
"30","077","050","Powell County",6946,6826,-120,-1.72761301468471,1.72761301468471
"30","079","050","Prairie County",1088,1073,-15,-1.37867647058824,1.37867647058824
"30","081","050","Ravalli County",44174,44796,622,1.40806809435415,1.40806809435415
"30","083","050","Richland County",11491,11004,-487,-4.23809938212514,4.23809938212514
"30","085","050","Roosevelt County",10794,10960,166,1.5378914211599,1.5378914211599
"30","087","050","Rosebud County",8329,8854,525,6.30327770440629,6.30327770440629
"30","089","050","Sanders County",12400,12089,-311,-2.50806451612903,2.50806451612903
"30","091","050","Sheridan County",3539,3266,-273,-7.71404351511727,7.71404351511727
"30","093","050","Silver Bow County",35133,35090,-43,-0.122392053055532,0.122392053055532
"30","095","050","Stillwater County",8963,9825,862,9.61731563092714,9.61731563092714
"30","097","050","Sweet Grass County",3678,3680,2,0.0543773790103317,0.0543773790103317
"30","099","050","Teton County",6226,6207,-19,-0.305171859942178,0.305171859942178
"30","101","050","Toole County",4971,4676,-295,-5.93441963387648,5.93441963387648
"30","103","050","Treasure County",762,700,-62,-8.13648293963255,8.13648293963255
"30","105","050","Valley County",7578,7345,-233,-3.07468989179203,3.07468989179203
"30","107","050","Wheatland County",2069,2134,65,3.14161430642823,3.14161430642823
"30","109","050","Wibaux County",937,939,2,0.213447171824973,0.213447171824973
"30","111","050","Yellowstone County",164731,162587,-2144,-1.30151580455409,1.30151580455409
"31","001","050","Adams County",31205,31371,166,0.531966031084762,0.531966031084762
"31","003","050","Antelope County",6295,6282,-13,-0.206513105639396,0.206513105639396
"31","005","050","Arthur County",434,471,37,8.52534562211982,8.52534562211982
"31","007","050","Banner County",674,789,115,17.0623145400593,17.0623145400593
"31","009","050","Blaine County",431,459,28,6.49651972157773,6.49651972157773
"31","011","050","Boone County",5379,5126,-253,-4.70347648261759,4.70347648261759
"31","013","050","Box Butte County",10842,10749,-93,-0.857775318206973,0.857775318206973
"31","015","050","Boyd County",1810,1871,61,3.37016574585635,3.37016574585635
"31","017","050","Brown County",2903,2992,89,3.06579400620048,3.06579400620048
"31","019","050","Buffalo County",50084,50120,36,0.0718792428719751,0.0718792428719751
"31","021","050","Burt County",6722,6495,-227,-3.3769711395418,3.3769711395418
"31","023","050","Butler County",8369,7991,-378,-4.51666865814315,4.51666865814315
"31","025","050","Cass County",26598,26268,-330,-1.24069478908189,1.24069478908189
"31","027","050","Cedar County",8380,8424,44,0.525059665871122,0.525059665871122
"31","029","050","Chase County",3893,3860,-33,-0.847675314667352,0.847675314667352
"31","031","050","Cherry County",5455,5794,339,6.21448212648946,6.21448212648946
"31","033","050","Cheyenne County",9468,9115,-353,-3.7283481199831,3.7283481199831
"31","035","050","Clay County",6104,6228,124,2.03145478374836,2.03145478374836
"31","037","050","Colfax County",10582,10646,64,0.604800604800605,0.604800604800605
"31","039","050","Cuming County",9013,8820,-193,-2.14135138133807,2.14135138133807
"31","041","050","Custer County",10545,10680,135,1.28022759601707,1.28022759601707
"31","043","050","Dakota County",21582,20111,-1471,-6.81586507274581,6.81586507274581
"31","045","050","Dawes County",8199,8410,211,2.57348457128918,2.57348457128918
"31","047","050","Dawson County",24111,23544,-567,-2.35162374020157,2.35162374020157
"31","049","050","Deuel County",1838,1804,-34,-1.84983677910773,1.84983677910773
"31","051","050","Dixon County",5606,5607,1,0.0178380306814128,0.0178380306814128
"31","053","050","Dodge County",37167,36321,-846,-2.2762127693922,2.2762127693922
"31","055","050","Douglas County",584526,573764,-10762,-1.84114992318562,1.84114992318562
"31","057","050","Dundy County",1654,1675,21,1.26964933494559,1.26964933494559
"31","059","050","Fillmore County",5551,5521,-30,-0.540443163393983,0.540443163393983
"31","061","050","Franklin County",2889,2953,64,2.21529941156109,2.21529941156109
"31","063","050","Frontier County",2519,2601,82,3.25526002381898,3.25526002381898
"31","065","050","Furnas County",4636,4666,30,0.647109577221743,0.647109577221743
"31","067","050","Gage County",21704,21488,-216,-0.995208256542573,0.995208256542573
"31","069","050","Garden County",1874,1846,-28,-1.49413020277481,1.49413020277481
"31","071","050","Garfield County",1813,1956,143,7.88747931605075,7.88747931605075
"31","073","050","Gosper County",1893,1979,86,4.54305335446381,4.54305335446381
"31","075","050","Grant County",611,631,20,3.27332242225859,3.27332242225859
"31","077","050","Greeley County",2188,2339,151,6.90127970749543,6.90127970749543
"31","079","050","Hall County",62895,61164,-1731,-2.75220605771524,2.75220605771524
"31","081","050","Hamilton County",9429,9254,-175,-1.85597624350408,1.85597624350408
"31","083","050","Harlan County",3073,3325,252,8.2004555808656,8.2004555808656
"31","085","050","Hayes County",856,917,61,7.12616822429906,7.12616822429906
"31","087","050","Hitchcock County",2616,2779,163,6.23088685015291,6.23088685015291
"31","089","050","Holt County",10127,9994,-133,-1.31332082551595,1.31332082551595
"31","091","050","Hooker County",711,653,-58,-8.15752461322082,8.15752461322082
"31","093","050","Howard County",6475,6470,-5,-0.0772200772200772,0.0772200772200772
"31","095","050","Jefferson County",7240,7088,-152,-2.09944751381215,2.09944751381215
"31","097","050","Johnson County",5290,5054,-236,-4.46124763705104,4.46124763705104
"31","099","050","Kearney County",6688,6644,-44,-0.657894736842105,0.657894736842105
"31","101","050","Keith County",8335,7989,-346,-4.15116976604679,4.15116976604679
"31","103","050","Keya Paha County",769,768,-1,-0.130039011703511,0.130039011703511
"31","105","050","Kimball County",3434,3519,85,2.47524752475248,2.47524752475248
"31","107","050","Knox County",8391,8312,-79,-0.94148492432368,0.94148492432368
"31","109","050","Lancaster County",322608,320229,-2379,-0.73742746615087,0.73742746615087
"31","111","050","Lincoln County",34676,34489,-187,-0.539277886722805,0.539277886722805
"31","113","050","Logan County",716,744,28,3.91061452513966,3.91061452513966
"31","115","050","Loup County",607,641,34,5.60131795716639,5.60131795716639
"31","117","050","McPherson County",399,475,76,19.047619047619,19.047619047619
"31","119","050","Madison County",35585,34863,-722,-2.02894478010398,2.02894478010398
"31","121","050","Merrick County",7668,7817,149,1.94314032342201,1.94314032342201
"31","123","050","Morrill County",4555,4627,72,1.58068057080132,1.58068057080132
"31","125","050","Nance County",3380,3521,141,4.17159763313609,4.17159763313609
"31","127","050","Nemaha County",7074,7014,-60,-0.848176420695505,0.848176420695505
"31","129","050","Nuckolls County",4095,4129,34,0.83028083028083,0.83028083028083
"31","131","050","Otoe County",15912,15963,51,0.32051282051282,0.32051282051282
"31","133","050","Pawnee County",2544,2617,73,2.86949685534591,2.86949685534591
"31","135","050","Perkins County",2858,2874,16,0.559832050384884,0.559832050384884
"31","137","050","Phelps County",8968,9006,38,0.423728813559322,0.423728813559322
"31","139","050","Pierce County",7317,7163,-154,-2.1046877135438,2.1046877135438
"31","141","050","Platte County",34296,33387,-909,-2.65045486354094,2.65045486354094
"31","143","050","Polk County",5214,5190,-24,-0.46029919447641,0.46029919447641
"31","145","050","Red Willow County",10702,10653,-49,-0.457858344234722,0.457858344234722
"31","147","050","Richardson County",7871,7813,-58,-0.736882225892517,0.736882225892517
"31","149","050","Rock County",1262,1373,111,8.79556259904913,8.79556259904913
"31","151","050","Saline County",14292,14020,-272,-1.90316260845228,1.90316260845228
"31","153","050","Sarpy County",190604,188409,-2195,-1.15160227487356,1.15160227487356
"31","155","050","Saunders County",22278,21836,-442,-1.98402010952509,1.98402010952509
"31","157","050","Scotts Bluff County",36084,35346,-738,-2.04522780179581,2.04522780179581
"31","159","050","Seward County",17609,17194,-415,-2.35674938951672,2.35674938951672
"31","161","050","Sheridan County",5127,5159,32,0.6241466744685,0.6241466744685
"31","163","050","Sherman County",2959,2983,24,0.811084825954714,0.811084825954714
"31","165","050","Sioux County",1135,1184,49,4.31718061674009,4.31718061674009
"31","167","050","Stanton County",5842,5884,42,0.718931872646354,0.718931872646354
"31","169","050","Thayer County",5034,4901,-133,-2.64203416765991,2.64203416765991
"31","171","050","Thomas County",669,719,50,7.47384155455904,7.47384155455904
"31","173","050","Thurston County",6773,7213,440,6.49638269599882,6.49638269599882
"31","175","050","Valley County",4059,4100,41,1.01010101010101,1.01010101010101
"31","177","050","Washington County",20865,20826,-39,-0.186915887850467,0.186915887850467
"31","179","050","Wayne County",9697,9470,-227,-2.34093018459317,2.34093018459317
"31","181","050","Webster County",3395,3427,32,0.942562592047128,0.942562592047128
"31","183","050","Wheeler County",774,784,10,1.29198966408269,1.29198966408269
"31","185","050","York County",14125,13518,-607,-4.29734513274336,4.29734513274336
"32","001","050","Churchill County",25516,25334,-182,-0.713277943251293,0.713277943251293
"32","003","050","Clark County",2265461,2307540,42079,1.85741445118676,1.85741445118676
"32","005","050","Douglas County",49488,49135,-353,-0.713304235370191,0.713304235370191
"32","007","050","Elko County",53702,52997,-705,-1.31280026814644,1.31280026814644
"32","009","050","Esmeralda County",729,878,149,20.4389574759945,20.4389574759945
"32","011","050","Eureka County",1855,2085,230,12.3989218328841,12.3989218328841
"32","013","050","Humboldt County",17285,16956,-329,-1.90338443737344,1.90338443737344
"32","015","050","Lander County",5734,5523,-211,-3.67980467387513,3.67980467387513
"32","017","050","Lincoln County",4499,5163,664,14.7588352967326,14.7588352967326
"32","019","050","Lyon County",59235,58142,-1093,-1.84519287583354,1.84519287583354
"32","021","050","Mineral County",4554,4520,-34,-0.746596398770312,0.746596398770312
"32","023","050","Nye County",51591,47792,-3799,-7.3636874648679,7.3636874648679
"32","027","050","Pershing County",6650,6577,-73,-1.09774436090226,1.09774436090226
"32","029","050","Storey County",4104,4203,99,2.41228070175439,2.41228070175439
"32","031","050","Washoe County",486492,476178,-10314,-2.12007597247231,2.12007597247231
"32","033","050","White Pine County",9080,9465,385,4.24008810572687,4.24008810572687
"32","510","050","Carson City",58639,56012,-2627,-4.47995361448865,4.47995361448865
"33","001","050","Belknap County",63705,61572,-2133,-3.34824582057923,3.34824582057923
"33","003","050","Carroll County",50107,49113,-994,-1.98375476480332,1.98375476480332
"33","005","050","Cheshire County",76458,76194,-264,-0.345287608883308,0.345287608883308
"33","007","050","Coos County",31268,31250,-18,-0.0575668414992964,0.0575668414992964
"33","009","050","Grafton County",91118,90655,-463,-0.508132311947145,0.508132311947145
"33","011","050","Hillsborough County",422937,418734,-4203,-0.993765028834082,0.993765028834082
"33","013","050","Merrimack County",153808,152426,-1382,-0.898522833662748,0.898522833662748
"33","015","050","Rockingham County",314176,310970,-3206,-1.02044713790996,1.02044713790996
"33","017","050","Strafford County",130889,131356,467,0.356790868598583,0.356790868598583
"33","019","050","Sullivan County",43063,43263,200,0.464435826579662,0.464435826579662
"34","001","050","Atlantic County",274534,263339,-11195,-4.07781914079859,4.07781914079859
"34","003","050","Bergen County",955732,931649,-24083,-2.51984866050315,2.51984866050315
"34","005","050","Burlington County",461860,446784,-15076,-3.26419261247997,3.26419261247997
"34","007","050","Camden County",523485,507070,-16415,-3.13571544552375,3.13571544552375
"34","009","050","Cape May County",95263,91777,-3486,-3.65934308178411,3.65934308178411
"34","011","050","Cumberland County",154152,147599,-6553,-4.25099901396025,4.25099901396025
"34","013","050","Essex County",863728,801474,-62254,-7.20759313117092,7.20759313117092
"34","015","050","Gloucester County",302294,293071,-9223,-3.0510033278861,3.0510033278861
"34","017","050","Hudson County",724854,672875,-51979,-7.17096132462537,7.17096132462537
"34","019","050","Hunterdon County",128947,124979,-3968,-3.07723328189101,3.07723328189101
"34","021","050","Mercer County",387340,367702,-19638,-5.06996437238602,5.06996437238602
"34","023","050","Middlesex County",863162,823906,-39256,-4.54792958911537,4.54792958911537
"34","025","050","Monmouth County",643615,619032,-24583,-3.81951943320153,3.81951943320153
"34","027","050","Morris County",509285,491515,-17770,-3.48920545470611,3.48920545470611
"34","029","050","Ocean County",637229,612913,-24316,-3.81589663998343,3.81589663998343
"34","031","050","Passaic County",524118,501079,-23039,-4.39576583899046,4.39576583899046
"34","033","050","Salem County",64837,62452,-2385,-3.67845520304764,3.67845520304764
"34","035","050","Somerset County",345361,329731,-15630,-4.52569919591384,4.52569919591384
"34","037","050","Sussex County",144221,140235,-3986,-2.76381386899273,2.76381386899273
"34","039","050","Union County",575345,556080,-19265,-3.34842572717239,3.34842572717239
"34","041","050","Warren County",109632,105621,-4011,-3.65860332749562,3.65860332749562
"35","001","050","Bernalillo County",676444,681598,5154,0.76192559916268,0.76192559916268
"35","003","050","Catron County",3579,3613,34,0.949986029617212,0.949986029617212
"35","005","050","Chaves County",65157,64767,-390,-0.598554261245914,0.598554261245914
"35","006","050","Cibola County",27172,26462,-710,-2.61298395407037,2.61298395407037
"35","007","050","Colfax County",12387,11994,-393,-3.1726810365706,3.1726810365706
"35","009","050","Curry County",48430,48917,487,1.00557505678299,1.00557505678299
"35","011","050","De Baca County",1698,1695,-3,-0.176678445229682,0.176678445229682
"35","013","050","Dońa Ana County",219561,220845,1284,0.584803312063618,0.584803312063618
"35","015","050","Eddy County",62314,58469,-3845,-6.17036300028886,6.17036300028886
"35","017","050","Grant County",28185,27039,-1146,-4.06599254922831,4.06599254922831
"35","019","050","Guadalupe County",4452,4288,-164,-3.6837376460018,3.6837376460018
"35","021","050","Harding County",657,638,-19,-2.89193302891933,2.89193302891933
"35","023","050","Hidalgo County",4178,4134,-44,-1.05313547151747,1.05313547151747
"35","025","050","Lea County",74455,71710,-2745,-3.68679067893358,3.68679067893358
"35","027","050","Lincoln County",20269,19906,-363,-1.79091223049978,1.79091223049978
"35","028","050","Los Alamos County",19419,19477,58,0.29867655389052,0.29867655389052
"35","029","050","Luna County",25427,23896,-1531,-6.02115861092539,6.02115861092539
"35","031","050","McKinley County",72902,71019,-1883,-2.5829195358152,2.5829195358152
"35","033","050","Mora County",4189,4486,297,7.08999761279542,7.08999761279542
"35","035","050","Otero County",67839,67893,54,0.0796002299562199,0.0796002299562199
"35","037","050","Quay County",8746,8235,-511,-5.8426709352847,5.8426709352847
"35","039","050","Rio Arriba County",40363,38630,-1733,-4.29353615935386,4.29353615935386
"35","041","050","Roosevelt County",19191,18381,-810,-4.22072846646866,4.22072846646866
"35","043","050","Sandoval County",148834,148533,-301,-0.20223873577274,0.20223873577274
"35","045","050","San Juan County",121661,123537,1876,1.54198962691413,1.54198962691413
"35","047","050","San Miguel County",27201,27191,-10,-0.0367633542884453,0.0367633542884453
"35","049","050","Santa Fe County",154823,151785,-3038,-1.962240752343,1.962240752343
"35","051","050","Sierra County",11576,10863,-713,-6.15929509329648,6.15929509329648
"35","053","050","Socorro County",16595,16540,-55,-0.331425128050618,0.331425128050618
"35","055","050","Taos County",34489,32640,-1849,-5.36112963553597,5.36112963553597
"35","057","050","Torrance County",15045,15453,408,2.71186440677966,2.71186440677966
"35","059","050","Union County",4079,4034,-45,-1.10321157146359,1.10321157146359
"35","061","050","Valencia County",76205,77449,1244,1.63243881635063,1.63243881635063
"36","001","050","Albany County",314848,304151,-10697,-3.39751245045228,3.39751245045228
"36","003","050","Allegany County",46456,45702,-754,-1.62304115722404,1.62304115722404
"36","005","050","Bronx County",1472654,1406655,-65999,-4.48163655549776,4.48163655549776
"36","007","050","Broome County",198683,189897,-8786,-4.42211965794758,4.42211965794758
"36","009","050","Cattaraugus County",77042,76012,-1030,-1.3369331014252,1.3369331014252
"36","011","050","Cayuga County",76248,76193,-55,-0.0721330395551359,0.0721330395551359
"36","013","050","Chautauqua County",127657,126269,-1388,-1.08728859365331,1.08728859365331
"36","015","050","Chemung County",84148,82878,-1270,-1.50924561486904,1.50924561486904
"36","017","050","Chenango County",47220,46873,-347,-0.734858110969928,0.734858110969928
"36","019","050","Clinton County",79843,79907,64,0.0801573087183598,0.0801573087183598
"36","021","050","Columbia County",61570,59596,-1974,-3.20610687022901,3.20610687022901
"36","023","050","Cortland County",46809,47287,478,1.02117114230169,1.02117114230169
"36","025","050","Delaware County",44308,44074,-234,-0.528121332490747,0.528121332490747
"36","027","050","Dutchess County",295911,293646,-2265,-0.765432849741983,0.765432849741983
"36","029","050","Erie County",954236,918182,-36054,-3.77831060660046,3.77831060660046
"36","031","050","Essex County",37381,36950,-431,-1.15299216179342,1.15299216179342
"36","033","050","Franklin County",47555,50017,2462,5.17716328461781,5.17716328461781
"36","035","050","Fulton County",53324,52994,-330,-0.618858300202536,0.618858300202536
"36","037","050","Genesee County",58388,57129,-1259,-2.15626498595602,2.15626498595602
"36","039","050","Greene County",47931,47220,-711,-1.48338236214558,1.48338236214558
"36","041","050","Hamilton County",5107,4370,-737,-14.4311728999413,14.4311728999413
"36","043","050","Herkimer County",60139,61056,917,1.52480087796605,1.52480087796605
"36","045","050","Jefferson County",116721,108650,-8071,-6.91477968831658,6.91477968831658
"36","047","050","Kings County",2736074,2546958,-189116,-6.91194755697397,6.91194755697397
"36","049","050","Lewis County",26582,26239,-343,-1.29034685125273,1.29034685125273
"36","051","050","Livingston County",61834,62561,727,1.17572856357344,1.17572856357344
"36","053","050","Madison County",68016,70589,2573,3.78293342742884,3.78293342742884
"36","055","050","Monroe County",759443,741770,-17673,-2.3271002563721,2.3271002563721
"36","057","050","Montgomery County",49532,49228,-304,-0.613744649923282,0.613744649923282
"36","059","050","Nassau County",1395774,1353544,-42230,-3.02556144476111,3.02556144476111
"36","061","050","New York County",1694251,1618394,-75857,-4.47731770558199,4.47731770558199
"36","063","050","Niagara County",212666,208781,-3885,-1.82680823450857,1.82680823450857
"36","065","050","Oneida County",232125,227713,-4412,-1.9007000538503,1.9007000538503
"36","067","050","Onondaga County",476516,459883,-16633,-3.49054386421442,3.49054386421442
"36","069","050","Ontario County",112458,110123,-2335,-2.07633071902399,2.07633071902399
"36","071","050","Orange County",401310,385352,-15958,-3.97647703770153,3.97647703770153
"36","073","050","Orleans County",40343,40097,-246,-0.609771211858315,0.609771211858315
"36","075","050","Oswego County",117525,116555,-970,-0.825356307168688,0.825356307168688
"36","077","050","Otsego County",58524,58883,359,0.613423552730504,0.613423552730504
"36","079","050","Putnam County",97668,98587,919,0.940942785764017,0.940942785764017
"36","081","050","Queens County",2405464,2235298,-170166,-7.0741445309512,7.0741445309512
"36","083","050","Rensselaer County",161130,158394,-2736,-1.69800781977285,1.69800781977285
"36","085","050","Richmond County",495747,475845,-19902,-4.01454774310283,4.01454774310283
"36","087","050","Rockland County",338329,326446,-11883,-3.51226173340151,3.51226173340151
"36","089","050","St. Lawrence County",108505,107362,-1143,-1.05340767706557,1.05340767706557
"36","091","050","Saratoga County",235509,230224,-5285,-2.24407559796016,2.24407559796016
"36","093","050","Schenectady County",158061,155480,-2581,-1.63291387502293,1.63291387502293
"36","095","050","Schoharie County",29714,31116,1402,4.71831459917884,4.71831459917884
"36","097","050","Schuyler County",17898,17702,-196,-1.09509442395798,1.09509442395798
"36","099","050","Seneca County",33814,34044,230,0.680191636600225,0.680191636600225
"36","101","050","Steuben County",93584,94841,1257,1.34317832108053,1.34317832108053
"36","103","050","Suffolk County",1525920,1476136,-49784,-3.26255635944217,3.26255635944217
"36","105","050","Sullivan County",78624,75775,-2849,-3.6235754985755,3.6235754985755
"36","107","050","Tioga County",48455,47997,-458,-0.945206892993499,0.945206892993499
"36","109","050","Tompkins County",105740,101336,-4404,-4.16493285417061,4.16493285417061
"36","111","050","Ulster County",181851,177839,-4012,-2.20620178057861,2.20620178057861
"36","113","050","Warren County",65737,63812,-1925,-2.92833564050687,2.92833564050687
"36","115","050","Washington County",61302,60752,-550,-0.89719748132198,0.89719748132198
"36","117","050","Wayne County",91283,89479,-1804,-1.97627159493005,1.97627159493005
"36","119","050","Westchester County",1004457,967141,-37316,-3.7150420575495,3.7150420575495
"36","121","050","Wyoming County",40531,39578,-953,-2.35128666946288,2.35128666946288
"36","123","050","Yates County",24774,24811,37,0.149350125131186,0.149350125131186
"37","001","050","Alamance County",171415,170945,-470,-0.274188373246215,0.274188373246215
"37","003","050","Alexander County",36444,37489,1045,2.86741301723192,2.86741301723192
"37","005","050","Alleghany County",10888,11202,314,2.88390889052167,2.88390889052167
"37","007","050","Anson County",22055,23999,1944,8.81432781682158,8.81432781682158
"37","009","050","Ashe County",26577,27206,629,2.36670805583775,2.36670805583775
"37","011","050","Avery County",17806,17577,-229,-1.28608334269347,1.28608334269347
"37","013","050","Beaufort County",44652,47152,2500,5.59885335483293,5.59885335483293
"37","015","050","Bertie County",17934,18787,853,4.7563287610126,4.7563287610126
"37","017","050","Bladen County",29606,32939,3333,11.2578531378775,11.2578531378775
"37","019","050","Brunswick County",136693,147669,10976,8.02967233142882,8.02967233142882
"37","021","050","Buncombe County",269452,263254,-6198,-2.30022415866277,2.30022415866277
"37","023","050","Burke County",87570,90508,2938,3.35503026150508,3.35503026150508
"37","025","050","Cabarrus County",225804,220350,-5454,-2.41536908115002,2.41536908115002
"37","027","050","Caldwell County",80652,82230,1578,1.95655408421366,1.95655408421366
"37","029","050","Camden County",10355,10949,594,5.7363592467407,5.7363592467407
"37","031","050","Carteret County",67686,69611,1925,2.84401501048961,2.84401501048961
"37","033","050","Caswell County",22736,22507,-229,-1.00721323011963,1.00721323011963
"37","035","050","Catawba County",160610,160207,-403,-0.250918373700268,0.250918373700268
"37","037","050","Chatham County",76285,75478,-807,-1.05787507373665,1.05787507373665
"37","039","050","Cherokee County",28774,29014,240,0.834086327934941,0.834086327934941
"37","041","050","Chowan County",13708,13865,157,1.14531660344324,1.14531660344324
"37","043","050","Clay County",11089,11462,373,3.36369375056362,3.36369375056362
"37","045","050","Cleveland County",99519,98857,-662,-0.6651996101247,0.6651996101247
"37","047","050","Columbus County",50623,54978,4355,8.60280899986172,8.60280899986172
"37","049","050","Craven County",100720,101502,782,0.776409849086577,0.776409849086577
"37","051","050","Cumberland County",334728,336589,1861,0.555973805597381,0.555973805597381
"37","053","050","Currituck County",28100,28804,704,2.50533807829181,2.50533807829181
"37","055","050","Dare County",36915,37479,564,1.52783421373425,1.52783421373425
"37","057","050","Davidson County",168930,169077,147,0.087018291600071,0.087018291600071
"37","059","050","Davie County",42712,43177,465,1.08868702004121,1.08868702004121
"37","061","050","Duplin County",48715,58856,10141,20.8169968182285,20.8169968182285
"37","063","050","Durham County",324833,326421,1588,0.488866586830771,0.488866586830771
"37","065","050","Edgecombe County",48900,51023,2123,4.34151329243354,4.34151329243354
"37","067","050","Forsyth County",382590,383658,1068,0.279150003920646,0.279150003920646
"37","069","050","Franklin County",68573,71366,2793,4.07303165969113,4.07303165969113
"37","071","050","Gaston County",227943,226209,-1734,-0.760716494913202,0.760716494913202
"37","073","050","Gates County",10478,11502,1024,9.77285741553731,9.77285741553731
"37","075","050","Graham County",8030,8481,451,5.61643835616438,5.61643835616438
"37","077","050","Granville County",60992,60494,-498,-0.816500524658972,0.816500524658972
"37","079","050","Greene County",20451,20942,491,2.400860593614,2.400860593614
"37","081","050","Guilford County",541299,540188,-1111,-0.2052470076612,0.2052470076612
"37","083","050","Halifax County",48622,49660,1038,2.13483608243182,2.13483608243182
"37","085","050","Harnett County",133568,136902,3334,2.49610685194058,2.49610685194058
"37","087","050","Haywood County",62089,62889,800,1.28847299843773,1.28847299843773
"37","089","050","Henderson County",116281,118252,1971,1.69503186247108,1.69503186247108
"37","091","050","Hertford County",21552,23264,1712,7.94357832219748,7.94357832219748
"37","093","050","Hoke County",52082,55708,3626,6.96209822971468,6.96209822971468
"37","095","050","Hyde County",4589,4865,276,6.01438221834822,6.01438221834822
"37","097","050","Iredell County",186693,184874,-1819,-0.974326836035631,0.974326836035631
"37","099","050","Jackson County",43109,43973,864,2.00422185622492,2.00422185622492
"37","101","050","Johnston County",215999,214730,-1269,-0.58750271992,0.58750271992
"37","103","050","Jones County",9172,9289,117,1.27562145660707,1.27562145660707
"37","105","050","Lee County",63285,62248,-1037,-1.63861894603777,1.63861894603777
"37","107","050","Lenoir County",55122,55840,718,1.30256521896883,1.30256521896883
"37","109","050","Lincoln County",86810,87765,955,1.10010367469186,1.10010367469186
"37","111","050","McDowell County",44578,45806,1228,2.75472206020907,2.75472206020907
"37","113","050","Macon County",37014,35944,-1070,-2.89079807640352,2.89079807640352
"37","115","050","Madison County",21193,21730,537,2.53385551833152,2.53385551833152
"37","117","050","Martin County",22031,22253,222,1.00767100903273,1.00767100903273
"37","119","050","Mecklenburg County",1115482,1125666,10184,0.912968564261907,0.912968564261907
"37","121","050","Mitchell County",14903,14904,1,0.00671005837750788,0.00671005837750788
"37","123","050","Montgomery County",25751,27256,1505,5.84443322589414,5.84443322589414
"37","125","050","Moore County",99727,102879,3152,3.16062851584827,3.16062851584827
"37","127","050","Nash County",94970,94751,-219,-0.230599136569443,0.230599136569443
"37","129","050","New Hanover County",225702,236121,10419,4.6162639232262,4.6162639232262
"37","131","050","Northampton County",17471,19198,1727,9.88495220651365,9.88495220651365
"37","133","050","Onslow County",204576,203718,-858,-0.419404035664007,0.419404035664007
"37","135","050","Orange County",148696,148921,225,0.151315435519449,0.151315435519449
"37","137","050","Pamlico County",12276,12702,426,3.47018572825024,3.47018572825024
"37","139","050","Pasquotank County",40568,40286,-282,-0.695129165845001,0.695129165845001
"37","141","050","Pender County",60203,64280,4077,6.77208776971247,6.77208776971247
"37","143","050","Perquimans County",13005,13632,627,4.82122260668973,4.82122260668973
"37","145","050","Person County",39097,39865,768,1.96434509041614,1.96434509041614
"37","147","050","Pitt County",170243,182581,12338,7.24728770052219,7.24728770052219
"37","149","050","Polk County",19328,20968,1640,8.48509933774834,8.48509933774834
"37","151","050","Randolph County",144171,144360,189,0.131094325488482,0.131094325488482
"37","153","050","Richmond County",42946,44446,1500,3.49275834769245,3.49275834769245
"37","155","050","Robeson County",116530,130152,13622,11.6896936411225,11.6896936411225
"37","157","050","Rockingham County",91096,91298,202,0.221744094142443,0.221744094142443
"37","159","050","Rowan County",146875,142373,-4502,-3.0651914893617,3.0651914893617
"37","161","050","Rutherford County",64444,67072,2628,4.07795915833902,4.07795915833902
"37","163","050","Sampson County",59036,63399,4363,7.39040585405515,7.39040585405515
"37","165","050","Scotland County",34174,34659,485,1.41920758471352,1.41920758471352
"37","167","050","Stanly County",62504,63104,600,0.959938563931908,0.959938563931908
"37","169","050","Stokes County",44520,45729,1209,2.71563342318059,2.71563342318059
"37","171","050","Surry County",71359,71716,357,0.500287279810535,0.500287279810535
"37","173","050","Swain County",14117,14208,91,0.644612878090246,0.644612878090246
"37","175","050","Transylvania County",32986,34446,1460,4.42612017219426,4.42612017219426
"37","177","050","Tyrrell County",3245,3779,534,16.4560862865948,16.4560862865948
"37","179","050","Union County",238267,243504,5237,2.19795439569894,2.19795439569894
"37","181","050","Vance County",42578,44696,2118,4.97439992484382,4.97439992484382
"37","183","050","Wake County",1129410,1127989,-1421,-0.12581790492381,0.12581790492381
"37","185","050","Warren County",18642,19542,900,4.82780817508851,4.82780817508851
"37","187","050","Washington County",11003,11532,529,4.80777969644642,4.80777969644642
"37","189","050","Watauga County",54086,56381,2295,4.24324224383389,4.24324224383389
"37","191","050","Wayne County",117333,123990,6657,5.67359566362404,5.67359566362404
"37","193","050","Wilkes County",65969,68116,2147,3.25455895951129,3.25455895951129
"37","195","050","Wilson County",78784,81963,3179,4.03508326563769,4.03508326563769
"37","197","050","Yadkin County",37214,37630,416,1.11785887031762,1.11785887031762
"37","199","050","Yancey County",18470,18078,-392,-2.122360584732,2.122360584732
"38","001","050","Adams County",2200,2219,19,0.863636363636364,0.863636363636364
"38","003","050","Barnes County",10853,10437,-416,-3.83304155533032,3.83304155533032
"38","005","050","Benson County",5964,6794,830,13.9168343393695,13.9168343393695
"38","007","050","Billings County",945,897,-48,-5.07936507936508,5.07936507936508
"38","009","050","Bottineau County",6379,6316,-63,-0.98761561373256,0.98761561373256
"38","011","050","Bowman County",2993,3009,16,0.534580688272636,0.534580688272636
"38","013","050","Burke County",2201,2131,-70,-3.18037255792821,3.18037255792821
"38","015","050","Burleigh County",98458,96190,-2268,-2.30352028276016,2.30352028276016
"38","017","050","Cass County",184525,183584,-941,-0.509958000270966,0.509958000270966
"38","019","050","Cavalier County",3704,3719,15,0.404967602591793,0.404967602591793
"38","021","050","Dickey County",4999,4747,-252,-5.04100820164033,5.04100820164033
"38","023","050","Divide County",2195,2283,88,4.00911161731207,4.00911161731207
"38","025","050","Dunn County",4095,4469,374,9.13308913308913,9.13308913308913
"38","027","050","Eddy County",2347,2195,-152,-6.47635279079676,6.47635279079676
"38","029","050","Emmons County",3301,3213,-88,-2.66585883065738,2.66585883065738
"38","031","050","Foster County",3397,3177,-220,-6.47630261995879,6.47630261995879
"38","033","050","Golden Valley County",1736,1747,11,0.633640552995392,0.633640552995392
"38","035","050","Grand Forks County",73170,69540,-3630,-4.96104961049611,4.96104961049611
"38","037","050","Grant County",2301,2232,-69,-2.9986962190352,2.9986962190352
"38","039","050","Griggs County",2306,2213,-93,-4.03295750216826,4.03295750216826
"38","041","050","Hettinger County",2489,2456,-33,-1.32583366813982,1.32583366813982
"38","043","050","Kidder County",2394,2470,76,3.17460317460317,3.17460317460317
"38","045","050","LaMoure County",4093,4046,-47,-1.14830197898852,1.14830197898852
"38","047","050","Logan County",1876,1883,7,0.373134328358209,0.373134328358209
"38","049","050","McHenry County",5345,5721,376,7.03461178671656,7.03461178671656
"38","051","050","McIntosh County",2530,2447,-83,-3.28063241106719,3.28063241106719
"38","053","050","McKenzie County",14704,15212,508,3.45484221980414,3.45484221980414
"38","055","050","McLean County",9771,9427,-344,-3.52062224951387,3.52062224951387
"38","057","050","Mercer County",8350,8203,-147,-1.76047904191617,1.76047904191617
"38","059","050","Morton County",33291,31467,-1824,-5.47895827701181,5.47895827701181
"38","061","050","Mountrail County",9809,10499,690,7.03435620348659,7.03435620348659
"38","063","050","Nelson County",3015,2805,-210,-6.96517412935323,6.96517412935323
"38","065","050","Oliver County",1877,1927,50,2.6638252530634,2.6638252530634
"38","067","050","Pembina County",6844,6697,-147,-2.1478667445938,2.1478667445938
"38","069","050","Pierce County",3990,3946,-44,-1.10275689223058,1.10275689223058
"38","071","050","Ramsey County",11605,11407,-198,-1.70616113744076,1.70616113744076
"38","073","050","Ransom County",5703,5186,-517,-9.06540417324215,9.06540417324215
"38","075","050","Renville County",2282,2294,12,0.525854513584575,0.525854513584575
"38","077","050","Richland County",16529,16175,-354,-2.14169036239337,2.14169036239337
"38","079","050","Rolette County",12187,14183,1996,16.378107819808,16.378107819808
"38","081","050","Sargent County",3862,3914,52,1.34645261522527,1.34645261522527
"38","083","050","Sheridan County",1265,1280,15,1.18577075098814,1.18577075098814
"38","085","050","Sioux County",3898,4178,280,7.18317085684967,7.18317085684967
"38","087","050","Slope County",706,742,36,5.09915014164306,5.09915014164306
"38","089","050","Stark County",33646,31939,-1707,-5.07341140105808,5.07341140105808
"38","091","050","Steele County",1798,1896,98,5.45050055617353,5.45050055617353
"38","093","050","Stutsman County",21593,20524,-1069,-4.95067846061224,4.95067846061224
"38","095","050","Towner County",2162,2114,-48,-2.22016651248844,2.22016651248844
"38","097","050","Traill County",7997,7975,-22,-0.275103163686382,0.275103163686382
"38","099","050","Walsh County",10563,10451,-112,-1.06030483764082,1.06030483764082
"38","101","050","Ward County",69919,68446,-1473,-2.10672349432915,2.10672349432915
"38","103","050","Wells County",3982,3730,-252,-6.32847815168257,6.32847815168257
"38","105","050","Williams County",40950,38472,-2478,-6.05128205128205,6.05128205128205
"39","001","050","Adams County",27477,27580,103,0.374858972959202,0.374858972959202
"39","003","050","Allen County",102206,102184,-22,-0.0215251550789582,0.0215251550789582
"39","005","050","Ashland County",52447,53426,979,1.86664632867466,1.86664632867466
"39","007","050","Ashtabula County",97574,96751,-823,-0.843462397769898,0.843462397769898
"39","009","050","Athens County",62431,65557,3126,5.00712786916756,5.00712786916756
"39","011","050","Auglaize County",46422,45709,-713,-1.53590969798802,1.53590969798802
"39","013","050","Belmont County",66497,66233,-264,-0.397010391446231,0.397010391446231
"39","015","050","Brown County",43676,43482,-194,-0.444179869951461,0.444179869951461
"39","017","050","Butler County",390357,385348,-5009,-1.2831843671306,1.2831843671306
"39","019","050","Carroll County",26721,26937,216,0.808352980801617,0.808352980801617
"39","021","050","Champaign County",38714,38984,270,0.697422121196466,0.697422121196466
"39","023","050","Clark County",136001,133888,-2113,-1.55366504658054,1.55366504658054
"39","025","050","Clermont County",208601,207391,-1210,-0.580054745662772,0.580054745662772
"39","027","050","Clinton County",42018,41980,-38,-0.0904374315769432,0.0904374315769432
"39","029","050","Columbiana County",101877,101351,-526,-0.516308882279612,0.516308882279612
"39","031","050","Coshocton County",36612,36500,-112,-0.305910630394406,0.305910630394406
"39","033","050","Crawford County",42025,41385,-640,-1.52290303390839,1.52290303390839
"39","035","050","Cuyahoga County",1264817,1230610,-34207,-2.70450191608747,2.70450191608747
"39","037","050","Darke County",51881,51240,-641,-1.23551974711359,1.23551974711359
"39","039","050","Defiance County",38286,37859,-427,-1.11529018440161,1.11529018440161
"39","041","050","Delaware County",214124,212722,-1402,-0.654760792811642,0.654760792811642
"39","043","050","Erie County",75622,73888,-1734,-2.29298352331332,2.29298352331332
"39","045","050","Fairfield County",158921,159298,377,0.237224784641426,0.237224784641426
"39","047","050","Fayette County",28951,28573,-378,-1.30565438154122,1.30565438154122
"39","049","050","Franklin County",1323807,1323855,48,0.0036259061932744,0.0036259061932744
"39","051","050","Fulton County",42713,41985,-728,-1.70439912907077,1.70439912907077
"39","053","050","Gallia County",29220,29826,606,2.07392197125257,2.07392197125257
"39","055","050","Geauga County",95397,93369,-2028,-2.12585301424573,2.12585301424573
"39","057","050","Greene County",167966,170008,2042,1.21572222949883,1.21572222949883
"39","059","050","Guernsey County",38438,38816,378,0.983401841927259,0.983401841927259
"39","061","050","Hamilton County",830639,818621,-12018,-1.44683791635115,1.44683791635115
"39","063","050","Hancock County",74920,75519,599,0.799519487453284,0.799519487453284
"39","065","050","Hardin County",30696,31460,764,2.48892363825906,2.48892363825906
"39","067","050","Harrison County",14483,15030,547,3.77684181454119,3.77684181454119
"39","069","050","Henry County",27662,26925,-737,-2.66430482250018,2.66430482250018
"39","071","050","Highland County",43317,43282,-35,-0.0807996860355057,0.0807996860355057
"39","073","050","Hocking County",28050,28151,101,0.360071301247772,0.360071301247772
"39","075","050","Holmes County",44223,44016,-207,-0.468082219659453,0.468082219659453
"39","077","050","Huron County",58565,58064,-501,-0.855459745581832,0.855459745581832
"39","079","050","Jackson County",32653,32476,-177,-0.542063516369093,0.542063516369093
"39","081","050","Jefferson County",65249,65121,-128,-0.196171588836611,0.196171588836611
"39","083","050","Knox County",62721,62401,-320,-0.510195947130945,0.510195947130945
"39","085","050","Lake County",232603,229745,-2858,-1.22870298319454,1.22870298319454
"39","087","050","Lawrence County",58240,59214,974,1.67239010989011,1.67239010989011
"39","089","050","Licking County",178519,177945,-574,-0.321534402500574,0.321534402500574
"39","091","050","Logan County",46150,45419,-731,-1.5839653304442,1.5839653304442
"39","093","050","Lorain County",312964,311797,-1167,-0.372886338364796,0.372886338364796
"39","095","050","Lucas County",431279,428666,-2613,-0.605872300761224,0.605872300761224
"39","097","050","Madison County",43824,44634,810,1.84830230010953,1.84830230010953
"39","099","050","Mahoning County",228614,226551,-2063,-0.902394429037592,0.902394429037592
"39","101","050","Marion County",65359,64911,-448,-0.685445003748527,0.685445003748527
"39","103","050","Medina County",182470,180792,-1678,-0.919603222447526,0.919603222447526
"39","105","050","Meigs County",22210,22728,518,2.33228275551553,2.33228275551553
"39","107","050","Mercer County",42528,41272,-1256,-2.95334838224229,2.95334838224229
"39","109","050","Miami County",108774,107428,-1346,-1.23742806185302,1.23742806185302
"39","111","050","Monroe County",13385,13625,240,1.79305192379529,1.79305192379529
"39","113","050","Montgomery County",537309,532022,-5287,-0.983977562259333,0.983977562259333
"39","115","050","Morgan County",13802,14347,545,3.9487030865092,3.9487030865092
"39","117","050","Morrow County",34950,35392,442,1.26466380543634,1.26466380543634
"39","119","050","Muskingum County",86410,86058,-352,-0.407360259229256,0.407360259229256
"39","121","050","Noble County",14115,14389,274,1.94119730782855,1.94119730782855
"39","123","050","Ottawa County",40364,40342,-22,-0.0545040134773561,0.0545040134773561
"39","125","050","Paulding County",18806,18659,-147,-0.781665425927895,0.781665425927895
"39","127","050","Perry County",35408,36201,793,2.23960686850429,2.23960686850429
"39","129","050","Pickaway County",58539,58636,97,0.165701498146535,0.165701498146535
"39","131","050","Pike County",27088,27730,642,2.37005316007088,2.37005316007088
"39","133","050","Portage County",161791,162597,806,0.498173569605231,0.498173569605231
"39","135","050","Preble County",40999,40848,-151,-0.36830166589429,0.36830166589429
"39","137","050","Putnam County",34451,33711,-740,-2.14797828800325,2.14797828800325
"39","139","050","Richland County",124936,121065,-3871,-3.0983863738234,3.0983863738234
"39","141","050","Ross County",77093,76485,-608,-0.78865785479875,0.78865785479875
"39","143","050","Sandusky County",58896,58409,-487,-0.826881282260255,0.826881282260255
"39","145","050","Scioto County",74008,74543,535,0.722894822181386,0.722894822181386
"39","147","050","Seneca County",55069,55015,-54,-0.0980587989613031,0.0980587989613031
"39","149","050","Shelby County",48230,48403,173,0.358697905867717,0.358697905867717
"39","151","050","Stark County",374853,370173,-4680,-1.24848940784788,1.24848940784788
"39","153","050","Summit County",540428,539638,-790,-0.146180434766518,0.146180434766518
"39","155","050","Trumbull County",201977,197194,-4783,-2.36809141634939,2.36809141634939
"39","157","050","Tuscarawas County",93263,91853,-1410,-1.51185357537287,1.51185357537287
"39","159","050","Union County",62784,59754,-3030,-4.82607033639144,4.82607033639144
"39","161","050","Van Wert County",28931,28179,-752,-2.59928796101068,2.59928796101068
"39","163","050","Vinton County",12800,12987,187,1.4609375,1.4609375
"39","165","050","Warren County",242337,237769,-4568,-1.88497835658608,1.88497835658608
"39","167","050","Washington County",59771,59747,-24,-0.0401532515768517,0.0401532515768517
"39","169","050","Wayne County",116894,115747,-1147,-0.98123085872671,0.98123085872671
"39","171","050","Williams County",37102,36611,-491,-1.32337879359603,1.32337879359603
"39","173","050","Wood County",132248,131111,-1137,-0.859748351581876,0.859748351581876
"39","175","050","Wyandot County",21900,21712,-188,-0.858447488584475,0.858447488584475
"40","001","050","Adair County",19495,22051,2556,13.1110541164401,13.1110541164401
"40","003","050","Alfalfa County",5699,5719,20,0.350938761186173,0.350938761186173
"40","005","050","Atoka County",14143,13899,-244,-1.72523509863537,1.72523509863537
"40","007","050","Beaver County",5049,5248,199,3.94137452960982,3.94137452960982
"40","009","050","Beckham County",22410,21603,-807,-3.60107095046854,3.60107095046854
"40","011","050","Blaine County",8735,9474,739,8.46021751574127,8.46021751574127
"40","013","050","Bryan County",46067,48804,2737,5.94134629995441,5.94134629995441
"40","015","050","Caddo County",26945,28777,1832,6.79903507144183,6.79903507144183
"40","017","050","Canadian County",154405,152155,-2250,-1.45720669667433,1.45720669667433
"40","019","050","Carter County",48003,48407,404,0.841614065787555,0.841614065787555
"40","021","050","Cherokee County",47078,49028,1950,4.1420621096903,4.1420621096903
"40","023","050","Choctaw County",14204,14673,469,3.30188679245283,3.30188679245283
"40","025","050","Cimarron County",2296,2161,-135,-5.87979094076655,5.87979094076655
"40","027","050","Cleveland County",295528,286588,-8940,-3.02509406892071,3.02509406892071
"40","029","050","Coal County",5266,5581,315,5.98176984428409,5.98176984428409
"40","031","050","Comanche County",121125,121182,57,0.0470588235294118,0.0470588235294118
"40","033","050","Cotton County",5527,5683,156,2.82250768952415,2.82250768952415
"40","035","050","Craig County",14107,14192,85,0.602537747217693,0.602537747217693
"40","037","050","Creek County",71754,71524,-230,-0.320539621484517,0.320539621484517
"40","039","050","Custer County",28513,28757,244,0.85575000876793,0.85575000876793
"40","041","050","Delaware County",40397,43138,2741,6.78515731366191,6.78515731366191
"40","043","050","Dewey County",4484,4848,364,8.11775200713648,8.11775200713648
"40","045","050","Ellis County",3749,3843,94,2.50733528941051,2.50733528941051
"40","047","050","Garfield County",62846,61044,-1802,-2.86732648060338,2.86732648060338
"40","049","050","Garvin County",25656,27697,2041,7.95525413158715,7.95525413158715
"40","051","050","Grady County",54795,55911,1116,2.03668217903093,2.03668217903093
"40","053","050","Grant County",4169,4361,192,4.60542096426001,4.60542096426001
"40","055","050","Greer County",5491,5721,230,4.18867237297396,4.18867237297396
"40","057","050","Harmon County",2488,2580,92,3.69774919614148,3.69774919614148
"40","059","050","Harper County",3272,3636,364,11.1246943765281,11.1246943765281
"40","061","050","Haskell County",11561,12668,1107,9.57529625464925,9.57529625464925
"40","063","050","Hughes County",13367,13154,-213,-1.59347647190843,1.59347647190843
"40","065","050","Jackson County",24785,24363,-422,-1.70264272745612,1.70264272745612
"40","067","050","Jefferson County",5337,5968,631,11.8231216038973,11.8231216038973
"40","069","050","Johnston County",10272,10890,618,6.01635514018692,6.01635514018692
"40","071","050","Kay County",43700,43410,-290,-0.663615560640732,0.663615560640732
"40","073","050","Kingfisher County",15184,15832,648,4.26765015806112,4.26765015806112
"40","075","050","Kiowa County",8509,8757,248,2.9145610530027,2.9145610530027
"40","077","050","Latimer County",9444,10113,669,7.08386277001271,7.08386277001271
"40","079","050","Le Flore County",48129,49925,1796,3.73163788983773,3.73163788983773
"40","081","050","Lincoln County",33458,35027,1569,4.68946141431048,4.68946141431048
"40","083","050","Logan County",49555,48638,-917,-1.8504691756634,1.8504691756634
"40","085","050","Love County",10146,10200,54,0.532229450029568,0.532229450029568
"40","087","050","McClain County",41662,41159,-503,-1.20733522154481,1.20733522154481
"40","089","050","McCurtain County",30814,32773,1959,6.35749983773609,6.35749983773609
"40","091","050","McIntosh County",18941,19620,679,3.58481600760256,3.58481600760256
"40","093","050","Major County",7782,7582,-200,-2.57003341043434,2.57003341043434
"40","095","050","Marshall County",15312,17070,1758,11.4811912225705,11.4811912225705
"40","097","050","Mayes County",39046,41162,2116,5.41924909081596,5.41924909081596
"40","099","050","Murray County",13904,13982,78,0.560989643268124,0.560989643268124
"40","101","050","Muskogee County",66339,67760,1421,2.14202806795399,2.14202806795399
"40","103","050","Noble County",10924,11110,186,1.70267301354815,1.70267301354815
"40","105","050","Nowata County",9320,10057,737,7.90772532188841,7.90772532188841
"40","107","050","Okfuskee County",11310,11812,502,4.43854995579134,4.43854995579134
"40","109","050","Oklahoma County",796292,802847,6555,0.82319048791147,0.82319048791147
"40","111","050","Okmulgee County",36706,38291,1585,4.31809513431047,4.31809513431047
"40","113","050","Osage County",45818,46713,895,1.953380767384,1.953380767384
"40","115","050","Ottawa County",30285,30955,670,2.21231632821529,2.21231632821529
"40","117","050","Pawnee County",15553,16377,824,5.29801324503311,5.29801324503311
"40","119","050","Payne County",81646,81769,123,0.150650368664723,0.150650368664723
"40","121","050","Pittsburg County",43773,43676,-97,-0.221597788591141,0.221597788591141
"40","123","050","Pontotoc County",38065,38381,316,0.830158938657559,0.830158938657559
"40","125","050","Pottawatomie County",72454,72955,501,0.691473210588787,0.691473210588787
"40","127","050","Pushmataha County",10812,10953,141,1.30410654827969,1.30410654827969
"40","129","050","Roger Mills County",3442,3557,115,3.34108076699593,3.34108076699593
"40","131","050","Rogers County",95240,93049,-2191,-2.3005039899202,2.3005039899202
"40","133","050","Seminole County",23556,24258,702,2.98013245033113,2.98013245033113
"40","135","050","Sequoyah County",39281,41558,2277,5.79669560347242,5.79669560347242
"40","137","050","Stephens County",42848,43141,293,0.683812546676624,0.683812546676624
"40","139","050","Texas County",21384,20026,-1358,-6.35054246165357,6.35054246165357
"40","141","050","Tillman County",6968,7237,269,3.86050516647532,3.86050516647532
"40","143","050","Tulsa County",669279,656547,-12732,-1.90234565853702,1.90234565853702
"40","145","050","Wagoner County",80981,82568,1587,1.95971894641953,1.95971894641953
"40","147","050","Washington County",52455,52094,-361,-0.688208940997045,0.688208940997045
"40","149","050","Washita County",10924,10846,-78,-0.714024166971805,0.714024166971805
"40","151","050","Woods County",8624,8698,74,0.858070500927644,0.858070500927644
"40","153","050","Woodward County",20470,19869,-601,-2.93600390815828,2.93600390815828
"41","001","050","Baker County",16668,16261,-407,-2.44180465562755,2.44180465562755
"41","003","050","Benton County",95184,93292,-1892,-1.98772903008909,1.98772903008909
"41","005","050","Clackamas County",421401,420976,-425,-0.10085405587552,0.10085405587552
"41","007","050","Clatsop County",41072,40419,-653,-1.58989092325672,1.58989092325672
"41","009","050","Columbia County",52589,52864,275,0.522923044743197,0.522923044743197
"41","011","050","Coos County",64929,64768,-161,-0.247963159759122,0.247963159759122
"41","013","050","Crook County",24738,24939,201,0.812515158864904,0.812515158864904
"41","015","050","Curry County",23446,23252,-194,-0.82743325087435,0.82743325087435
"41","017","050","Deschutes County",198253,200798,2545,1.28371323510867,1.28371323510867
"41","019","050","Douglas County",111201,111322,121,0.108811971115368,0.108811971115368
"41","021","050","Gilliam County",1995,1956,-39,-1.95488721804511,1.95488721804511
"41","023","050","Grant County",7233,7186,-47,-0.649799529932255,0.649799529932255
"41","025","050","Harney County",7495,7388,-107,-1.42761841227485,1.42761841227485
"41","027","050","Hood River County",23977,23322,-655,-2.73178462693415,2.73178462693415
"41","029","050","Jackson County",223259,221706,-1553,-0.695604656475215,0.695604656475215
"41","031","050","Jefferson County",24502,24841,339,1.38356052567137,1.38356052567137
"41","033","050","Josephine County",88090,88020,-70,-0.0794641843569077,0.0794641843569077
"41","035","050","Klamath County",69413,68688,-725,-1.04447293734603,1.04447293734603
"41","037","050","Lake County",8160,7955,-205,-2.51225490196078,2.51225490196078
"41","039","050","Lane County",382971,382958,-13,-0.0033945129004546,0.0033945129004546
"41","041","050","Lincoln County",50395,50506,111,0.220259946423256,0.220259946423256
"41","043","050","Linn County",128610,130731,2121,1.64917191509214,1.64917191509214
"41","045","050","Malheur County",31571,30921,-650,-2.05885147762187,2.05885147762187
"41","047","050","Marion County",345920,348993,3073,0.888355689176688,0.888355689176688
"41","049","050","Morrow County",12186,11661,-525,-4.30822255046775,4.30822255046775
"41","051","050","Multnomah County",815428,815194,-234,-0.0286965863325763,0.0286965863325763
"41","053","050","Polk County",87433,87279,-154,-0.176134868985395,0.176134868985395
"41","055","050","Sherman County",1870,1805,-65,-3.47593582887701,3.47593582887701
"41","057","050","Tillamook County",27390,27348,-42,-0.153340635268346,0.153340635268346
"41","059","050","Umatilla County",80075,77782,-2293,-2.86356540743053,2.86356540743053
"41","061","050","Union County",26196,26580,384,1.46587265231333,1.46587265231333
"41","063","050","Wallowa County",7391,7177,-214,-2.89541334054932,2.89541334054932
"41","065","050","Wasco County",26670,26446,-224,-0.83989501312336,0.83989501312336
"41","067","050","Washington County",600372,603195,2823,0.470208470748136,0.470208470748136
"41","069","050","Wheeler County",1451,1383,-68,-4.68642315644383,4.68642315644383
"41","071","050","Yamhill County",107722,107496,-226,-0.209799298193498,0.209799298193498
"42","001","050","Adams County",103852,102835,-1017,-0.979278203597427,0.979278203597427
"42","003","050","Allegheny County",1250578,1213154,-37424,-2.99253625123743,2.99253625123743
"42","005","050","Armstrong County",65558,64348,-1210,-1.8456938893804,1.8456938893804
"42","007","050","Beaver County",168215,163041,-5174,-3.07582558035847,3.07582558035847
"42","009","050","Bedford County",47577,47880,303,0.636862349454568,0.636862349454568
"42","011","050","Berks County",428849,421131,-7718,-1.79970106027996,1.79970106027996
"42","013","050","Blair County",122822,121310,-1512,-1.23104981192295,1.23104981192295
"42","015","050","Bradford County",59967,60331,364,0.60700051695099,0.60700051695099
"42","017","050","Bucks County",646538,628474,-18064,-2.79395797308124,2.79395797308124
"42","019","050","Butler County",193763,189029,-4734,-2.44319090848098,2.44319090848098
"42","021","050","Cambria County",133472,129107,-4365,-3.2703488372093,3.2703488372093
"42","023","050","Cameron County",4547,4361,-186,-4.09060919287442,4.09060919287442
"42","025","050","Carbon County",64749,64132,-617,-0.952910469659763,0.952910469659763
"42","027","050","Centre County",158172,161754,3582,2.26462332144754,2.26462332144754
"42","029","050","Chester County",534413,526641,-7772,-1.4543059394139,1.4543059394139
"42","031","050","Clarion County",37241,38375,1134,3.04503101420477,3.04503101420477
"42","033","050","Clearfield County",80562,78789,-1773,-2.20078945408505,2.20078945408505
"42","035","050","Clinton County",37450,38062,612,1.63417890520694,1.63417890520694
"42","037","050","Columbia County",64727,64929,202,0.312079966629073,0.312079966629073
"42","039","050","Crawford County",83938,83935,-3,-0.0035740665729467,0.0035740665729467
"42","041","050","Cumberland County",259469,255297,-4172,-1.60789920953948,1.60789920953948
"42","043","050","Dauphin County",286401,279717,-6684,-2.3337907339709,2.3337907339709
"42","045","050","Delaware County",576830,567039,-9791,-1.6973805107224,1.6973805107224
"42","047","050","Elk County",30990,29702,-1288,-4.15617941271378,4.15617941271378
"42","049","050","Erie County",270876,268831,-2045,-0.754957988156943,0.754957988156943
"42","051","050","Fayette County",128804,128505,-299,-0.232135647961243,0.232135647961243
"42","053","050","Forest County",6973,6987,14,0.20077441560304,0.20077441560304
"42","055","050","Franklin County",155932,155680,-252,-0.1616089064464,0.1616089064464
"42","057","050","Fulton County",14556,14513,-43,-0.295410827150316,0.295410827150316
"42","059","050","Greene County",35954,35748,-206,-0.572954330533459,0.572954330533459
"42","061","050","Huntingdon County",44092,44709,617,1.39934682028486,1.39934682028486
"42","063","050","Indiana County",83246,83801,555,0.666698700237849,0.666698700237849
"42","065","050","Jefferson County",44492,43177,-1315,-2.95558752135215,2.95558752135215
"42","067","050","Juniata County",23509,24666,1157,4.9215194180952,4.9215194180952
"42","069","050","Lackawanna County",215896,209301,-6595,-3.05471152777263,3.05471152777263
"42","071","050","Lancaster County",552984,546297,-6687,-1.20925741070266,1.20925741070266
"42","073","050","Lawrence County",86070,85233,-837,-0.972464273265946,0.972464273265946
"42","075","050","Lebanon County",143257,141645,-1612,-1.12525042406305,1.12525042406305
"42","077","050","Lehigh County",374557,370652,-3905,-1.04256495006101,1.04256495006101
"42","079","050","Luzerne County",325594,317231,-8363,-2.56853627523849,2.56853627523849
"42","081","050","Lycoming County",114188,113342,-846,-0.740883455354328,0.740883455354328
"42","083","050","McKean County",40432,40411,-21,-0.0519390581717452,0.0519390581717452
"42","085","050","Mercer County",110652,108770,-1882,-1.70082782055453,1.70082782055453
"42","087","050","Mifflin County",46143,46089,-54,-0.117027501462844,0.117027501462844
"42","089","050","Monroe County",168327,170227,1900,1.1287553393098,1.1287553393098
"42","091","050","Montgomery County",856553,833505,-23048,-2.69078504190634,2.69078504190634
"42","093","050","Montour County",18136,18096,-40,-0.220555800617556,0.220555800617556
"42","095","050","Northampton County",312951,305965,-6986,-2.23229834702557,2.23229834702557
"42","097","050","Northumberland County",91647,90393,-1254,-1.36829356116403,1.36829356116403
"42","099","050","Perry County",45842,46259,417,0.909646175995812,0.909646175995812
"42","101","050","Philadelphia County",1603797,1581124,-22673,-1.41370759516323,1.41370759516323
"42","103","050","Pike County",58535,56036,-2499,-4.26924062526694,4.26924062526694
"42","105","050","Potter County",16396,16486,90,0.54891436935838,0.54891436935838
"42","107","050","Schuylkill County",143049,140865,-2184,-1.52674957532034,1.52674957532034
"42","109","050","Snyder County",39736,40339,603,1.51751560297967,1.51751560297967
"42","111","050","Somerset County",74129,73070,-1059,-1.42859069999595,1.42859069999595
"42","113","050","Sullivan County",5840,5927,87,1.48972602739726,1.48972602739726
"42","115","050","Susquehanna County",38434,40072,1638,4.26185148566374,4.26185148566374
"42","117","050","Tioga County",41045,40464,-581,-1.41551955171154,1.41551955171154
"42","119","050","Union County",42681,44363,1682,3.94086361612896,3.94086361612896
"42","121","050","Venango County",50454,50470,16,0.0317120545447338,0.0317120545447338
"42","123","050","Warren County",38587,38982,395,1.02366081841035,1.02366081841035
"42","125","050","Washington County",209349,206894,-2455,-1.17268293614968,1.17268293614968
"42","127","050","Wayne County",51155,51197,42,0.0821034112012511,0.0821034112012511
"42","129","050","Westmoreland County",354663,347721,-6942,-1.95735106283994,1.95735106283994
"42","131","050","Wyoming County",26069,26614,545,2.09060570025701,2.09060570025701
"42","133","050","York County",456438,450374,-6064,-1.32854845565006,1.32854845565006
"44","001","050","Bristol County",50793,48435,-2358,-4.642371980391,4.642371980391
"44","003","050","Kent County",170363,164657,-5706,-3.34931880748754,3.34931880748754
"44","005","050","Newport County",85643,82046,-3597,-4.19999299417349,4.19999299417349
"44","007","050","Providence County",660741,637043,-23698,-3.5865793101987,3.5865793101987
"44","009","050","Washington County",129839,125823,-4016,-3.09306140681921,3.09306140681921
"45","001","050","Abbeville County",24295,24475,180,0.740893187898745,0.740893187898745
"45","003","050","Aiken County",168808,172652,3844,2.27714326335245,2.27714326335245
"45","005","050","Allendale County",8039,8426,387,4.81403159596965,4.81403159596965
"45","007","050","Anderson County",203718,204004,286,0.140390147164217,0.140390147164217
"45","009","050","Bamberg County",13311,13973,662,4.9733303282999,4.9733303282999
"45","011","050","Barnwell County",20589,20858,269,1.30652290057798,1.30652290057798
"45","013","050","Beaufort County",187117,195068,7951,4.24921305920894,4.24921305920894
"45","015","050","Berkeley County",229861,234392,4531,1.97119128516799,1.97119128516799
"45","017","050","Calhoun County",14119,14572,453,3.20844252425809,3.20844252425809
"45","019","050","Charleston County",408235,416901,8666,2.12279691844158,2.12279691844158
"45","021","050","Cherokee County",56216,57367,1151,2.0474597979223,2.0474597979223
"45","023","050","Chester County",32294,32274,-20,-0.0619310088561343,0.0619310088561343
"45","025","050","Chesterfield County",43273,45686,2413,5.5762253599242,5.5762253599242
"45","027","050","Clarendon County",31144,33564,2420,7.77035705111739,7.77035705111739
"45","029","050","Colleton County",38604,37557,-1047,-2.71215418091389,2.71215418091389
"45","031","050","Darlington County",62905,66587,3682,5.85327080518242,5.85327080518242
"45","033","050","Dillon County",28292,30393,2101,7.42612752721617,7.42612752721617
"45","035","050","Dorchester County",161540,165277,3737,2.31335892039123,2.31335892039123
"45","037","050","Edgefield County",25657,27188,1531,5.96718244533656,5.96718244533656
"45","039","050","Fairfield County",20948,22142,1194,5.69982814588505,5.69982814588505
"45","041","050","Florence County",137059,137820,761,0.555235336606863,0.555235336606863
"45","043","050","Georgetown County",63404,63317,-87,-0.137215317645574,0.137215317645574
"45","045","050","Greenville County",525534,530807,5273,1.00336039152557,1.00336039152557
"45","047","050","Greenwood County",69351,71085,1734,2.50032443656184,2.50032443656184
"45","049","050","Hampton County",18561,18369,-192,-1.03442702440601,1.03442702440601
"45","051","050","Horry County",351029,362898,11869,3.38120212290153,3.38120212290153
"45","053","050","Jasper County",28791,31281,2490,8.64853600083359,8.64853600083359
"45","055","050","Kershaw County",65403,67330,1927,2.94634802684892,2.94634802684892
"45","057","050","Lancaster County",96016,100306,4290,4.46800533244459,4.46800533244459
"45","059","050","Laurens County",67539,67816,277,0.410133404403382,0.410133404403382
"45","061","050","Lee County",16531,16754,223,1.34898070292178,1.34898070292178
"45","063","050","Lexington County",293991,302953,8962,3.04839263786987,3.04839263786987
"45","065","050","McCormick County",9526,9436,-90,-0.944782699979005,0.944782699979005
"45","067","050","Marion County",29183,30274,1091,3.73847788095809,3.73847788095809
"45","069","050","Marlboro County",26667,25723,-944,-3.53995575055312,3.53995575055312
"45","071","050","Newberry County",37719,38442,723,1.91680585381373,1.91680585381373
"45","073","050","Oconee County",78607,79902,1295,1.64743597898406,1.64743597898406
"45","075","050","Orangeburg County",84223,85609,1386,1.64563124087245,1.64563124087245
"45","077","050","Pickens County",131404,127756,-3648,-2.77617119722383,2.77617119722383
"45","079","050","Richland County",416147,418767,2620,0.629585218684744,0.629585218684744
"45","081","050","Saluda County",18862,20320,1458,7.72982716573004,7.72982716573004
"45","083","050","Spartanburg County",327997,324825,-3172,-0.967082015994049,0.967082015994049
"45","085","050","Sumter County",105556,106470,914,0.86589109098488,0.86589109098488
"45","087","050","Union County",27244,27039,-205,-0.752459257084129,0.752459257084129
"45","089","050","Williamsburg County",31026,29936,-1090,-3.5131824921034,3.5131824921034
"45","091","050","York County",282090,287273,5183,1.83735687192031,1.83735687192031
"46","003","050","Aurora County",2747,2743,-4,-0.145613396432472,0.145613396432472
"46","005","050","Beadle County",19149,18553,-596,-3.11243406966421,3.11243406966421
"46","007","050","Bennett County",3381,3414,33,0.976042590949423,0.976042590949423
"46","009","050","Bon Homme County",7003,6875,-128,-1.82778809081822,1.82778809081822
"46","011","050","Brookings County",34375,35614,1239,3.60436363636364,3.60436363636364
"46","013","050","Brown County",38301,38820,519,1.35505600375969,1.35505600375969
"46","015","050","Brule County",5247,5269,22,0.419287211740042,0.419287211740042
"46","017","050","Buffalo County",1948,1969,21,1.07802874743326,1.07802874743326
"46","019","050","Butte County",10243,10535,292,2.85072732597872,2.85072732597872
"46","021","050","Campbell County",1377,1386,9,0.65359477124183,0.65359477124183
"46","023","050","Charles Mix County",9373,9287,-86,-0.917529072868879,0.917529072868879
"46","025","050","Clark County",3837,3791,-46,-1.19885327078447,1.19885327078447
"46","027","050","Clay County",14967,14239,-728,-4.86403420859224,4.86403420859224
"46","029","050","Codington County",28325,28198,-127,-0.448367166813769,0.448367166813769
"46","031","050","Corson County",3902,4057,155,3.9723218862122,3.9723218862122
"46","033","050","Custer County",8318,9020,702,8.43952873286848,8.43952873286848
"46","035","050","Davison County",19956,19862,-94,-0.471036279815594,0.471036279815594
"46","037","050","Day County",5449,5386,-63,-1.15617544503579,1.15617544503579
"46","039","050","Deuel County",4295,4351,56,1.30384167636787,1.30384167636787
"46","041","050","Dewey County",5239,5824,585,11.166253101737,11.166253101737
"46","043","050","Douglas County",2835,2905,70,2.46913580246914,2.46913580246914
"46","045","050","Edmunds County",3986,3830,-156,-3.9136979427998,3.9136979427998
"46","047","050","Fall River County",6973,6718,-255,-3.65696256991252,3.65696256991252
"46","049","050","Faulk County",2125,2307,182,8.56470588235294,8.56470588235294
"46","051","050","Grant County",7556,7020,-536,-7.09370037056644,7.09370037056644
"46","053","050","Gregory County",3994,4210,216,5.40811216825238,5.40811216825238
"46","055","050","Haakon County",1872,1870,-2,-0.106837606837607,0.106837606837607
"46","057","050","Hamlin County",6164,6229,65,1.05451005840363,1.05451005840363
"46","059","050","Hand County",3145,3135,-10,-0.317965023847377,0.317965023847377
"46","061","050","Hanson County",3461,3486,25,0.722334585379948,0.722334585379948
"46","063","050","Harding County",1311,1316,5,0.3813882532418,0.3813882532418
"46","065","050","Hughes County",17765,17384,-381,-2.1446664790318,2.1446664790318
"46","067","050","Hutchinson County",7427,7297,-130,-1.75037027063417,1.75037027063417
"46","069","050","Hyde County",1262,1286,24,1.90174326465927,1.90174326465927
"46","071","050","Jackson County",2806,3330,524,18.6742694226657,18.6742694226657
"46","073","050","Jerauld County",1663,1991,328,19.7233914612147,19.7233914612147
"46","075","050","Jones County",917,936,19,2.07197382769902,2.07197382769902
"46","077","050","Kingsbury County",5187,4976,-211,-4.0678619625988,4.0678619625988
"46","079","050","Lake County",11059,12545,1486,13.4370196220273,13.4370196220273
"46","081","050","Lawrence County",25768,26159,391,1.51738590499845,1.51738590499845
"46","083","050","Lincoln County",65161,62594,-2567,-3.93947299765197,3.93947299765197
"46","085","050","Lyman County",3718,3796,78,2.0979020979021,2.0979020979021
"46","087","050","McCook County",5682,5533,-149,-2.62231608588525,2.62231608588525
"46","089","050","McPherson County",2411,2365,-46,-1.90792202405641,1.90792202405641
"46","091","050","Marshall County",4306,4883,577,13.3999071063632,13.3999071063632
"46","093","050","Meade County",29852,28536,-1316,-4.40841484657644,4.40841484657644
"46","095","050","Mellette County",1918,2083,165,8.60271115745568,8.60271115745568
"46","097","050","Miner County",2298,2200,-98,-4.26457789382071,4.26457789382071
"46","099","050","Minnehaha County",197214,196078,-1136,-0.576024014522296,0.576024014522296
"46","101","050","Moody County",6336,6534,198,3.125,3.125
"46","102","050","Oglala Lakota County",13672,14070,398,2.91105909888824,2.91105909888824
"46","103","050","Pennington County",109222,115569,6347,5.81110032777279,5.81110032777279
"46","105","050","Perkins County",2835,2835,0,0,0
"46","107","050","Potter County",2472,2158,-314,-12.7022653721683,12.7022653721683
"46","109","050","Roberts County",10280,10334,54,0.525291828793774,0.525291828793774
"46","111","050","Sanborn County",2330,2319,-11,-0.472103004291845,0.472103004291845
"46","115","050","Spink County",6361,6333,-28,-0.440182361263952,0.440182361263952
"46","117","050","Stanley County",2980,3105,125,4.19463087248322,4.19463087248322
"46","119","050","Sully County",1446,1393,-53,-3.66528354080221,3.66528354080221
"46","121","050","Todd County",9319,10284,965,10.3551883249276,10.3551883249276
"46","123","050","Tripp County",5624,5369,-255,-4.53413940256046,4.53413940256046
"46","125","050","Turner County",8673,8339,-334,-3.85103193819901,3.85103193819901
"46","127","050","Union County",16811,16113,-698,-4.15204330497888,4.15204330497888
"46","129","050","Walworth County",5315,5322,7,0.13170272812794,0.13170272812794
"46","135","050","Yankton County",23310,22732,-578,-2.47962247962248,2.47962247962248
"46","137","050","Ziebach County",2413,2688,275,11.3966017405719,11.3966017405719
"47","001","050","Anderson County",77123,77491,368,0.47715986151991,0.47715986151991
"47","003","050","Bedford County",50237,50136,-101,-0.201047037044409,0.201047037044409
"47","005","050","Benton County",15864,16173,309,1.94780635400908,1.94780635400908
"47","007","050","Bledsoe County",14913,15194,281,1.88426205324214,1.88426205324214
"47","009","050","Blount County",135280,134505,-775,-0.572885866351271,0.572885866351271
"47","011","050","Bradley County",108620,108938,318,0.292763763579451,0.292763763579451
"47","013","050","Campbell County",39272,39855,583,1.48451823181911,1.48451823181911
"47","015","050","Cannon County",14506,14802,296,2.04053495105474,2.04053495105474
"47","017","050","Carroll County",28440,27806,-634,-2.22925457102672,2.22925457102672
"47","019","050","Carter County",56356,56471,115,0.20405990489034,0.20405990489034
"47","021","050","Cheatham County",41072,41078,6,0.014608492403584,0.014608492403584
"47","023","050","Chester County",17341,17412,71,0.409434288680007,0.409434288680007
"47","025","050","Claiborne County",32043,32012,-31,-0.0967449989077178,0.0967449989077178
"47","027","050","Clay County",7581,7621,40,0.527634876665348,0.527634876665348
"47","029","050","Cocke County",35999,36214,215,0.597238812189227,0.597238812189227
"47","031","050","Coffee County",57889,57454,-435,-0.751438097047798,0.751438097047798
"47","033","050","Crockett County",13911,14202,291,2.09186974336856,2.09186974336856
"47","035","050","Cumberland County",61145,61470,325,0.531523427917246,0.531523427917246
"47","037","050","Davidson County",715884,694243,-21641,-3.0229757893737,3.0229757893737
"47","039","050","Decatur County",11435,11607,172,1.5041539134237,1.5041539134237
"47","041","050","DeKalb County",20080,20751,671,3.34163346613546,3.34163346613546
"47","043","050","Dickson County",54315,54292,-23,-0.0423455767283439,0.0423455767283439
"47","045","050","Dyer County",36801,36848,47,0.127713920817369,0.127713920817369
"47","047","050","Fayette County",41990,41527,-463,-1.10264348654442,1.10264348654442
"47","049","050","Fentress County",18489,18751,262,1.41705879171399,1.41705879171399
"47","051","050","Franklin County",42774,42465,-309,-0.72240145883013,0.72240145883013
"47","053","050","Gibson County",50429,49173,-1256,-2.49063039124313,2.49063039124313
"47","055","050","Giles County",30346,29537,-809,-2.66591972582877,2.66591972582877
"47","057","050","Grainger County",23527,23548,21,0.0892591490627789,0.0892591490627789
"47","059","050","Greene County",70152,69503,-649,-0.925133994754248,0.925133994754248
"47","061","050","Grundy County",13529,13489,-40,-0.295661172296548,0.295661172296548
"47","063","050","Hamblen County",64499,65121,622,0.964356036527698,0.964356036527698
"47","065","050","Hamilton County",366207,370913,4706,1.28506555035813,1.28506555035813
"47","067","050","Hancock County",6662,6525,-137,-2.05643950765536,2.05643950765536
"47","069","050","Hardeman County",25462,24922,-540,-2.12080747781007,2.12080747781007
"47","071","050","Hardin County",26831,25606,-1225,-4.56561440125228,4.56561440125228
"47","073","050","Hawkins County",56721,56801,80,0.141041236931648,0.141041236931648
"47","075","050","Haywood County",17864,17061,-803,-4.49507389162562,4.49507389162562
"47","077","050","Henderson County",27842,28090,248,0.890740607714963,0.890740607714963
"47","079","050","Henry County",32199,32141,-58,-0.180129817696202,0.180129817696202
"47","081","050","Hickman County",24925,25355,430,1.72517552657974,1.72517552657974
"47","083","050","Houston County",8283,8273,-10,-0.120729204394543,0.120729204394543
"47","085","050","Humphreys County",18990,18599,-391,-2.05897840968931,2.05897840968931
"47","087","050","Jackson County",11617,11866,249,2.14341051906688,2.14341051906688
"47","089","050","Jefferson County",54683,55133,450,0.822924857816872,0.822924857816872
"47","091","050","Johnson County",17948,17832,-116,-0.646311566748384,0.646311566748384
"47","093","050","Knox County",478971,474445,-4526,-0.944942386908602,0.944942386908602
"47","095","050","Lake County",7005,6984,-21,-0.299785867237687,0.299785867237687
"47","097","050","Lauderdale County",25143,25506,363,1.44374179692161,1.44374179692161
"47","099","050","Lawrence County",44159,44390,231,0.52310967186757,0.52310967186757
"47","101","050","Lewis County",12582,12352,-230,-1.82800826577651,1.82800826577651
"47","103","050","Lincoln County",35319,34536,-783,-2.21693705937314,2.21693705937314
"47","105","050","Loudon County",54886,54723,-163,-0.296979193236891,0.296979193236891
"47","107","050","McMinn County",53276,54141,865,1.62362039192132,1.62362039192132
"47","109","050","McNairy County",25866,25701,-165,-0.637903038738112,0.637903038738112
"47","111","050","Macon County",25216,24800,-416,-1.6497461928934,1.6497461928934
"47","113","050","Madison County",98823,98329,-494,-0.499883630328972,0.499883630328972
"47","115","050","Marion County",28837,28918,81,0.280889135485661,0.280889135485661
"47","117","050","Marshall County",34318,34893,575,1.6755055655924,1.6755055655924
"47","119","050","Maury County",100974,98921,-2053,-2.03319666448789,2.03319666448789
"47","121","050","Meigs County",12758,12492,-266,-2.08496629565763,2.08496629565763
"47","123","050","Monroe County",46250,47043,793,1.71459459459459,1.71459459459459
"47","125","050","Montgomery County",220069,213211,-6858,-3.1162953437331,3.1162953437331
"47","127","050","Moore County",6461,6439,-22,-0.340504565856679,0.340504565856679
"47","129","050","Morgan County",21035,21412,377,1.79225101022106,1.79225101022106
"47","131","050","Obion County",30787,30183,-604,-1.96186702179491,1.96186702179491
"47","133","050","Overton County",22511,22484,-27,-0.1199413620008,0.1199413620008
"47","135","050","Perry County",8366,8109,-257,-3.07195792493426,3.07195792493426
"47","137","050","Pickett County",5001,5066,65,1.2997400519896,1.2997400519896
"47","139","050","Polk County",17544,16813,-731,-4.16666666666667,4.16666666666667
"47","141","050","Putnam County",79854,80696,842,1.05442432439202,1.05442432439202
"47","143","050","Rhea County",32870,33383,513,1.5606936416185,1.5606936416185
"47","145","050","Roane County",53404,53761,357,0.668489251741443,0.668489251741443
"47","147","050","Robertson County",72803,72127,-676,-0.928533164842108,0.928533164842108
"47","149","050","Rutherford County",341486,337582,-3904,-1.14323866864235,1.14323866864235
"47","151","050","Scott County",21850,22094,244,1.11670480549199,1.11670480549199
"47","153","050","Sequatchie County",15826,15149,-677,-4.27777075698218,4.27777075698218
"47","155","050","Sevier County",98380,99082,702,0.713559666598902,0.713559666598902
"47","157","050","Shelby County",929744,936830,7086,0.762145278700374,0.762145278700374
"47","159","050","Smith County",19904,20250,346,1.73834405144695,1.73834405144695
"47","161","050","Stewart County",13657,13810,153,1.12030460569671,1.12030460569671
"47","163","050","Sullivan County",158163,158718,555,0.350903814419302,0.350903814419302
"47","165","050","Sumner County",196281,194576,-1705,-0.868652595004101,0.868652595004101
"47","167","050","Tipton County",60970,61849,879,1.44169263572249,1.44169263572249
"47","169","050","Trousdale County",11615,11399,-216,-1.85966422729229,1.85966422729229
"47","171","050","Unicoi County",17928,17793,-135,-0.753012048192771,0.753012048192771
"47","173","050","Union County",19802,20107,305,1.54024845975154,1.54024845975154
"47","175","050","Van Buren County",6168,5918,-250,-4.05317769130999,4.05317769130999
"47","177","050","Warren County",40953,41506,553,1.35032842526799,1.35032842526799
"47","179","050","Washington County",133001,130217,-2784,-2.09321734423049,2.09321734423049
"47","181","050","Wayne County",16232,16535,303,1.86668309512075,1.86668309512075
"47","183","050","Weakley County",32902,33303,401,1.2187708953863,1.2187708953863
"47","185","050","White County",27351,27609,258,0.943292749808051,0.943292749808051
"47","187","050","Williamson County",247726,243711,-4015,-1.62074227170341,1.62074227170341
"47","189","050","Wilson County",147737,147237,-500,-0.338439253538382,0.338439253538382
"48","001","050","Anderson County",57922,57863,-59,-0.101861123579987,0.101861123579987
"48","003","050","Andrews County",18610,18902,292,1.5690488984417,1.5690488984417
"48","005","050","Angelina County",86395,86874,479,0.55443023323109,0.55443023323109
"48","007","050","Aransas County",23830,23753,-77,-0.323122114981116,0.323122114981116
"48","009","050","Archer County",8560,8731,171,1.99766355140187,1.99766355140187
"48","011","050","Armstrong County",1848,1873,25,1.35281385281385,1.35281385281385
"48","013","050","Atascosa County",48981,51644,2663,5.43680202527511,5.43680202527511
"48","015","050","Austin County",30167,30058,-109,-0.361321974342825,0.361321974342825
"48","017","050","Bailey County",6904,6756,-148,-2.14368482039397,2.14368482039397
"48","019","050","Bandera County",20851,23732,2881,13.8170831135197,13.8170831135197
"48","021","050","Bastrop County",97216,90986,-6230,-6.40841013824885,6.40841013824885
"48","023","050","Baylor County",3465,3531,66,1.9047619047619,1.9047619047619
"48","025","050","Bee County",31047,32579,1532,4.9344542145779,4.9344542145779
"48","027","050","Bell County",370647,368582,-2065,-0.557133876707487,0.557133876707487
"48","029","050","Bexar County",2009324,2022160,12836,0.63882181270915,0.63882181270915
"48","031","050","Blanco County",11374,12217,843,7.41164058378759,7.41164058378759
"48","033","050","Borden County",631,700,69,10.9350237717908,10.9350237717908
"48","035","050","Bosque County",18235,18635,400,2.19358376748012,2.19358376748012
"48","037","050","Bowie County",92893,93571,678,0.729872003272583,0.729872003272583
"48","039","050","Brazoria County",372031,379317,7286,1.95843894729203,1.95843894729203
"48","041","050","Brazos County",233849,231939,-1910,-0.816766374882937,0.816766374882937
"48","043","050","Brewster County",9546,9248,-298,-3.12172637754033,3.12172637754033
"48","045","050","Briscoe County",1435,1505,70,4.8780487804878,4.8780487804878
"48","047","050","Brooks County",7076,7019,-57,-0.805539853024308,0.805539853024308
"48","049","050","Brown County",38095,37704,-391,-1.02638141488384,1.02638141488384
"48","051","050","Burleson County",17642,18519,877,4.97109171295771,4.97109171295771
"48","053","050","Burnet County",49130,49372,242,0.492570730714431,0.492570730714431
"48","055","050","Caldwell County",45883,43930,-1953,-4.25647843427849,4.25647843427849
"48","057","050","Calhoun County",20106,21099,993,4.93882423157267,4.93882423157267
"48","059","050","Callahan County",13708,14089,381,2.77939889115845,2.77939889115845
"48","061","050","Cameron County",421017,424174,3157,0.749850956137163,0.749850956137163
"48","063","050","Camp County",12464,13078,614,4.92618741976893,4.92618741976893
"48","065","050","Carson County",5807,5866,59,1.01601515412433,1.01601515412433
"48","067","050","Cass County",28454,29956,1502,5.27869543825121,5.27869543825121
"48","069","050","Castro County",7371,7437,66,0.895400895400895,0.895400895400895
"48","071","050","Chambers County",46571,45172,-1399,-3.00401537437461,3.00401537437461
"48","073","050","Cherokee County",50412,52844,2432,4.82424819487424,4.82424819487424
"48","075","050","Childress County",6664,7175,511,7.66806722689076,7.66806722689076
"48","077","050","Clay County",10218,10545,327,3.20023487962419,3.20023487962419
"48","079","050","Cochran County",2547,2882,335,13.1527287004319,13.1527287004319
"48","081","050","Coke County",3285,3336,51,1.55251141552511,1.55251141552511
"48","083","050","Coleman County",7684,8118,434,5.64809994794378,5.64809994794378
"48","085","050","Collin County",1064465,1063523,-942,-0.0884951595402385,0.0884951595402385
"48","087","050","Collingsworth County",2652,2893,241,9.08748114630468,9.08748114630468
"48","089","050","Colorado County",20557,21607,1050,5.10774918519239,5.10774918519239
"48","091","050","Comal County",161501,162805,1304,0.80742534101956,0.80742534101956
"48","093","050","Comanche County",13594,13747,153,1.12549654259232,1.12549654259232
"48","095","050","Concho County",3303,2814,-489,-14.8047229791099,14.8047229791099
"48","097","050","Cooke County",41668,41318,-350,-0.839973120860132,0.839973120860132
"48","099","050","Coryell County",83093,76729,-6364,-7.65888823366589,7.65888823366589
"48","101","050","Cottle County",1380,1372,-8,-0.579710144927536,0.579710144927536
"48","103","050","Crane County",4675,4787,112,2.39572192513369,2.39572192513369
"48","105","050","Crockett County",3098,3509,411,13.2666236281472,13.2666236281472
"48","107","050","Crosby County",5133,5613,480,9.35125657510228,9.35125657510228
"48","109","050","Culberson County",2188,2150,-38,-1.73674588665448,1.73674588665448
"48","111","050","Dallam County",7115,7280,165,2.31904427266339,2.31904427266339
"48","113","050","Dallas County",2613539,2637743,24204,0.92610058621662,0.92610058621662
"48","115","050","Dawson County",12456,12994,538,4.31920359666024,4.31920359666024
"48","117","050","Deaf Smith County",18583,18371,-212,-1.14082763816391,1.14082763816391
"48","119","050","Delta County",5230,5354,124,2.37093690248566,2.37093690248566
"48","121","050","Denton County",906422,912175,5753,0.6346933326861,0.6346933326861
"48","123","050","DeWitt County",19824,20174,350,1.76553672316384,1.76553672316384
"48","125","050","Dickens County",1770,2154,384,21.6949152542373,21.6949152542373
"48","127","050","Dimmit County",8615,9981,1366,15.8560650029019,15.8560650029019
"48","129","050","Donley County",3258,3305,47,1.44260282381829,1.44260282381829
"48","131","050","Duval County",9831,11096,1265,12.8674600752721,12.8674600752721
"48","133","050","Eastland County",17725,18372,647,3.65021156558533,3.65021156558533
"48","135","050","Ector County",165171,167431,2260,1.36827893516416,1.36827893516416
"48","137","050","Edwards County",1422,1927,505,35.5133614627285,35.5133614627285
"48","139","050","Ellis County",192455,190121,-2334,-1.21275103270895,1.21275103270895
"48","141","050","El Paso County",865657,841015,-24642,-2.8466240092785,2.8466240092785
"48","143","050","Erath County",42545,43089,544,1.27864613938183,1.27864613938183
"48","145","050","Falls County",16968,17293,325,1.91537010843942,1.91537010843942
"48","147","050","Fannin County",35662,35852,190,0.532779989905221,0.532779989905221
"48","149","050","Fayette County",24435,25510,1075,4.39942705136075,4.39942705136075
"48","151","050","Fisher County",3672,3803,131,3.56753812636166,3.56753812636166
"48","153","050","Floyd County",5402,5697,295,5.46094039244724,5.46094039244724
"48","155","050","Foard County",1095,1132,37,3.37899543378995,3.37899543378995
"48","157","050","Fort Bend County",822779,833674,10895,1.3241708891452,1.3241708891452
"48","159","050","Franklin County",10359,10804,445,4.29578144608553,4.29578144608553
"48","161","050","Freestone County",19435,19876,441,2.26910213532287,2.26910213532287
"48","163","050","Frio County",18385,20368,1983,10.7859668207778,10.7859668207778
"48","165","050","Gaines County",21598,21906,308,1.4260579683304,1.4260579683304
"48","167","050","Galveston County",350682,344408,-6274,-1.78908526813466,1.78908526813466
"48","169","050","Garza County",5816,6239,423,7.27303988995873,7.27303988995873
"48","171","050","Gillespie County",26725,26990,265,0.991580916744621,0.991580916744621
"48","173","050","Glasscock County",1116,1433,317,28.405017921147,28.405017921147
"48","175","050","Goliad County",7012,7631,619,8.82772390188249,8.82772390188249
"48","177","050","Gonzales County",19653,20977,1324,6.73688495395105,6.73688495395105
"48","179","050","Gray County",21227,21725,498,2.34606868610732,2.34606868610732
"48","181","050","Grayson County",135543,137863,2320,1.71163394642291,1.71163394642291
"48","183","050","Gregg County",124239,124290,51,0.0410499118634245,0.0410499118634245
"48","185","050","Grimes County",29268,29468,200,0.683340166735001,0.683340166735001
"48","187","050","Guadalupe County",172706,169821,-2885,-1.67046888932637,1.67046888932637
"48","189","050","Hale County",32522,32861,339,1.04237131787713,1.04237131787713
"48","191","050","Hall County",2825,2949,124,4.38938053097345,4.38938053097345
"48","193","050","Hamilton County",8222,8552,330,4.01362198978351,4.01362198978351
"48","195","050","Hansford County",5285,5297,12,0.227057710501419,0.227057710501419
"48","197","050","Hardeman County",3549,3995,446,12.566920259228,12.566920259228
"48","199","050","Hardin County",56231,58224,1993,3.54430829969234,3.54430829969234
"48","201","050","Harris County",4731145,4734392,3247,0.0686303209899506,0.0686303209899506
"48","203","050","Harrison County",68839,66445,-2394,-3.4776798035997,3.4776798035997
"48","205","050","Hartley County",5382,5459,77,1.43069490895578,1.43069490895578
"48","207","050","Haskell County",5416,5726,310,5.72378138847858,5.72378138847858
"48","209","050","Hays County",241067,238769,-2298,-0.95326195621964,0.95326195621964
"48","211","050","Hemphill County",3382,3788,406,12.0047309284447,12.0047309284447
"48","213","050","Henderson County",82150,83622,1472,1.79184418746196,1.79184418746196
"48","215","050","Hidalgo County",870781,873940,3159,0.362777782243756,0.362777782243756
"48","217","050","Hill County",35874,36919,1045,2.9129731839215,2.9129731839215
"48","219","050","Hockley County",21537,22974,1437,6.67223847332498,6.67223847332498
"48","221","050","Hood County",61598,63142,1544,2.50657488879509,2.50657488879509
"48","223","050","Hopkins County",36787,37181,394,1.07103052708837,1.07103052708837
"48","225","050","Houston County",22066,22873,807,3.65721018761896,3.65721018761896
"48","227","050","Howard County",34860,36608,1748,5.01434308663224,5.01434308663224
"48","229","050","Hudspeth County",3202,4915,1713,53.4978138663335,53.4978138663335
"48","231","050","Hunt County",99956,99570,-386,-0.386169914762496,0.386169914762496
"48","233","050","Hutchinson County",20617,20728,111,0.538390648493961,0.538390648493961
"48","235","050","Irion County",1513,1572,59,3.8995373430271,3.8995373430271
"48","237","050","Jack County",8472,9027,555,6.55099150141643,6.55099150141643
"48","239","050","Jackson County",14988,14845,-143,-0.954096610621831,0.954096610621831
"48","241","050","Jasper County",32980,35462,2482,7.52577319587629,7.52577319587629
"48","243","050","Jeff Davis County",1996,2230,234,11.7234468937876,11.7234468937876
"48","245","050","Jefferson County",256526,250584,-5942,-2.31633440664884,2.31633440664884
"48","247","050","Jim Hogg County",4838,5175,337,6.96568830095081,6.96568830095081
"48","249","050","Jim Wells County",38891,40504,1613,4.14748913630403,4.14748913630403
"48","251","050","Johnson County",179927,178772,-1155,-0.64192700372929,0.64192700372929
"48","253","050","Jones County",19663,19879,216,1.09850989167472,1.09850989167472
"48","255","050","Karnes County",14710,15531,821,5.581237253569,5.581237253569
"48","257","050","Kaufman County",145310,141585,-3725,-2.56348496318216,2.56348496318216
"48","259","050","Kendall County",44279,48268,3989,9.00878520291786,9.00878520291786
"48","261","050","Kenedy County",350,382,32,9.14285714285714,9.14285714285714
"48","263","050","Kent County",753,779,26,3.45285524568393,3.45285524568393
"48","265","050","Kerr County",52598,52795,197,0.374538955853835,0.374538955853835
"48","267","050","Kimble County",4286,4384,98,2.28651423238451,2.28651423238451
"48","269","050","King County",265,282,17,6.41509433962264,6.41509433962264
"48","271","050","Kinney County",3129,3672,543,17.3537871524449,17.3537871524449
"48","273","050","Kleberg County",31040,30408,-632,-2.0360824742268,2.0360824742268
"48","275","050","Knox County",3353,3679,326,9.72263644497465,9.72263644497465
"48","277","050","Lamar County",50088,49903,-185,-0.369349944098387,0.369349944098387
"48","279","050","Lamb County",13045,12761,-284,-2.17707934074358,2.17707934074358
"48","281","050","Lampasas County",21627,21685,58,0.26818328940676,0.26818328940676
"48","283","050","La Salle County",6664,7517,853,12.8001200480192,12.8001200480192
"48","285","050","Lavaca County",20337,20205,-132,-0.649063283670158,0.649063283670158
"48","287","050","Lee County",17478,17396,-82,-0.469161231262158,0.469161231262158
"48","289","050","Leon County",15719,17481,1762,11.2093644633883,11.2093644633883
"48","291","050","Liberty County",91628,90825,-803,-0.876369668660235,0.876369668660235
"48","293","050","Limestone County",22146,23381,1235,5.5766278334688,5.5766278334688
"48","295","050","Lipscomb County",3059,3142,83,2.71330500163452,2.71330500163452
"48","297","050","Live Oak County",11335,12309,974,8.59285399205999,8.59285399205999
"48","299","050","Llano County",21243,21947,704,3.3140328578826,3.3140328578826
"48","301","050","Loving County",64,172,108,168.75,168.75
"48","303","050","Lubbock County",310639,314034,3395,1.0929084886315,1.0929084886315
"48","305","050","Lynn County",5596,6017,421,7.52323087919943,7.52323087919943
"48","307","050","McCulloch County",7630,7877,247,3.23722149410223,3.23722149410223
"48","309","050","McLennan County",260579,259203,-1376,-0.528054831740086,0.528054831740086
"48","311","050","McMullen County",600,729,129,21.5,21.5
"48","313","050","Madison County",13455,14414,959,7.1274619100706,7.1274619100706
"48","315","050","Marion County",9725,9922,197,2.02570694087404,2.02570694087404
"48","317","050","Martin County",5237,5793,556,10.6167653236586,10.6167653236586
"48","319","050","Mason County",3953,4323,370,9.35997976220592,9.35997976220592
"48","321","050","Matagorda County",36255,36734,479,1.32119707626534,1.32119707626534
"48","323","050","Maverick County",57887,58417,530,0.915576899822067,0.915576899822067
"48","325","050","Medina County",50748,52193,1445,2.84740285331442,2.84740285331442
"48","327","050","Menard County",1962,2116,154,7.84913353720693,7.84913353720693
"48","329","050","Midland County",169983,177595,7612,4.47809486831036,4.47809486831036
"48","331","050","Milam County",24754,24726,-28,-0.113113032237214,0.113113032237214
"48","333","050","Mills County",4456,4841,385,8.64003590664273,8.64003590664273
"48","335","050","Mitchell County",8990,8188,-802,-8.9210233592881,8.9210233592881
"48","337","050","Montague County",19965,19934,-31,-0.155271725519659,0.155271725519659
"48","339","050","Montgomery County",620443,621953,1510,0.243374492096776,0.243374492096776
"48","341","050","Moore County",21358,20707,-651,-3.04803820582452,3.04803820582452
"48","343","050","Morris County",11973,12384,411,3.43272362816337,3.43272362816337
"48","345","050","Motley County",1063,1189,126,11.8532455315146,11.8532455315146
"48","347","050","Nacogdoches County",64653,64802,149,0.230461076825515,0.230461076825515
"48","349","050","Navarro County",52624,50539,-2085,-3.96207053815749,3.96207053815749
"48","351","050","Newton County",12217,13488,1271,10.403536056315,10.403536056315
"48","353","050","Nolan County",14738,14819,81,0.549599674311304,0.549599674311304
"48","355","050","Nueces County",353178,363196,10018,2.83653002168878,2.83653002168878
"48","357","050","Ochiltree County",10015,9648,-367,-3.6645032451323,3.6645032451323
"48","359","050","Oldham County",1758,2126,368,20.9328782707622,20.9328782707622
"48","361","050","Orange County",84808,82953,-1855,-2.18729365154231,2.18729365154231
"48","363","050","Palo Pinto County",28409,29280,871,3.06592981097539,3.06592981097539
"48","365","050","Panola County",22491,23170,679,3.01898537192655,3.01898537192655
"48","367","050","Parker County",148222,146987,-1235,-0.833209644991971,0.833209644991971
"48","369","050","Parmer County",9869,9525,-344,-3.48566217448576,3.48566217448576
"48","371","050","Pecos County",15193,15725,532,3.50161258474297,3.50161258474297
"48","373","050","Polk County",50123,52560,2437,4.86203938311753,4.86203938311753
"48","375","050","Potter County",118525,116271,-2254,-1.90170850031639,1.90170850031639
"48","377","050","Presidio County",6131,6528,397,6.47528951231447,6.47528951231447
"48","379","050","Rains County",12164,12521,357,2.93488983886879,2.93488983886879
"48","381","050","Randall County",140753,139430,-1323,-0.939944441681527,0.939944441681527
"48","383","050","Reagan County",3385,3832,447,13.205317577548,13.205317577548
"48","385","050","Real County",2758,3427,669,24.2567077592458,24.2567077592458
"48","387","050","Red River County",11587,12023,436,3.76283766289808,3.76283766289808
"48","389","050","Reeves County",14748,15940,1192,8.08245185787903,8.08245185787903
"48","391","050","Refugio County",6741,6860,119,1.76531671858775,1.76531671858775
"48","393","050","Roberts County",827,817,-10,-1.20918984280532,1.20918984280532
"48","395","050","Robertson County",16757,17148,391,2.33335322551769,2.33335322551769
"48","397","050","Rockwall County",107819,108680,861,0.798560550552315,0.798560550552315
"48","399","050","Runnels County",9900,10371,471,4.75757575757576,4.75757575757576
"48","401","050","Rusk County",52214,54368,2154,4.12533037116482,4.12533037116482
"48","403","050","Sabine County",9894,10506,612,6.18556701030928,6.18556701030928
"48","405","050","San Augustine County",7918,8237,319,4.02879515029048,4.02879515029048
"48","407","050","San Jacinto County",27402,29197,1795,6.55061674330341,6.55061674330341
"48","409","050","San Patricio County",68755,66969,-1786,-2.5976292633263,2.5976292633263
"48","411","050","San Saba County",5730,6028,298,5.20069808027923,5.20069808027923
"48","413","050","Schleicher County",2451,2764,313,12.7702978376173,12.7702978376173
"48","415","050","Scurry County",16932,16654,-278,-1.64186156390267,1.64186156390267
"48","417","050","Shackelford County",3105,3298,193,6.21578099838969,6.21578099838969
"48","419","050","Shelby County",24022,25034,1012,4.21280492881525,4.21280492881525
"48","421","050","Sherman County",2782,3025,243,8.73472322070453,8.73472322070453
"48","423","050","Smith County",233479,235217,1738,0.74439242929771,0.74439242929771
"48","425","050","Somervell County",9205,9127,-78,-0.847365562194459,0.847365562194459
"48","427","050","Starr County",65920,64313,-1607,-2.43780339805825,2.43780339805825
"48","429","050","Stephens County",9101,9335,234,2.57114602790902,2.57114602790902
"48","431","050","Sterling County",1372,1306,-66,-4.81049562682216,4.81049562682216
"48","433","050","Stonewall County",1245,1352,107,8.59437751004016,8.59437751004016
"48","435","050","Sutton County",3372,3758,386,11.4472123368921,11.4472123368921
"48","437","050","Swisher County",6971,7331,360,5.1642519007316,5.1642519007316
"48","439","050","Tarrant County",2110640,2119134,8494,0.402437175453891,0.402437175453891
"48","441","050","Taylor County",143208,138998,-4210,-2.93977990056421,2.93977990056421
"48","443","050","Terrell County",760,717,-43,-5.65789473684211,5.65789473684211
"48","445","050","Terry County",11831,12225,394,3.33023413067365,3.33023413067365
"48","447","050","Throckmorton County",1440,1475,35,2.43055555555556,2.43055555555556
"48","449","050","Titus County",31247,32886,1639,5.24530354914072,5.24530354914072
"48","451","050","Tom Green County",120003,119919,-84,-0.0699982500437489,0.0699982500437489
"48","453","050","Travis County",1290188,1294483,4295,0.332897221180169,0.332897221180169
"48","455","050","Trinity County",13602,14828,1226,9.01338038523746,9.01338038523746
"48","457","050","Tyler County",19798,21562,1764,8.90999090817254,8.90999090817254
"48","459","050","Upshur County",40892,42039,1147,2.80494962339822,2.80494962339822
"48","461","050","Upton County",3308,3622,314,9.49214026602177,9.49214026602177
"48","463","050","Uvalde County",24564,26753,2189,8.91141507897736,8.91141507897736
"48","465","050","Val Verde County",47586,49031,1445,3.03660740553944,3.03660740553944
"48","467","050","Van Zandt County",59541,57327,-2214,-3.71844611276263,3.71844611276263
"48","469","050","Victoria County",91319,91975,656,0.718360910653862,0.718360910653862
"48","471","050","Walker County",76400,72061,-4339,-5.67931937172775,5.67931937172775
"48","473","050","Waller County",56794,56929,135,0.237701165616086,0.237701165616086
"48","475","050","Ward County",11644,12048,404,3.46959807626245,3.46959807626245
"48","477","050","Washington County",35805,35742,-63,-0.175953079178886,0.175953079178886
"48","479","050","Webb County",267114,277567,10453,3.91331042176749,3.91331042176749
"48","481","050","Wharton County",41570,41684,114,0.274236228049074,0.274236228049074
"48","483","050","Wheeler County",4990,4952,-38,-0.761523046092184,0.761523046092184
"48","485","050","Wichita County",129350,133036,3686,2.84963277928102,2.84963277928102
"48","487","050","Wilbarger County",12887,12579,-308,-2.39000543183053,2.39000543183053
"48","489","050","Willacy County",20164,21186,1022,5.06843880182504,5.06843880182504
"48","491","050","Williamson County",609017,611682,2665,0.437590412090303,0.437590412090303
"48","493","050","Wilson County",49753,51753,2000,4.01985809900911,4.01985809900911
"48","495","050","Winkler County",7791,7888,97,1.24502631241176,1.24502631241176
"48","497","050","Wise County",68632,70786,2154,3.13847767805105,3.13847767805105
"48","499","050","Wood County",44843,46095,1252,2.79196307115938,2.79196307115938
"48","501","050","Yoakum County",7694,8679,985,12.8021835196257,12.8021835196257
"48","503","050","Young County",17867,17905,38,0.212682599205239,0.212682599205239
"48","505","050","Zapata County",13889,14186,297,2.13838289293686,2.13838289293686
"48","507","050","Zavala County",9670,11813,2143,22.1613236814891,22.1613236814891
"49","001","050","Beaver County",7072,6766,-306,-4.32692307692308,4.32692307692308
"49","003","050","Box Elder County",57666,56805,-861,-1.49308084486526,1.49308084486526
"49","005","050","Cache County",133154,129656,-3498,-2.62703335986902,2.62703335986902
"49","007","050","Carbon County",20412,20725,313,1.5334117185969,1.5334117185969
"49","009","050","Daggett County",935,1013,78,8.34224598930481,8.34224598930481
"49","011","050","Davis County",362679,358385,-4294,-1.1839670893545,1.1839670893545
"49","013","050","Duchesne County",19596,19910,314,1.60236783016942,1.60236783016942
"49","015","050","Emery County",9825,10127,302,3.07379134860051,3.07379134860051
"49","017","050","Garfield County",5083,5042,-41,-0.806610269525871,0.806610269525871
"49","019","050","Grand County",9669,9803,134,1.38587237563347,1.38587237563347
"49","021","050","Iron County",57289,56481,-808,-1.41039292010683,1.41039292010683
"49","023","050","Juab County",11786,12108,322,2.73205498048532,2.73205498048532
"49","025","050","Kane County",7667,7899,232,3.02595539324377,3.02595539324377
"49","027","050","Millard County",12975,13280,305,2.35067437379576,2.35067437379576
"49","029","050","Morgan County",12295,12377,82,0.666937779585197,0.666937779585197
"49","031","050","Piute County",1438,1472,34,2.3643949930459,2.3643949930459
"49","033","050","Rich County",2510,2458,-52,-2.07171314741036,2.07171314741036
"49","035","050","Salt Lake County",1185238,1164301,-20937,-1.76648065620576,1.76648065620576
"49","037","050","San Juan County",14518,15274,756,5.20732883317261,5.20732883317261
"49","039","050","Sanpete County",28437,31301,2864,10.0713858705208,10.0713858705208
"49","041","050","Sevier County",21522,21755,233,1.08261314004275,1.08261314004275
"49","043","050","Summit County",42357,42389,32,0.0755483155086527,0.0755483155086527
"49","045","050","Tooele County",72698,73920,1222,1.68092657294561,1.68092657294561
"49","047","050","Uintah County",35620,35922,302,0.847838293093768,0.847838293093768
"49","049","050","Utah County",659399,647412,-11987,-1.81786748235894,1.81786748235894
"49","051","050","Wasatch County",34788,35010,222,0.63815108658158,0.63815108658158
"49","053","050","Washington County",180279,183252,2973,1.64911054532142,1.64911054532142
"49","055","050","Wayne County",2486,2736,250,10.0563153660499,10.0563153660499
"49","057","050","Weber County",262223,261963,-260,-0.0991522482772297,0.0991522482772297
"50","001","050","Addison County",37363,36937,-426,-1.14016540427696,1.14016540427696
"50","003","050","Bennington County",37347,35446,-1901,-5.09010094518971,5.09010094518971
"50","005","050","Caledonia County",30233,29773,-460,-1.52151622399365,1.52151622399365
"50","007","050","Chittenden County",168323,164323,-4000,-2.37638350076935,2.37638350076935
"50","009","050","Essex County",5920,6133,213,3.59797297297297,3.59797297297297
"50","011","050","Franklin County",49946,49647,-299,-0.598646538261322,0.598646538261322
"50","013","050","Grand Isle County",7293,7179,-114,-1.56314273961333,1.56314273961333
"50","015","050","Lamoille County",25945,25364,-581,-2.23935247639237,2.23935247639237
"50","017","050","Orange County",29277,28835,-442,-1.50971752570277,1.50971752570277
"50","019","050","Orleans County",27393,26901,-492,-1.79607929032965,1.79607929032965
"50","021","050","Rutland County",60572,57879,-2693,-4.4459486231262,4.4459486231262
"50","023","050","Washington County",59807,58363,-1444,-2.41443309311619,2.41443309311619
"50","025","050","Windham County",45905,42064,-3841,-8.36728025269578,8.36728025269578
"50","027","050","Windsor County",57753,54977,-2776,-4.80667670943501,4.80667670943501
"51","001","050","Accomack County",33413,32315,-1098,-3.2861461107952,3.2861461107952
"51","003","050","Albemarle County",112395,110549,-1846,-1.64242181591708,1.64242181591708
"51","005","050","Alleghany County",15223,14767,-456,-2.99546738487815,2.99546738487815
"51","007","050","Amelia County",13265,13047,-218,-1.64342254052017,1.64342254052017
"51","009","050","Amherst County",31307,31714,407,1.30002874756444,1.30002874756444
"51","011","050","Appomattox County",16119,16033,-86,-0.533531856814939,0.533531856814939
"51","013","050","Arlington County",238643,239850,1207,0.505776410789338,0.505776410789338
"51","015","050","Augusta County",77487,76522,-965,-1.24537019112883,1.24537019112883
"51","017","050","Bath County",4209,4137,-72,-1.71062009978617,1.71062009978617
"51","019","050","Bedford County",79462,79800,338,0.42536054969671,0.42536054969671
"51","021","050","Bland County",6270,6261,-9,-0.143540669856459,0.143540669856459
"51","023","050","Botetourt County",33596,33646,50,0.148827241338255,0.148827241338255
"51","025","050","Brunswick County",15849,16084,235,1.48274339075021,1.48274339075021
"51","027","050","Buchanan County",20355,20726,371,1.82264799803488,1.82264799803488
"51","029","050","Buckingham County",16824,17174,350,2.08036138849263,2.08036138849263
"51","031","050","Campbell County",55696,55391,-305,-0.547615627693192,0.547615627693192
"51","033","050","Caroline County",30887,30866,-21,-0.0679897691585457,0.0679897691585457
"51","035","050","Carroll County",29155,30092,937,3.21385697135997,3.21385697135997
"51","036","050","Charles City County",6773,6876,103,1.52074413110881,1.52074413110881
"51","037","050","Charlotte County",11529,11855,326,2.82765200797988,2.82765200797988
"51","041","050","Chesterfield County",364548,357241,-7307,-2.00439996927702,2.00439996927702
"51","043","050","Clarke County",14783,14613,-170,-1.1499695596293,1.1499695596293
"51","045","050","Craig County",4892,5094,202,4.12919051512674,4.12919051512674
"51","047","050","Culpeper County",52552,53390,838,1.59461105191049,1.59461105191049
"51","049","050","Cumberland County",9675,9948,273,2.82170542635659,2.82170542635659
"51","051","050","Dickenson County",14124,14140,16,0.11328235627301,0.11328235627301
"51","053","050","Dinwiddie County",27947,28747,800,2.86256127670233,2.86256127670233
"51","057","050","Essex County",10599,10957,358,3.37767713935277,3.37767713935277
"51","059","050","Fairfax County",1150309,1152138,1829,0.159000755449188,0.159000755449188
"51","061","050","Fauquier County",72972,71408,-1564,-2.14328783643041,2.14328783643041
"51","063","050","Floyd County",15476,15797,321,2.07417937451538,2.07417937451538
"51","065","050","Fluvanna County",27249,27417,168,0.616536386656391,0.616536386656391
"51","067","050","Franklin County",54477,56242,1765,3.23989940708923,3.23989940708923
"51","069","050","Frederick County",91419,90784,-635,-0.694603966352728,0.694603966352728
"51","071","050","Giles County",16787,16681,-106,-0.631440996008816,0.631440996008816
"51","073","050","Gloucester County",38711,37501,-1210,-3.12572653767663,3.12572653767663
"51","075","050","Goochland County",24727,24353,-374,-1.51251668216929,1.51251668216929
"51","077","050","Grayson County",15333,15530,197,1.28481053935955,1.28481053935955
"51","079","050","Greene County",20552,20112,-440,-2.14091086025691,2.14091086025691
"51","081","050","Greensville County",11391,11296,-95,-0.833991747871126,0.833991747871126
"51","083","050","Halifax County",34022,33761,-261,-0.767150667215331,0.767150667215331
"51","085","050","Hanover County",109979,108158,-1821,-1.65577064712354,1.65577064712354
"51","087","050","Henrico County",334389,333715,-674,-0.201561654241019,0.201561654241019
"51","089","050","Henry County",50948,50472,-476,-0.934285938604067,0.934285938604067
"51","091","050","Highland County",2232,2200,-32,-1.4336917562724,1.4336917562724
"51","093","050","Isle of Wight County",38606,37673,-933,-2.41672278920375,2.41672278920375
"51","095","050","James City County",78254,77492,-762,-0.973752140465663,0.973752140465663
"51","097","050","King and Queen County",6608,6961,353,5.34200968523002,5.34200968523002
"51","099","050","King George County",26723,27293,570,2.13299405006923,2.13299405006923
"51","101","050","King William County",17810,17545,-265,-1.4879281302639,1.4879281302639
"51","103","050","Lancaster County",10919,10636,-283,-2.59181243703636,2.59181243703636
"51","105","050","Lee County",22173,23327,1154,5.20452802958553,5.20452802958553
"51","107","050","Loudoun County",420959,421074,115,0.0273185749681085,0.0273185749681085
"51","109","050","Louisa County",37596,37974,378,1.00542610916055,1.00542610916055
"51","111","050","Lunenburg County",11936,12271,335,2.80663538873995,2.80663538873995
"51","113","050","Madison County",13837,13308,-529,-3.82308303823083,3.82308303823083
"51","115","050","Mathews County",8533,8786,253,2.96495956873315,2.96495956873315
"51","117","050","Mecklenburg County",30319,30710,391,1.28962037006498,1.28962037006498
"51","119","050","Middlesex County",10625,10575,-50,-0.470588235294118,0.470588235294118
"51","121","050","Montgomery County",99721,98560,-1161,-1.16424825262482,1.16424825262482
"51","125","050","Nelson County",14775,14797,22,0.148900169204738,0.148900169204738
"51","127","050","New Kent County",22945,23500,555,2.41882763129222,2.41882763129222
"51","131","050","Northampton County",12282,11730,-552,-4.49438202247191,4.49438202247191
"51","133","050","Northumberland County",11839,12077,238,2.0103049244024,2.0103049244024
"51","135","050","Nottoway County",15642,15179,-463,-2.95997954225802,2.95997954225802
"51","137","050","Orange County",36254,37535,1281,3.5334032106802,3.5334032106802
"51","139","050","Page County",23709,23945,236,0.995402589733856,0.995402589733856
"51","141","050","Patrick County",17608,17533,-75,-0.425942753293957,0.425942753293957
"51","143","050","Pittsylvania County",60501,60032,-469,-0.775193798449612,0.775193798449612
"51","145","050","Powhatan County",30333,30033,-300,-0.989021857383048,0.989021857383048
"51","147","050","Prince Edward County",21849,22975,1126,5.15355393839535,5.15355393839535
"51","149","050","Prince George County",43010,38663,-4347,-10.1069518716578,10.1069518716578
"51","153","050","Prince William County",482204,474887,-7317,-1.51740757023998,1.51740757023998
"51","155","050","Pulaski County",33800,33976,176,0.520710059171598,0.520710059171598
"51","157","050","Rappahannock County",7348,7304,-44,-0.598802395209581,0.598802395209581
"51","159","050","Richmond County",8923,9077,154,1.72587694721506,1.72587694721506
"51","161","050","Roanoke County",96929,94525,-2404,-2.4801658946239,2.4801658946239
"51","163","050","Rockbridge County",22650,22772,122,0.538631346578366,0.538631346578366
"51","165","050","Rockingham County",83757,82335,-1422,-1.69776854471865,1.69776854471865
"51","167","050","Russell County",25781,26679,898,3.48318529149374,3.48318529149374
"51","169","050","Scott County",21576,21615,39,0.180756395995551,0.180756395995551
"51","171","050","Shenandoah County",44186,43853,-333,-0.753632372244602,0.753632372244602
"51","173","050","Smyth County",29800,30120,320,1.0738255033557,1.0738255033557
"51","175","050","Southampton County",17996,17687,-309,-1.71704823294065,1.71704823294065
"51","177","050","Spotsylvania County",140032,138009,-2023,-1.44466978976234,1.44466978976234
"51","179","050","Stafford County",156927,156063,-864,-0.550574470932344,0.550574470932344
"51","181","050","Surry County",6561,6380,-181,-2.75872580399329,2.75872580399329
"51","183","050","Sussex County",10829,10969,140,1.29282482223659,1.29282482223659
"51","185","050","Tazewell County",40429,40583,154,0.380914689950283,0.380914689950283
"51","187","050","Warren County",40727,40426,-301,-0.739067449112382,0.739067449112382
"51","191","050","Washington County",53935,53747,-188,-0.34856772040419,0.34856772040419
"51","193","050","Westmoreland County",18477,18121,-356,-1.92671970557991,1.92671970557991
"51","195","050","Wise County",36130,37263,1133,3.13589814558539,3.13589814558539
"51","197","050","Wythe County",28290,28610,320,1.13114174620007,1.13114174620007
"51","199","050","York County",70045,69075,-970,-1.38482404168749,1.38482404168749
"51","510","050","Alexandria city",159467,158872,-595,-0.373117949168166,0.373117949168166
"51","520","050","Bristol city",17219,17250,31,0.18003368372147,0.18003368372147
"51","530","050","Buena Vista city",6641,6420,-221,-3.3278120764945,3.3278120764945
"51","540","050","Charlottesville city",46553,47053,500,1.07404463729513,1.07404463729513
"51","550","050","Chesapeake city",249422,246720,-2702,-1.08330460023574,1.08330460023574
"51","570","050","Colonial Heights city",18170,17178,-992,-5.45954870665933,5.45954870665933
"51","580","050","Covington city",5737,5634,-103,-1.7953634303643,1.7953634303643
"51","590","050","Danville city",42590,39923,-2667,-6.2620333411599,6.2620333411599
"51","595","050","Emporia city",5766,5284,-482,-8.3593479014915,8.3593479014915
"51","600","050","Fairfax city",24146,23394,-752,-3.11438747618653,3.11438747618653
"51","610","050","Falls Church city",14658,14598,-60,-0.409332787556283,0.409332787556283
"51","620","050","Franklin city",8180,7836,-344,-4.20537897310513,4.20537897310513
"51","630","050","Fredericksburg city",27982,29451,1469,5.24980344507183,5.24980344507183
"51","640","050","Galax city",6720,6296,-424,-6.30952380952381,6.30952380952381
"51","650","050","Hampton city",137148,135430,-1718,-1.25266135853239,1.25266135853239
"51","660","050","Harrisonburg city",51814,53284,1470,2.83707106187517,2.83707106187517
"51","670","050","Hopewell city",23033,22385,-648,-2.81335475187774,2.81335475187774
"51","678","050","Lexington city",7320,7270,-50,-0.683060109289617,0.683060109289617
"51","680","050","Lynchburg city",79009,81635,2626,3.32367198673569,3.32367198673569
"51","683","050","Manassas city",42772,40899,-1873,-4.37903301225101,4.37903301225101
"51","685","050","Manassas Park city",17219,18001,782,4.54149486032871,4.54149486032871
"51","690","050","Martinsville city",13485,12368,-1117,-8.28327771598072,8.28327771598072
"51","700","050","Newport News city",186247,179309,-6938,-3.72516067372897,3.72516067372897
"51","710","050","Norfolk city",238005,243089,5084,2.13608957795004,2.13608957795004
"51","720","050","Norton city",3687,3976,289,7.83835096284242,7.83835096284242
"51","730","050","Petersburg city",33458,30465,-2993,-8.94554366668659,8.94554366668659
"51","735","050","Poquoson city",12460,12246,-214,-1.71749598715891,1.71749598715891
"51","740","050","Portsmouth city",97915,94993,-2922,-2.98422100801716,2.98422100801716
"51","750","050","Radford city",16070,18214,2144,13.3416303671437,13.3416303671437
"51","760","050","Richmond city",226610,232056,5446,2.40324787079123,2.40324787079123
"51","770","050","Roanoke city",100011,99138,-873,-0.872903980562138,0.872903980562138
"51","775","050","Salem city",25346,25306,-40,-0.157815828927641,0.157815828927641
"51","790","050","Staunton city",25750,25120,-630,-2.44660194174757,2.44660194174757
"51","800","050","Suffolk city",94324,93537,-787,-0.834358169712904,0.834358169712904
"51","810","050","Virginia Beach city",459470,451340,-8130,-1.76942999542952,1.76942999542952
"51","820","050","Waynesboro city",22196,22621,425,1.91475941611101,1.91475941611101
"51","830","050","Williamsburg city",15425,15185,-240,-1.55591572123177,1.55591572123177
"51","840","050","Winchester city",28120,27781,-339,-1.20554765291607,1.20554765291607
"53","001","050","Adams County",20613,20052,-561,-2.72158346674429,2.72158346674429
"53","003","050","Asotin County",22285,22812,527,2.36481938523671,2.36481938523671
"53","005","050","Benton County",206873,206007,-866,-0.418614318929972,0.418614318929972
"53","007","050","Chelan County",79074,77498,-1576,-1.99306978273516,1.99306978273516
"53","009","050","Clallam County",77155,77979,824,1.06798004017886,1.06798004017886
"53","011","050","Clark County",503311,495223,-8088,-1.6069587193604,1.6069587193604
"53","013","050","Columbia County",3952,4045,93,2.35323886639676,2.35323886639676
"53","015","050","Cowlitz County",110730,111187,457,0.412715614557934,0.412715614557934
"53","017","050","Douglas County",42938,43538,600,1.39736364059807,1.39736364059807
"53","019","050","Ferry County",7178,7763,585,8.14990247979939,8.14990247979939
"53","021","050","Franklin County",96749,96749,0,0,0
"53","023","050","Garfield County",2286,2294,8,0.349956255468067,0.349956255468067
"53","025","050","Grant County",99123,99107,-16,-0.0161415614943051,0.0161415614943051
"53","027","050","Grays Harbor County",75636,75781,145,0.191707652440637,0.191707652440637
"53","029","050","Island County",86857,85923,-934,-1.07533071600447,1.07533071600447
"53","031","050","Jefferson County",32977,32659,-318,-0.96430845740971,0.96430845740971
"53","033","050","King County",2269675,2269880,205,0.00903213015079251,0.00903213015079251
"53","035","050","Kitsap County",275611,272796,-2815,-1.02136707170614,1.02136707170614
"53","037","050","Kittitas County",44337,48899,4562,10.2893745630061,10.2893745630061
"53","039","050","Klickitat County",22735,22641,-94,-0.413459423795909,0.413459423795909
"53","041","050","Lewis County",82149,81766,-383,-0.466226003968399,0.466226003968399
"53","043","050","Lincoln County",10876,11064,188,1.7285766826039,1.7285766826039
"53","045","050","Mason County",65726,67929,2203,3.35179381066853,3.35179381066853
"53","047","050","Okanogan County",42104,42601,497,1.18041041231237,1.18041041231237
"53","049","050","Pacific County",23365,22873,-492,-2.10571367429917,2.10571367429917
"53","051","050","Pend Oreille County",13401,14039,638,4.76083874337736,4.76083874337736
"53","053","050","Pierce County",921130,912328,-8802,-0.955565446788184,0.955565446788184
"53","055","050","San Juan County",17788,17457,-331,-1.86080503710367,1.86080503710367
"53","057","050","Skagit County",129523,130439,916,0.707210302417331,0.707210302417331
"53","059","050","Skamania County",12036,12095,59,0.490196078431373,0.490196078431373
"53","061","050","Snohomish County",827957,828858,901,0.108822076508804,0.108822076508804
"53","063","050","Spokane County",539339,526920,-12419,-2.30263340867247,2.30263340867247
"53","065","050","Stevens County",46445,46241,-204,-0.439229195823017,0.439229195823017
"53","067","050","Thurston County",294793,293104,-1689,-0.572944405057108,0.572944405057108
"53","069","050","Wahkiakum County",4422,4483,61,1.37946630483944,1.37946630483944
"53","071","050","Walla Walla County",62584,61259,-1325,-2.11715454429247,2.11715454429247
"53","073","050","Whatcom County",226847,230501,3654,1.61077730805345,1.61077730805345
"53","075","050","Whitman County",47973,49664,1691,3.52489942259187,3.52489942259187
"53","077","050","Yakima County",256728,251925,-4803,-1.87085164064691,1.87085164064691
"54","001","050","Barbour County",15465,16474,1009,6.52440995796961,6.52440995796961
"54","003","050","Berkeley County",122076,121579,-497,-0.407123431305089,0.407123431305089
"54","005","050","Boone County",21809,21161,-648,-2.97125040121051,2.97125040121051
"54","007","050","Braxton County",12447,13777,1330,10.6853056961517,10.6853056961517
"54","009","050","Brooke County",22559,21769,-790,-3.50192827696263,3.50192827696263
"54","011","050","Cabell County",94350,91745,-2605,-2.76099629040806,2.76099629040806
"54","013","050","Calhoun County",6229,6987,758,12.1688874618719,12.1688874618719
"54","015","050","Clay County",8051,8404,353,4.38454850329152,4.38454850329152
"54","017","050","Doddridge County",7808,8395,587,7.51793032786885,7.51793032786885
"54","019","050","Fayette County",40488,42210,1722,4.25311203319502,4.25311203319502
"54","021","050","Gilmer County",7408,7848,440,5.93952483801296,5.93952483801296
"54","023","050","Grant County",10976,11516,540,4.9198250728863,4.9198250728863
"54","025","050","Greenbrier County",32977,34442,1465,4.44249022045668,4.44249022045668
"54","027","050","Hampshire County",23093,23207,114,0.493656086259906,0.493656086259906
"54","029","050","Hancock County",29095,28681,-414,-1.42292490118577,1.42292490118577
"54","031","050","Hardy County",14299,13709,-590,-4.12616266871809,4.12616266871809
"54","033","050","Harrison County",65921,67008,1087,1.64894343229017,1.64894343229017
"54","035","050","Jackson County",27791,28534,743,2.67352740095714,2.67352740095714
"54","037","050","Jefferson County",57701,57486,-215,-0.372610526680647,0.372610526680647
"54","039","050","Kanawha County",180745,176887,-3858,-2.13449887963706,2.13449887963706
"54","041","050","Lewis County",17033,15843,-1190,-6.98643809076499,6.98643809076499
"54","043","050","Lincoln County",20463,20161,-302,-1.47583443287885,1.47583443287885
"54","045","050","Logan County",32567,31770,-797,-2.44726256640157,2.44726256640157
"54","047","050","McDowell County",19111,17103,-2008,-10.5070378316153,10.5070378316153
"54","049","050","Marion County",56205,56017,-188,-0.334489814073481,0.334489814073481
"54","051","050","Marshall County",30591,30226,-365,-1.19316138733614,1.19316138733614
"54","053","050","Mason County",25453,26412,959,3.76772875496012,3.76772875496012
"54","055","050","Mercer County",59664,58406,-1258,-2.10847412174846,2.10847412174846
"54","057","050","Mineral County",26938,26769,-169,-0.627366545400549,0.627366545400549
"54","059","050","Mingo County",23568,23047,-521,-2.21062457569586,2.21062457569586
"54","061","050","Monongalia County",105822,106717,895,0.84575986089849,0.84575986089849
"54","063","050","Monroe County",12376,13255,879,7.10245636716225,7.10245636716225
"54","065","050","Morgan County",17063,17875,812,4.75883490593682,4.75883490593682
"54","067","050","Nicholas County",24604,24391,-213,-0.865712892212648,0.865712892212648
"54","069","050","Ohio County",42425,41297,-1128,-2.65880966411314,2.65880966411314
"54","071","050","Pendleton County",6143,6933,790,12.8601660426502,12.8601660426502
"54","073","050","Pleasants County",7653,7431,-222,-2.90082320658565,2.90082320658565
"54","075","050","Pocahontas County",7869,8208,339,4.3080442241708,4.3080442241708
"54","077","050","Preston County",34216,33419,-797,-2.32931961655366,2.32931961655366
"54","079","050","Putnam County",57440,56439,-1001,-1.74268802228412,1.74268802228412
"54","081","050","Raleigh County",74591,73127,-1464,-1.96270327519406,1.96270327519406
"54","083","050","Randolph County",27932,28451,519,1.85808391808678,1.85808391808678
"54","085","050","Ritchie County",8444,9533,1089,12.8967314069162,12.8967314069162
"54","087","050","Roane County",14028,13515,-513,-3.65697177074423,3.65697177074423
"54","089","050","Summers County",11959,12455,496,4.14750397190401,4.14750397190401
"54","091","050","Taylor County",16705,16685,-20,-0.11972463334331,0.11972463334331
"54","093","050","Tucker County",6762,6835,73,1.07956225968648,1.07956225968648
"54","095","050","Tyler County",8313,8550,237,2.85095633345363,2.85095633345363
"54","097","050","Upshur County",23816,24225,409,1.71733288545516,1.71733288545516
"54","099","050","Wayne County",38982,39169,187,0.479708583448771,0.479708583448771
"54","101","050","Webster County",8378,8088,-290,-3.46144664597756,3.46144664597756
"54","103","050","Wetzel County",14442,14949,507,3.51059410054009,3.51059410054009
"54","105","050","Wirt County",5194,5720,526,10.1270696958029,10.1270696958029
"54","107","050","Wood County",84296,83111,-1185,-1.40576065293727,1.40576065293727
"54","109","050","Wyoming County",21382,20199,-1183,-5.53269104854551,5.53269104854551
"55","001","050","Adams County",20654,20498,-156,-0.755301636486879,0.755301636486879
"55","003","050","Ashland County",16027,15461,-566,-3.53154052536345,3.53154052536345
"55","005","050","Barron County",46711,45176,-1535,-3.28616385862003,3.28616385862003
"55","007","050","Bayfield County",16220,15262,-958,-5.90628853267571,5.90628853267571
"55","009","050","Brown County",268740,264607,-4133,-1.53791768996056,1.53791768996056
"55","011","050","Buffalo County",13317,13042,-275,-2.06502966133514,2.06502966133514
"55","013","050","Burnett County",16526,15558,-968,-5.85743676630764,5.85743676630764
"55","015","050","Calumet County",52442,50256,-2186,-4.16841462949544,4.16841462949544
"55","017","050","Chippewa County",66297,64794,-1503,-2.26707090818589,2.26707090818589
"55","019","050","Clark County",34659,34777,118,0.340459909403041,0.340459909403041
"55","021","050","Columbia County",58490,57694,-796,-1.36091639596512,1.36091639596512
"55","023","050","Crawford County",16113,16058,-55,-0.341339291255508,0.341339291255508
"55","025","050","Dane County",561504,551616,-9888,-1.76098478372371,1.76098478372371
"55","027","050","Dodge County",89396,87467,-1929,-2.15781466732292,2.15781466732292
"55","029","050","Door County",30066,27881,-2185,-7.26734517395064,7.26734517395064
"55","031","050","Douglas County",44295,43681,-614,-1.38616096624901,1.38616096624901
"55","033","050","Dunn County",45440,45490,50,0.110035211267606,0.110035211267606
"55","035","050","Eau Claire County",105710,105132,-578,-0.54677892346987,0.54677892346987
"55","037","050","Florence County",4558,4308,-250,-5.48486178148311,5.48486178148311
"55","039","050","Fond du Lac County",104154,103012,-1142,-1.09645332872477,1.09645332872477
"55","041","050","Forest County",9179,8980,-199,-2.16799215600828,2.16799215600828
"55","043","050","Grant County",51938,51167,-771,-1.48446224344411,1.48446224344411
"55","045","050","Green County",37093,36691,-402,-1.08376243496077,1.08376243496077
"55","047","050","Green Lake County",19018,18926,-92,-0.483752234724997,0.483752234724997
"55","049","050","Iowa County",23709,23662,-47,-0.198236956430048,0.198236956430048
"55","051","050","Iron County",6137,5712,-425,-6.92520775623269,6.92520775623269
"55","053","050","Jackson County",21145,20657,-488,-2.30787420193899,2.30787420193899
"55","055","050","Jefferson County",84900,85026,126,0.148409893992933,0.148409893992933
"55","057","050","Juneau County",26718,26869,151,0.56516206302867,0.56516206302867
"55","059","050","Kenosha County",169151,169794,643,0.380133726670253,0.380133726670253
"55","061","050","Kewaunee County",20563,20404,-159,-0.773233477605408,0.773233477605408
"55","063","050","La Crosse County",120784,118479,-2305,-1.9083653464035,1.9083653464035
"55","065","050","Lafayette County",16611,16659,48,0.288965143579556,0.288965143579556
"55","067","050","Langlade County",19491,19162,-329,-1.68795854496947,1.68795854496947
"55","069","050","Lincoln County",28415,27574,-841,-2.95970438148865,2.95970438148865
"55","071","050","Manitowoc County",81359,78810,-2549,-3.13302769208078,3.13302769208078
"55","073","050","Marathon County",138013,135700,-2313,-1.67592907914472,1.67592907914472
"55","075","050","Marinette County",41872,40277,-1595,-3.80922812380588,3.80922812380588
"55","077","050","Marquette County",15592,15573,-19,-0.121857362750128,0.121857362750128
"55","078","050","Menominee County",4255,4553,298,7.00352526439483,7.00352526439483
"55","079","050","Milwaukee County",939489,946092,6603,0.702828878251901,0.702828878251901
"55","081","050","Monroe County",46274,46623,349,0.75420322427281,0.75420322427281
"55","083","050","Oconto County",38965,38311,-654,-1.67842935968177,1.67842935968177
"55","085","050","Oneida County",37845,35727,-2118,-5.59651208878319,5.59651208878319
"55","087","050","Outagamie County",190705,188621,-2084,-1.09278728926877,1.09278728926877
"55","089","050","Ozaukee County",91503,89975,-1528,-1.66989060467963,1.66989060467963
"55","091","050","Pepin County",7318,7257,-61,-0.833561082262913,0.833561082262913
"55","093","050","Pierce County",42212,42704,492,1.16554534255662,1.16554534255662
"55","095","050","Polk County",44977,43763,-1214,-2.69915734708851,2.69915734708851
"55","097","050","Portage County",70377,71035,658,0.934964548076787,0.934964548076787
"55","099","050","Price County",14054,13268,-786,-5.59271381813007,5.59271381813007
"55","101","050","Racine County",197727,195982,-1745,-0.882529952914878,0.882529952914878
"55","103","050","Richland County",17304,17273,-31,-0.179149329634767,0.179149329634767
"55","105","050","Rock County",163687,163140,-547,-0.334174369375699,0.334174369375699
"55","107","050","Rusk County",14188,14033,-155,-1.09247251198196,1.09247251198196
"55","109","050","St. Croix County",93536,91555,-1981,-2.11790112897708,2.11790112897708
"55","111","050","Sauk County",65763,64450,-1313,-1.99656341711905,1.99656341711905
"55","113","050","Sawyer County",18074,16656,-1418,-7.8455239570654,7.8455239570654
"55","115","050","Shawano County",40881,40784,-97,-0.237274039284753,0.237274039284753
"55","117","050","Sheboygan County",118034,115262,-2772,-2.34847586288697,2.34847586288697
"55","119","050","Taylor County",19913,20310,397,1.99367247526741,1.99367247526741
"55","121","050","Trempealeau County",30760,29644,-1116,-3.62808842652796,3.62808842652796
"55","123","050","Vernon County",30714,30869,155,0.504655857263788,0.504655857263788
"55","125","050","Vilas County",23047,22297,-750,-3.25421963813078,3.25421963813078
"55","127","050","Walworth County",106478,103954,-2524,-2.37044272056199,2.37044272056199
"55","129","050","Washburn County",16623,15718,-905,-5.44426397160561,5.44426397160561
"55","131","050","Washington County",136761,136430,-331,-0.242028063556131,0.242028063556131
"55","133","050","Waukesha County",406978,405937,-1041,-0.255787782140558,0.255787782140558
"55","135","050","Waupaca County",51812,50705,-1107,-2.13657067860727,2.13657067860727
"55","137","050","Waushara County",24520,24329,-191,-0.778955954323002,0.778955954323002
"55","139","050","Winnebago County",171730,171695,-35,-0.0203808303732603,0.0203808303732603
"55","141","050","Wood County",74207,72620,-1587,-2.13861226029889,2.13861226029889
"56","001","050","Albany County",37066,39005,1939,5.23120919440997,5.23120919440997
"56","003","050","Big Horn County",11521,11642,121,1.05025605416197,1.05025605416197
"56","005","050","Campbell County",47026,46657,-369,-0.784672308935483,0.784672308935483
"56","007","050","Carbon County",14537,14769,232,1.59592763293664,1.59592763293664
"56","009","050","Converse County",13751,13849,98,0.712675441786052,0.712675441786052
"56","011","050","Crook County",7181,7600,419,5.83484194401894,5.83484194401894
"56","013","050","Fremont County",39234,39403,169,0.430748840291584,0.430748840291584
"56","015","050","Goshen County",12498,13249,751,6.00896143382941,6.00896143382941
"56","017","050","Hot Springs County",4621,4421,-200,-4.32806751785328,4.32806751785328
"56","019","050","Johnson County",8447,8591,144,1.70474724754351,1.70474724754351
"56","021","050","Laramie County",100512,100458,-54,-0.0537249283667622,0.0537249283667622
"56","023","050","Lincoln County",19581,20186,605,3.08972984015117,3.08972984015117
"56","025","050","Natrona County",79955,80568,613,0.766681258207742,0.766681258207742
"56","027","050","Niobrara County",2467,2294,-173,-7.0125658694771,7.0125658694771
"56","029","050","Park County",29624,29298,-326,-1.10045908722657,1.10045908722657
"56","031","050","Platte County",8605,8545,-60,-0.697269029633934,0.697269029633934
"56","033","050","Sheridan County",30921,30796,-125,-0.404256007244268,0.404256007244268
"56","035","050","Sublette County",8728,9852,1124,12.878093492209,12.878093492209
"56","037","050","Sweetwater County",42272,42717,445,1.05270628311885,1.05270628311885
"56","039","050","Teton County",23331,23453,122,0.522909433800523,0.522909433800523
"56","041","050","Uinta County",20450,20169,-281,-1.37408312958435,1.37408312958435
"56","043","050","Washakie County",7685,7756,71,0.92387768379961,0.92387768379961
"56","045","050","Weston County",6838,6752,-86,-1.2576776835332,1.2576776835332
